matchID,season,battingTeam,bowlingTeam,innings,firstBatter,secondBatter,partnership,totalBallsFaced,fours,sixes,wicket,firstBatterRuns,firstBatterBallsFaced,firstBatterFours,firstBatterSixes,secondBatterRuns,secondBatterBallsFaced,secondBatterFours,secondBatterSixes
6480bba3fc9599eca1b87a77,2016,,,1,AB de Villiers,V Kohli,229,97,14,20,1,129,52,10,12,97,45,4,8
6480bba2d313234709068efb,2015,,,2,AB de Villiers,V Kohli,215,102,24,8,0,133,59,19,4,76,43,5,4
6480bb9927b39ebcfd7820b0,2022,,,1,KL Rahul,Q de Kock,210,121,13,14,0,68,51,3,4,140,70,10,10
6480bb9e565ef5f11c5c8f55,2011,,,1,AC Gilchrist,SE Marsh,206,98,15,14,1,105,49,8,9,79,49,7,5
6480bb9f022f0e8cd6e9cdeb,2012,,,2,CH Gayle,V Kohli,204,108,16,14,0,127,55,7,13,73,53,9,1
6480bb9e38040b358f5a34d8,2012,,,2,DA Warner,NV Ojha,189,100,12,12,0,109,54,10,7,64,46,2,5
6480bb95b84f125c6212267a,2019,,,1,DA Warner,JM Bairstow,185,98,15,10,1,70,42,3,3,114,56,12,7
6480bb93894ff5c944493650,2017,,,2,CA Lynn,G Gambhir,184,89,18,8,0,93,41,6,8,76,48,12,0
6480bb96e834e1c16b33f325,2020/21,,,1,KL Rahul,MA Agarwal,183,100,17,8,1,68,50,7,1,106,50,10,7
6480bb98825d8ceb716e3f3c,2022,,,1,DP Conway,RD Gaikwad,182,107,12,10,1,74,50,6,4,99,57,6,6
6480bb96e29253678ca02869,2020/21,,,2,F du Plessis,SR Watson,181,106,22,4,0,87,53,11,1,83,53,11,3
6480bb97493381c4d7dc7bf4,2021,,,2,D Padikkal,V Kohli,181,99,17,9,0,101,52,11,6,72,47,6,3
6480bb95481ab7c06b86419b,2018,,,2,KS Williamson,S Dhawan,176,102,17,6,0,83,53,8,2,91,49,9,4
6480bb9affc08d6384ac3992,2023,,,2,F du Plessis,V Kohli,172,108,18,6,1,67,45,6,2,100,63,12,4
6480bb9f3ca20834ecc7607a,2012,,,2,HH Gibbs,RG Sharma,167,106,16,7,0,53,46,4,2,109,60,12,5
6480bba0b5eabeb0a150b93f,2013,,,1,CH Gayle,TM Dilshan,167,84,14,13,1,127,48,9,13,33,36,5,0
6480bb988545a7776b8c9306,2022,,,1,RV Uthappa,S Dube,165,74,8,14,1,73,34,3,8,80,40,5,6
6480bb9f8ab73cf7c77cef03,2012,,,2,DR Smith,SR Tendulkar,163,109,16,3,0,87,58,10,3,58,51,6,0
6480bb97fb920d483d0da2af,2020/21,,,1,DA Warner,JM Bairstow,160,92,12,7,1,52,40,5,1,97,52,7,6
6480bb9e300070746cc2eb67,2011,,,1,M Vijay,MEK Hussey,159,89,7,9,1,89,44,4,6,63,45,3,3
6480bb947a7076697fc0b339,2017,,,2,G Gambhir,RV Uthappa,158,85,13,7,1,60,38,6,1,87,47,7,6
6480bba2ab35be3ffcfa932a,2016,,,1,AB de Villiers,V Kohli,157,87,13,9,1,82,40,7,6,71,47,6,3
6480bb9ed6aefcc9cd13d851,2012,,,1,CL White,KC Sangakkara,157,87,13,6,1,65,35,3,4,82,52,10,2
6480bba21bbf76a62abea528,2016,,,2,AB de Villiers,V Kohli,155,96,11,5,1,83,45,6,4,61,51,5,1
6480bb9aa030c8ebcbcc19c9,2007/08,,,2,AC Gilchrist,VVS Laxman,155,73,13,11,0,109,47,9,10,37,26,4,1
6480bb98b00f767943bb8415,2022,,,1,D Padikkal,JC Buttler,155,91,15,10,1,54,35,7,2,99,56,8,8
6480bba163bd0c619365a16b,2015,,,1,JP Duminy,SS Iyer,154,97,10,10,1,66,42,3,5,82,55,7,5
6480bb979e8cc2484c1a8c7b,2020/21,,,2,BA Stokes,SV Samson,152,82,14,6,0,87,51,10,3,54,31,4,3
6480bb9c3803ef7726af83ab,2009/10,,,1,JA Morkel,M Vijay,152,66,7,13,1,62,34,3,5,85,32,4,8
6480bb9d109617dfa089c2c6,2011,,,2,G Gambhir,JH Kallis,152,104,18,3,0,75,44,11,1,76,60,7,2
6480bb9f014bd6e0ac2b51a8,2013,,,1,DPMD Jayawardene,V Sehwag,151,97,20,3,1,59,43,8,1,90,54,12,2
6480bb960d5042aa46b7776b,2020/21,,,2,DA Warner,WP Saha,151,103,17,2,0,85,58,10,1,58,45,7,1
6480bb970c637fd0c057dca9,2021,,,1,JC Buttler,SV Samson,150,82,13,7,1,94,49,9,5,48,33,4,2
6480bba07fa24b891b818984,2013,,,1,Azhar Mahmood,SE Marsh,148,86,19,4,1,79,39,8,4,63,47,11,0
6480bb99b4febfb641fddd39,2023,,,2,F du Plessis,V Kohli,148,89,10,10,1,73,43,5,6,71,46,5,4
6480bba34d78f594b07da1bc,2016,,,1,CH Gayle,V Kohli,147,67,10,14,1,73,32,4,8,69,35,6,6
6480bb9a24adc8d916dfe2db,2023,,,1,B Sai Sudharsan,Shubman Gill,147,84,18,2,1,47,36,6,1,89,48,12,1
6480bb9db9ed29ce1ee8764f,2011,,,1,DA Warner,V Sehwag,146,70,15,7,1,59,35,7,3,77,35,8,4
6480bb9e3db1392e753dd785,2012,,,1,MK Pandey,RV Uthappa,145,112,13,3,0,80,54,7,3,60,58,6,0
6480bb9618b5973b98c0ba18,2019,,,2,Gurkeerat Singh,SO Hetmyer,144,89,12,7,1,65,47,8,1,73,42,4,6
6480bb99b3179a9346d8883c,2022,,,2,DA Warner,MR Marsh,144,101,10,8,1,48,39,5,1,89,62,5,7
6480bba1ece63aa1c77a954e,2015,,,1,AM Rahane,SR Watson,144,97,12,6,1,70,50,6,2,73,47,6,4
6480bb94f27c8167d1685878,2017,,,1,RR Pant,SV Samson,143,63,5,14,1,87,38,5,8,52,25,0,6
6480bb9c54a72690027ba3d4,2009/10,,,1,S Badrinath,SK Raina,142,91,13,3,0,55,45,6,0,78,46,7,3
6480bb9a6a7169d0e413bcfa,2023,,,1,Shubman Gill,WP Saha,142,74,10,9,1,57,31,0,5,81,43,10,4
6480bb9ac9149c73fdf073b3,2023,,,1,DP Conway,RD Gaikwad,141,87,10,9,1,60,37,7,2,79,50,3,7
6480bb9a43249ece8e841e56,2023,,,2,N Wadhera,SA Yadav,140,66,11,8,1,46,32,4,2,82,34,7,6
6480bba09d6b23c8722fd208,2013,,,1,MEK Hussey,SK Raina,140,76,10,7,0,58,34,5,2,82,42,5,5
6480bb96fed7a7ee65076e4a,2020/21,,,2,MK Pandey,V Shankar,140,93,10,8,0,82,42,4,8,52,51,6,0
6480bb9a1a3e8cef5633f4e6,2023,,,1,MA Agarwal,Vivrant Sharma,140,83,16,4,1,62,36,7,2,69,47,9,2
6480bb9fa3a890f94f179477,2013,,,2,M Vijay,MEK Hussey,139,104,14,3,0,50,50,3,1,86,54,11,2
6480bb943565d22d24ec0ae8,2017,,,1,DA Warner,S Dhawan,139,76,9,9,1,104,46,7,8,29,30,2,1
6480bb9a1e358307d26cd50d,2023,,,1,B Sai Sudharsan,Shubman Gill,138,64,8,10,1,38,26,4,1,95,38,4,9
6480bb9adb5d9ca80cb1c6a0,2023,,,1,JC Buttler,SV Samson,138,81,10,8,1,82,47,8,4,52,34,2,4
6480bb974086cbea889134af,2021,,,2,PP Shaw,S Dhawan,138,82,15,5,1,72,38,9,3,65,44,6,2
6480bb9d5d93b08a19c16313,2009/10,,,1,M Vijay,SK Raina,137,78,15,5,0,49,39,4,2,78,39,11,3
6480bb9d6ea22feab98beb5b,2011,,,1,MEK Hussey,SK Raina,137,100,10,2,1,72,49,7,1,61,51,3,1
6480bb9996eb97dd08b62f78,2023,,,1,F du Plessis,V Kohli,137,98,10,4,1,71,51,5,3,59,47,5,1
6480bba237377ccc608266d2,2016,,,2,AT Rayudu,PA Patel,137,86,14,5,1,65,37,4,4,68,49,10,1
6480bba2d324f0342e6af689,2016,,,2,DA Warner,S Dhawan,137,89,14,0,0,74,48,9,0,53,41,5,0
6480bb9dec749d630afd07d1,2011,,,2,AC Gilchrist,PC Valthaty,136,86,12,7,1,61,46,5,3,63,40,7,4
6480bba0208e8fbb34afdc50,2013,,,1,CH Gayle,V Kohli,136,89,10,8,1,74,48,4,6,55,41,6,2
6480bb9fc9e4047271240a59,2012,,,1,JH Kallis,MS Bisla,136,82,12,5,1,41,36,4,0,88,46,8,5
6480bb93ff8d1f4cd07859ce,2017,,,1,KS Williamson,S Dhawan,136,87,10,5,1,89,51,6,5,44,36,4,0
6480bb9e591b94e62772e66a,2012,,,1,DPMD Jayawardene,V Sehwag,135,79,16,4,1,55,42,8,0,72,37,8,4
6480bba1ff89cb428182daa6,2014,,,1,DA Miller,GJ Maxwell,135,64,10,10,1,47,32,5,2,84,32,5,8
6480bb9b166300b6298fc71a,2009,,,2,GC Smith,NV Ojha,135,91,17,4,1,77,44,12,1,56,47,5,3
6480bb95b98d000799e11963,2018,,,2,KS Williamson,MK Pandey,135,67,13,7,1,72,33,6,5,59,34,7,2
6480bb9e1751fd9db64a2834,2011,,,2,R Dravid,SR Watson,134,79,15,6,0,43,32,6,0,89,47,9,6
6480bb95a65bb0f3394a62b5,2018,,,2,AT Rayudu,SR Watson,134,81,11,9,1,77,46,6,6,57,35,5,3
6480bba326249b668a4713d6,2016,,,1,Shakib Al Hasan,YK Pathan,134,85,11,5,0,66,44,4,4,63,41,7,1
6480bba2ad3f26917361061f,2016,,,2,KK Nair,Q de Kock,134,77,14,4,1,54,42,6,1,74,35,8,3
6480bb94f27c8167d1685878,2017,,,2,KD Karthik,SK Raina,133,72,9,8,1,54,30,4,4,77,42,5,4
6480bb94cfe5aeb50e36aef3,2017,,,2,DA Warner,V Shankar,133,91,18,0,0,67,47,9,0,63,44,9,0
6480bba0fee4ae82492a666f,2013,,,2,MEK Hussey,SK Raina,133,73,10,6,1,52,30,2,4,75,43,8,2
6480bb9b2a5f2fd5053534dc,2007/08,,,2,LA Pomersbach,SE Marsh,133,86,12,6,1,48,32,5,2,80,54,7,4
6480bb9b9614f21d90333e15,2007/08,,,1,JR Hopes,SE Marsh,133,82,17,5,1,51,35,7,1,80,47,10,4
6480bb9b283b30d0503656f7,2007/08,,,1,G Gambhir,S Dhawan,133,85,13,3,1,72,44,6,3,55,41,7,0
6480bb977453ebef15f59e25,2021,,,2,PP Shaw,S Dhawan,132,83,15,4,1,82,36,11,3,46,47,4,1
6480bb9f36da1a646c80be45,2013,,,1,KD Karthik,RG Sharma,132,80,16,4,1,86,46,14,2,38,34,2,2
6480bba1568e0f3990191600,2014,,,1,AB de Villiers,Yuvraj Singh,132,65,8,10,1,43,27,1,3,83,38,7,7
6480bb9538916411f52016bf,2019,,,2,DA Warner,JM Bairstow,131,74,9,7,1,67,38,3,5,59,36,6,2
6480bba0b46cf5430edef3f5,2014,,,2,JH Kallis,MK Pandey,131,92,11,4,1,61,39,5,2,64,53,6,2
6480bb9ee7a29c9b96ed61e5,2011,,,2,DB Ravi Teja,S Dhawan,131,80,13,2,1,60,41,5,2,55,39,8,0
6480bb9edd901481f13ce9ba,2012,,,2,AB de Villiers,CH Gayle,131,76,12,4,1,52,37,6,0,73,39,6,4
6480bba16796f9a72374865f,2015,,,2,CJ Anderson,RG Sharma,131,88,13,6,0,55,41,4,3,75,47,9,3
6480bb956e3f7f62e4b24c01,2019,,,1,AM Rahane,SPD Smith,130,72,16,3,1,77,40,8,3,50,32,8,0
6480bba0fbf5f1671e1e557e,2013,,,1,DA Miller,R Sathish,130,50,10,8,0,93,32,8,7,27,18,2,1
6480bba16af3f513920ef499,2015,,,1,DA Warner,S Dhawan,130,86,11,5,1,91,55,9,4,36,31,2,1
6480bba1553f17c77d5f1ca2,2014,,,2,AT Rayudu,LMP Simmons,130,87,11,6,1,63,42,6,2,67,45,5,4
6480bb9c5ec0713155cad138,2009/10,,,2,AD Mathews,OA Shah,130,90,8,7,0,65,46,5,4,58,44,3,3
6480bb9c94ef2c2e850189ff,2009/10,,,2,MS Bisla,RS Bopara,129,86,11,5,1,75,51,7,4,45,35,4,1
6480bb970127afddc00607cc,2021,,,2,F du Plessis,RD Gaikwad,129,78,18,1,1,53,34,6,1,75,44,12,0
6480bba1bd00c57fb3301f04,2014,,,2,M Vohra,WP Saha,129,73,9,8,1,46,33,4,2,77,40,5,6
6480bb94640655c49683aee1,2018,,,1,Ishan Kishan,SA Yadav,129,82,10,6,1,58,42,4,3,69,40,6,3
6480bba063bacaa2dfabf6fd,2014,,,1,AJ Finch,DA Warner,128,82,8,7,0,69,37,5,4,58,45,3,3
6480bb9a1a3e8cef5633f4e6,2023,,,2,C Green,RG Sharma,128,65,12,8,1,73,33,5,7,50,32,7,1
6480bb9c17dcdfd5b06984f0,2009/10,,,1,DA Warner,PD Collingwood,128,99,8,5,1,74,54,5,3,53,45,3,2
6480bb9f218f37b46bef4afb,2013,,,1,DA Miller,Mandeep Singh,128,79,8,5,0,80,41,5,5,47,38,3,0
6480bb9d29051b8e40c07d52,2011,,,2,BB McCullum,DPMD Jayawardene,128,83,17,2,1,62,47,8,2,56,36,9,0
6480bb9b6ded6d116cfe02ee,2009,,,2,SR Tendulkar,ST Jayasuriya,127,74,8,8,1,68,45,6,4,51,29,2,4
6480bb9b7557e68b433167d5,2007/08,,,2,GC Smith,SA Asnodkar,127,68,14,5,1,79,41,9,3,41,27,5,2
6480bb99c6aa5989a16174d1,2023,,,1,F du Plessis,GJ Maxwell,127,67,11,6,1,52,31,6,2,65,36,5,4
6480bb9b332c16fba9cd28bc,2009,,,1,JH Kallis,RV Uthappa,126,91,10,4,0,55,49,2,2,66,42,8,2
6480bb994877788ec5b187ff,2023,,,2,F du Plessis,GJ Maxwell,126,61,7,11,1,49,25,4,3,76,36,3,8
6480bb9f7bae5ad85c4473ba,2012,,,1,RG Sharma,SR Tendulkar,126,81,16,3,1,57,42,6,2,67,39,10,1
6480bb9e38040b358f5a34d8,2012,,,1,CL White,S Dhawan,126,70,13,6,1,51,34,6,1,74,36,7,5
6480bb94351a8b10e20d14d9,2017,,,1,HM Amla,SE Marsh,125,89,10,2,1,64,46,4,2,58,43,6,0
6480bb9d872bbb611f6266cb,2011,,,2,M Vijay,S Badrinath,124,87,12,4,1,74,43,6,4,46,44,6,0
6480bba26ca6ec72ba377236,2016,,,1,DA Warner,KS Williamson,124,74,13,5,1,76,39,7,5,45,35,6,0
6480bb9db38208342bc57b96,2011,,,2,CH Gayle,TM Dilshan,123,73,13,7,1,84,42,7,7,38,31,6,0
6480bb95a65bb0f3394a62b5,2018,,,1,KS Williamson,S Dhawan,123,75,12,5,1,51,38,5,2,63,37,7,3
6480bb9ab49fc97bbb30576f,2023,,,2,Shubman Gill,V Shankar,123,71,10,6,1,63,36,3,4,53,35,7,2
6480bba0be153677ce53c58e,2014,,,1,BB McCullum,DR Smith,123,76,9,6,1,67,45,4,5,44,31,5,1
6480bb9e1a26096ce68e9ca3,2012,,,2,AB de Villiers,TM Dilshan,122,52,9,6,0,59,23,3,5,47,29,6,1
6480bb9f68a0a232d83c338c,2012,,,2,AT Rayudu,KA Pollard,122,65,10,7,0,64,34,5,4,52,31,5,3
6480bb9871b0ff7264721cbc,2022,,,1,DA Warner,R Powell,122,66,10,7,0,50,31,7,1,67,35,3,6
6480bb9399a527d39bc17dad,2017,,,2,CH Gayle,V Kohli,122,76,11,7,1,77,38,5,7,42,38,6,0
6480bb9718a9b89de407178b,2021,,,1,KL Rahul,MA Agarwal,122,77,13,5,1,47,41,6,1,69,36,7,4
6480bb9e21655ee16a96b2c3,2012,,,2,AM Rahane,OA Shah,121,50,12,8,1,55,24,7,3,60,26,5,5
6480bb96ec7d98e34055e8fc,2020/21,,,1,SPD Smith,SV Samson,121,57,4,12,1,45,25,3,3,74,32,1,9
6480bb9a2b33e06f46eed54f,2023,,,2,SV Samson,YBK Jaiswal,121,69,11,8,0,48,29,2,5,71,40,9,3
6480bb9692a7f0d52bd43127,2019,,,1,AB de Villiers,MP Stoinis,121,66,4,10,0,69,32,2,7,46,34,2,3
6480bb9a61edc0c77bc4bc86,2007/08,,,1,G Gambhir,S Dhawan,121,76,13,3,1,60,34,8,1,52,42,5,2
6480bba179195d83fa7fbfbb,2014,,,2,G Gambhir,RV Uthappa,121,85,11,4,1,54,34,6,1,65,51,5,3
6480bb94f06c6048c8088194,2018,,,2,KS Williamson,S Dhawan,121,88,16,2,0,36,35,3,1,78,53,13,1
6480bba13b673297bce003e2,2014,,,1,RV Uthappa,Shakib Al Hasan,121,71,13,4,1,58,33,8,1,60,38,5,3
6480bba264ad6b873d0d07d8,2016,,,2,KL Rahul,V Kohli,121,74,10,4,0,51,35,4,3,67,39,6,1
6480bb97af44a48533f08540,2020/21,,,1,CH Gayle,KL Rahul,120,82,8,7,1,69,46,5,5,45,36,3,2
6480bb9a43249ece8e841e56,2023,,,1,F du Plessis,GJ Maxwell,120,62,11,7,1,49,29,3,3,68,33,8,4
6480bb985efffbcafdef9f19,2021,,,2,KL Rahul,MA Agarwal,120,72,11,4,1,49,33,4,2,63,39,7,2
6480bb965aa0867bce4e79b3,2019,,,1,F du Plessis,SK Raina,120,75,12,5,1,67,37,7,3,53,38,5,2
6480bba18a2fe828fa106f6c,2014,,,2,LMP Simmons,MEK Hussey,120,88,9,4,1,62,51,6,2,55,37,3,2
6480bba255079696d5cfa453,2015,,,1,CH Gayle,V Kohli,119,69,7,10,1,80,39,4,9,32,30,3,1
6480bb9fd4a1af6234c9e57c,2012,,,1,CH Gayle,V Kohli,119,83,9,6,1,71,42,6,4,45,41,3,2
6480bba2b7be71a15b2bb3de,2015,,,1,LMP Simmons,RG Sharma,119,68,14,5,1,67,42,8,3,50,26,6,2
6480bb95c8ecc2185a67f4fd,2019,,,1,AM Rahane,SV Samson,119,76,9,5,1,61,37,4,3,56,39,5,2
6480bb97746881ab34c38bf8,2020/21,,,2,Ishan Kishan,KA Pollard,119,51,3,11,1,60,28,1,6,56,23,2,5
6480bb9ab99ef699d66ad5a0,2023,,,1,JM Sharma,LS Livingstone,119,53,10,5,0,49,27,5,2,58,26,5,3
6480bb95af5853799812b0f6,2019,,,1,DA Warner,JM Bairstow,118,78,12,3,1,74,43,9,2,39,35,3,1
6480bb957e6d387fe3a6b26e,2018,,,2,AB de Villiers,V Kohli,118,64,10,7,1,53,29,4,4,63,35,6,3
6480bb9523e6dc3c988ce398,2019,,,2,AD Russell,N Rana,118,48,5,13,1,65,25,2,9,48,23,3,4
6480bba0208e8fbb34afdc50,2013,,,2,AC Gilchrist,Azhar Mahmood,118,77,15,2,1,52,36,7,1,61,41,8,1
6480bb980cc3d01eab3a4748,2022,,,1,F du Plessis,V Kohli,118,61,3,9,1,75,35,2,7,38,26,1,2
6480bb951354c40599b60208,2018,,,2,SK Raina,SR Watson,117,57,8,8,1,32,24,3,1,82,33,5,7
6480bb9ab99ef699d66ad5a0,2023,,,2,Ishan Kishan,SA Yadav,116,55,13,4,1,48,24,5,2,66,31,8,2
6480bba031c5cf0145ae8cfe,2014,,,2,CA Pujara,GJ Maxwell,116,67,10,6,1,21,22,2,0,89,45,8,6
6480bb966f48b8ee03e6dff5,2020/21,,,2,Ishan Kishan,Q de Kock,116,74,11,7,0,68,37,6,5,46,37,5,2
6480bba1cef79f12933bbf27,2014,,,2,DA Warner,S Dhawan,116,69,13,3,1,90,45,12,3,22,24,1,0
6480bba33195e5ebac1da82a,2016,,,2,M Vijay,WP Saha,116,88,11,2,1,50,48,5,1,56,40,6,1
6480bb94fc240a33621b10a6,2018,,,2,CH Gayle,KL Rahul,116,58,14,7,1,55,31,5,5,60,27,9,2
6480bb9d29051b8e40c07d52,2011,,,1,AT Rayudu,SR Tendulkar,116,68,8,7,1,53,33,3,4,59,35,5,3
6480bb9e1d754facf4fad618,2012,,,1,F du Plessis,S Badrinath,116,94,12,2,1,58,48,4,2,57,46,8,0
6480bb95a09b947e0837a38a,2019,,,1,CH Gayle,KL Rahul,116,77,7,9,1,63,36,3,7,50,41,4,2
6480bb96c95abb10156a6055,2020/21,,,2,AT Rayudu,F du Plessis,115,85,9,3,1,71,48,6,3,41,37,3,0
6480bb962831291a868490e7,2020/21,,,1,N Rana,SP Narine,115,56,13,5,1,45,24,7,1,64,32,6,4
6480bba0be153677ce53c58e,2014,,,2,DA Miller,GJ Maxwell,115,63,13,3,1,32,28,2,1,78,35,11,2
6480bb96e76ccde6082d7564,2020/21,,,2,KL Rahul,MA Agarwal,115,86,11,1,1,58,47,5,0,56,39,6,1
6480bb975ea60ce128803d60,2021,,,1,F du Plessis,RD Gaikwad,115,76,9,6,1,48,34,3,2,64,42,6,4
6480bb997d1393ca85856ec2,2022,,,2,F du Plessis,V Kohli,115,87,13,1,1,44,38,5,0,65,49,8,1
6480bba2a94dd2c01769b3ae,2016,,,2,Q de Kock,RR Pant,115,81,13,3,1,44,41,4,1,69,40,9,2
6480bb9a17692bfb5bd3894c,2007/08,,,2,G Gambhir,V Sehwag,115,70,12,4,1,39,29,5,0,71,41,7,4
6480bb99315aee6cd9d56504,2023,,,1,F du Plessis,GJ Maxwell,115,50,5,11,1,48,21,2,5,59,29,3,6
6480bb961570df6942a00888,2019,,,1,DA Warner,MK Pandey,115,72,10,4,1,53,38,3,2,60,34,7,2
6480bba38ce35716815a1845,2016,,,2,AB de Villiers,V Kohli,115,68,8,5,0,59,31,5,3,54,37,3,2
6480bb957ae1619e0d648dec,2019,,,2,KL Rahul,MA Agarwal,114,84,9,4,1,58,41,6,1,55,43,3,3
6480bba388682c5ca10ff37a,2016,,,1,CH Gayle,V Kohli,114,63,7,9,1,76,38,4,8,32,25,3,1
6480bb9e28b7a946a6921fa6,2011,,,1,CH Gayle,MA Agarwal,113,64,13,4,1,62,33,9,2,41,31,4,2
6480bba2bbd9d85769220a68,2015,,,1,AM Rahane,KK Nair,113,69,10,4,1,50,31,4,2,61,38,6,2
6480bb9f6f311344dac147cc,2012,,,1,BB McCullum,G Gambhir,113,75,9,3,1,42,39,5,1,56,36,4,2
6480bba2b341a081c069198d,2015,,,1,AB de Villiers,Mandeep Singh,113,67,10,5,1,65,37,4,4,43,30,6,1
6480bb9af968df9497d2b9c4,2007/08,,,2,DJ Bravo,RV Uthappa,113,88,13,1,0,64,53,8,1,37,35,5,0
6480bba2965d1d15aa6f723e,2016,,,2,BB McCullum,DR Smith,112,64,11,6,1,58,34,6,3,53,30,5,3
6480bba1603d86b7d278a366,2015,,,1,AD Russell,RV Uthappa,112,64,8,5,0,55,32,4,4,52,32,4,1
6480bb94566b0cf89fca84f9,2018,,,1,AT Rayudu,SK Raina,112,57,11,6,1,79,37,9,4,31,20,2,2
6480bb9ab655ac367694708c,2007/08,,,1,G Gambhir,S Dhawan,112,81,13,1,0,50,40,5,1,52,41,8,0
6480bb9aab9770e7260312df,2007/08,,,2,S Dhawan,V Sehwag,112,57,10,6,0,25,28,3,0,75,29,7,6
6480bb9aef150645306cc170,2023,,,2,MR Marsh,PD Salt,112,66,10,5,1,52,31,1,5,59,35,9,0
6480bb9a1a3ab2ab8297871d,2007/08,,,1,A Symonds,RG Sharma,111,58,8,7,1,73,28,5,6,36,30,3,1
6480bb94cfe5aeb50e36aef3,2017,,,1,DR Smith,Ishan Kishan,111,65,11,6,1,54,33,7,2,54,32,4,4
6480bb9e9162dceff15dc334,2011,,,2,KD Karthik,SE Marsh,111,57,12,7,1,69,33,7,5,41,24,5,2
6480bb9d1ed71a4f47892d00,2009/10,,,1,CA Pujara,SC Ganguly,111,80,13,3,0,45,38,5,1,62,42,8,2
6480bba120182b9ca0b70004,2014,,,2,DA Warner,KL Rahul,111,81,2,4,1,65,51,1,4,34,30,1,0
6480bb9dd89d4266d59a4592,2011,,,1,CH Gayle,V Kohli,111,59,12,7,1,83,29,8,7,27,30,4,0
6480bba278153a5979e31ec9,2016,,,1,AM Rahane,SPD Smith,111,68,9,2,1,42,32,3,0,65,36,6,2
6480bb98d8f59b81335f4a3d,2021,,,1,D Padikkal,V Kohli,111,80,11,3,1,55,39,5,2,53,41,6,1
6480bb97dee20878b0c4246c,2021,,,2,GJ Maxwell,KS Bharat,111,63,10,3,0,51,33,8,0,56,30,2,3
6480bba28257fe87dd859e3e,2015,,,2,LMP Simmons,PA Patel,111,74,12,3,1,50,38,7,0,59,36,5,3
6480bb954817ed0a4ba25bc2,2018,,,2,AJ Finch,KL Rahul,111,74,8,3,1,46,35,3,1,60,39,5,2
6480bb95c8ecc2185a67f4fd,2019,,,2,DA Warner,JM Bairstow,110,58,14,3,1,69,37,9,2,39,21,5,1
6480bb99ecbdaaf953b8eee5,2023,,,1,DP Conway,RD Gaikwad,110,56,7,6,1,40,25,4,2,57,31,3,4
6480bba136257b71aa9952cf,2014,,,2,M Vohra,V Sehwag,110,64,10,5,1,34,31,1,2,69,33,9,3
6480bb95f45dffe4751efc46,2019,,,2,KL Rahul,SN Khan,110,93,6,3,1,54,44,3,1,55,49,3,2
6480bb931e6d2b03141b586d,2017,,,2,MK Pandey,YK Pathan,110,72,9,4,1,43,33,3,2,59,39,6,2
6480bba0a222eb875a07f5a3,2014,,,1,JP Duminy,LRPL Taylor,110,78,7,3,0,61,39,3,3,43,39,4,0
6480bb9d93cca4d1a7635fba,2011,,,2,AT Rayudu,SR Tendulkar,110,86,15,0,0,63,50,9,0,46,36,6,0
6480bb9c7a11e1cbeea46b0e,2009/10,,,1,AT Rayudu,SS Tiwary,110,63,10,4,1,55,33,6,2,51,30,4,2
6480bb980b5b26e8c4335a4b,2022,,,1,PBB Rajapaksa,S Dhawan,110,71,10,2,1,42,32,2,2,58,39,8,0
6480bb9822eeb0c1c117f221,2021,,,2,RD Gaikwad,RV Uthappa,110,77,9,4,1,45,33,2,2,63,44,7,2
6480bb9929c7e430acd1ef18,2022,,,1,DP Conway,RD Gaikwad,110,67,10,5,1,64,34,6,4,41,33,4,1
6480bb95d4da0397e79acffa,2019,,,1,N Rana,RV Uthappa,110,66,5,9,1,63,34,2,7,44,32,3,2
6480bb9bc74c35e494cec477,2007/08,,,1,GC Smith,YK Pathan,109,76,12,2,1,35,39,3,0,68,37,9,2
6480bba1c0aa361f3c6e454c,2015,,,2,BB McCullum,DR Smith,109,46,14,5,1,46,20,6,2,56,26,8,3
6480bb9cdf6c63fec90a42df,2009/10,,,2,MS Dhoni,S Badrinath,109,65,9,4,0,66,33,6,3,42,32,3,1
6480bb9baa08d0494c0b8dc3,2007/08,,,1,GC Smith,SA Asnodkar,109,75,11,2,1,40,31,4,1,50,44,7,1
6480bb9ce7891d47a7fe9c12,2009/10,,,1,MJ Lumb,NV Ojha,109,59,18,2,1,83,43,16,2,21,16,2,0
6480bb9e83b8575f74b8e962,2012,,,2,CH Gayle,V Kohli,109,66,7,6,1,62,29,2,6,38,37,5,0
6480bb94a0422f6d0abe276b,2017,,,1,G Gambhir,RV Uthappa,108,66,11,4,1,41,33,6,0,59,33,5,4
6480bba09d1874eb9ded0204,2013,,,1,AM Rahane,R Dravid,108,82,11,0,1,44,34,4,0,53,48,7,0
6480bb97aad3147696268239,2021,,,1,F du Plessis,MM Ali,108,61,7,9,1,48,25,2,4,58,36,5,5
6480bba1cef79f12933bbf27,2014,,,1,DJ Hussey,MS Dhoni,108,68,7,6,0,47,27,5,2,57,41,2,4
6480bb95833c06e6c5119173,2019,,,1,AB de Villiers,V Kohli,108,56,9,6,1,61,30,5,4,46,26,4,2
6480bb965aa0867bce4e79b3,2019,,,2,CH Gayle,KL Rahul,108,63,9,7,1,28,27,2,2,71,36,7,5
6480bb948f3284f793b2763c,2018,,,1,E Lewis,RG Sharma,108,66,10,6,1,65,42,6,5,32,24,4,1
6480bb932f8447acd7840076,2017,,,1,DA Warner,MC Henriques,108,74,11,2,0,53,35,5,2,52,39,6,0
6480bba2ad3f26917361061f,2016,,,1,AB de Villiers,V Kohli,107,65,13,2,1,55,33,9,1,46,32,4,1
6480bb96acacf3be646d300a,2020/21,,,1,DA Warner,WP Saha,107,58,14,2,1,66,34,8,2,40,24,6,0
6480bb95b98d000799e11963,2018,,,1,AB de Villiers,MM Ali,107,57,8,7,1,44,25,7,1,61,32,1,6
6480bb9c7a11e1cbeea46b0e,2009/10,,,2,P Dogra,YK Pathan,107,47,9,7,1,18,21,0,0,86,26,9,7
6480bb94fbd0b904d63e0e07,2017,,,2,DA Warner,S Dhawan,107,60,11,5,1,51,27,4,4,55,33,7,1
6480bb9824c4678d005d7aeb,2022,,,2,AJ Finch,SS Iyer,107,53,15,2,1,58,27,9,2,41,26,6,0
6480bba1d9f266a28a109f29,2015,,,2,MA Agarwal,Yuvraj Singh,106,66,9,5,1,46,27,4,2,54,39,5,3
6480bb984f0f3dc0df6d4531,2022,,,2,Shubman Gill,WP Saha,106,73,12,4,1,52,36,6,2,52,37,6,2
6480bba23b270561e8026bd2,2015,,,2,LMP Simmons,PA Patel,106,80,13,2,1,48,44,4,2,50,36,9,0
6480bba2db1e2def1b597ed3,2015,,,1,MA Agarwal,SS Iyer,106,76,9,4,1,45,36,5,1,54,40,4,3
6480bba1551dc12c8f2a7038,2014,,,2,G Gambhir,RV Uthappa,106,71,9,2,1,47,37,4,1,47,34,5,1
6480bb9b3a5e1af467fb027b,2009,,,2,ML Hayden,PA Patel,106,61,11,3,1,65,35,9,2,30,26,2,1
6480bb9938b659481e3ab6dc,2022,,,2,DA Miller,HH Pandya,106,61,7,5,0,68,38,3,5,33,23,4,0
6480bb970127afddc00607cc,2021,,,1,DA Warner,MK Pandey,106,83,6,3,1,45,40,2,2,56,43,4,1
6480bba3412663673a969a24,2016,,,2,AM Rahane,SS Tiwary,106,70,14,1,1,49,31,5,1,52,39,9,0
6480bb95d675b7da24db1a57,2019,,,2,RR Pant,S Dhawan,105,69,10,2,1,46,31,4,2,56,38,6,0
6480bba273adb498d96b27a9,2016,,,1,KK Nair,SW Billings,105,69,10,2,1,53,39,7,1,45,30,3,1
6480bb99350726d00af209bf,2022,,,1,F du Plessis,RM Patidar,105,73,10,4,1,52,35,6,2,48,38,4,2
6480bb94c5d20726ee59d3d6,2017,,,2,CA Lynn,SP Narine,105,37,11,8,1,49,20,5,4,54,17,6,4
6480bb97752fcb9cd9f23692,2021,,,1,DJ Hooda,KL Rahul,105,47,4,10,1,64,28,4,6,40,19,0,4
6480bb9f87652064dab6c573,2013,,,2,EJG Morgan,G Gambhir,105,71,14,0,1,40,33,5,0,60,38,9,0
6480bb9a51ee1ef33a5b2dbb,2007/08,,,2,DJ Hussey,WP Saha,104,55,4,7,1,58,28,3,4,46,27,1,3
6480bb9cafc843037dc1e863,2009,,,2,AM Rahane,JP Duminy,104,72,6,3,0,44,31,4,0,59,41,2,3
6480bb9a4de9fe3e7319ce39,2007/08,,,2,GC Smith,SR Watson,104,76,15,2,1,44,36,8,0,57,40,7,2
6480bb9a87f64c1a12f62ece,2007/08,,,1,ML Hayden,SK Raina,104,63,8,4,1,41,26,5,1,53,37,3,3
6480bba141bcb000fa6fe2a4,2015,,,2,CJ Anderson,KA Pollard,104,56,10,7,1,32,22,3,2,70,34,7,5
6480bba0ca27548122e36880,2013,,,1,MEK Hussey,WP Saha,103,61,12,3,1,63,38,8,1,39,23,4,2
6480bba2e30bef1d7b3bb753,2015,,,1,DA Warner,MC Henriques,103,45,9,5,1,40,23,4,1,57,22,5,4
6480bb9f59fd8000010baf09,2013,,,1,AB de Villiers,V Kohli,103,75,10,2,1,39,32,3,1,62,43,7,1
6480bb942fc9529eb2869c17,2018,,,1,AB de Villiers,Q de Kock,103,53,3,10,1,66,27,2,8,36,26,1,2
6480bb99ed38bcb4025b8d86,2023,,,1,RK Singh,SN Thakur,103,47,9,6,1,34,21,1,3,63,26,8,3
6480bba0fbf5f1671e1e557e,2013,,,2,CA Pujara,CH Gayle,102,69,11,3,1,35,36,5,0,61,33,6,3
6480bb9429a15517bb46f3be,2018,,,1,E Lewis,SA Yadav,102,54,11,5,1,48,28,4,4,47,26,7,1
6480bb97aad3147696268239,2021,,,1,AT Rayudu,RA Jadeja,102,49,6,7,0,72,27,4,7,22,22,2,0
6480bb9e95693a2c4c4531e8,2011,,,1,PC Valthaty,SE Marsh,102,65,10,6,1,51,37,5,3,46,28,5,3
6480bb9b46b4360184dc19f3,2007/08,,,2,DJ Hussey,SC Ganguly,102,48,7,8,1,52,25,4,3,48,23,3,5
6480bb9bca2c11520f5b3b9e,2007/08,,,1,PA Patel,SK Raina,102,75,11,4,0,44,41,7,0,55,34,4,4
6480bba0d3cbb27b257a9c1f,2013,,,1,AC Gilchrist,SE Marsh,102,78,11,1,1,42,32,6,0,54,46,5,1
6480bb9d038ed22e46cbeccb,2011,,,2,A Symonds,RG Sharma,102,65,9,4,0,44,33,4,1,56,32,5,3
6480bb9b724406459cd357c9,2007/08,,,1,LA Pomersbach,SE Marsh,102,56,11,4,0,34,24,3,2,61,32,8,2
6480bb94ce8e0a620532955b,2018,,,1,F du Plessis,SR Watson,102,66,5,8,1,33,33,3,1,66,33,2,7
6480bba2a215721aadf7a90a,2015,,,1,BB McCullum,F du Plessis,101,76,8,3,1,64,51,5,3,29,25,3,0
6480bb981f136a7564719d7f,2022,,,2,B Sai Sudharsan,Shubman Gill,101,68,10,2,1,35,30,4,1,64,38,6,1
6480bb9c7bc1dc527c14f1ac,2009/10,,,1,CH Gayle,MK Tiwary,101,50,4,8,1,71,28,3,8,22,22,1,0
6480bb9a07d46704efe103ef,2007/08,,,1,AC Gilchrist,HH Gibbs,101,68,10,4,1,45,34,4,2,47,34,6,2
6480bba2704d23da78c3eb15,2016,,,1,G Gambhir,RV Uthappa,101,81,10,2,1,54,45,6,1,46,36,4,1
6480bb9c44492d9e5fc4bb60,2009/10,,,1,BJ Hodge,MK Tiwary,101,70,13,2,1,48,41,7,0,50,29,6,2
6480bb942fc9529eb2869c17,2018,,,2,AT Rayudu,MS Dhoni,101,54,2,9,1,40,24,1,4,55,30,1,5
6480bb99f649ea7a6d79892f,2023,,,2,AK Markram,RA Tripathi,100,52,16,2,0,37,21,6,0,63,31,10,2
6480bba17bce347084729c56,2015,,,1,Harbhajan Singh,J Suchith,100,38,9,8,1,64,24,5,6,32,14,4,2
6480bba2eea6f31945e4c5e2,2016,,,1,G Gambhir,MK Pandey,100,60,5,4,1,44,31,2,1,52,29,3,3
6480bb965f597c872396f67c,2020/21,,,2,CH Gayle,Mandeep Singh,100,61,9,6,1,51,29,2,5,46,32,7,1
6480bba16e510ff78ef635a1,2014,,,2,KK Nair,SV Samson,100,57,10,4,1,50,27,7,2,49,30,3,2
6480bb996c324f07ab7f763c,2023,,,2,N Rana,VR Iyer,100,55,9,6,1,45,29,4,3,54,26,5,3
6480bba119569fcc2d7859a4,2014,,,1,DA Warner,S Dhawan,100,75,10,4,1,46,36,3,3,50,39,7,1
6480bb9bef0d1fffea8bfd11,2009,,,1,ML Hayden,MS Dhoni,100,47,8,7,1,46,24,2,5,49,23,6,2
6480bb973d98bfd2d4a5f108,2020/21,,,1,AB de Villiers,V Kohli,100,47,6,6,0,73,33,5,6,22,14,1,0
6480bba2f36e449a59f4a812,2015,,,2,CH Gayle,V Kohli,99,63,12,4,0,62,40,6,4,35,23,6,0
6480bb98cce4ab46512c2c03,2022,,,2,KL Rahul,Q de Kock,99,62,11,3,1,40,26,2,3,52,36,9,0
6480bb9fe8f5df13fc8d1bc3,2012,,,1,BB McCullum,G Gambhir,99,69,10,4,1,37,29,4,1,61,40,6,3
6480bba063bacaa2dfabf6fd,2014,,,2,M Vijay,Q de Kock,99,68,12,2,1,48,38,6,1,48,30,6,1
6480bb9d9f4551d7ec79c951,2009/10,,,1,IK Pathan,SE Marsh,99,48,7,6,0,44,27,4,1,53,21,3,5
6480bb980d1be75574871dcc,2022,,,1,RM Patidar,V Kohli,99,74,9,3,1,52,32,5,2,45,42,4,1
6480bb9448fe25ec89c5fcff,2017,,,1,LMP Simmons,PA Patel,99,52,12,4,1,57,29,5,4,38,23,7,0
6480bb9ae4498012aa089436,2023,,,2,N Rana,RK Singh,99,77,9,3,1,42,34,5,0,54,43,4,3
6480bb9d4e112d675b2925df,2009/10,,,2,G Gambhir,V Sehwag,99,58,10,3,1,47,29,6,1,46,29,4,2
6480bb96ec01f8fb3504bc36,2020/21,,,2,D Padikkal,V Kohli,99,80,9,2,1,46,37,5,0,50,43,4,2
6480bb9e173228d1b18e376b,2012,,,2,AM Rahane,R Dravid,99,83,11,0,1,55,45,6,0,40,38,5,0
6480bb95816d3ad3bc382ab6,2018,,,1,AM Rahane,RA Tripathi,99,69,8,2,1,33,31,3,0,62,38,5,2
6480bba0c9e6d590ed35eb56,2014,,,1,AB de Villiers,PA Patel,99,82,10,1,0,45,48,3,1,52,34,7,0
6480bb99a620a7afdb3217fe,2023,,,1,JC Buttler,YBK Jaiswal,98,51,18,1,1,35,20,7,0,60,31,11,1
6480bb96fb897a6ff486ffe4,2020/21,,,2,JC Buttler,SPD Smith,98,78,9,2,0,70,48,7,2,26,30,2,0
6480bb9a7194d8b20952afae,2007/08,,,1,G Gambhir,S Dhawan,98,60,9,4,1,48,27,5,1,50,33,4,3
6480bba0c1c8569f19cc70f0,2013,,,1,AM Rahane,R Dravid,98,71,12,2,1,37,31,3,1,58,40,9,1
6480bba0a9f68a29bda72302,2013,,,1,RN ten Doeschate,YK Pathan,98,67,10,2,1,42,30,4,1,56,37,6,1
6480bb9a1a3ab2ab8297871d,2007/08,,,2,GC Smith,YK Pathan,98,44,10,7,1,36,16,6,1,61,28,4,6
6480bba31cc11024436836b5,2016,,,1,KH Pandya,MJ Guptill,98,50,8,5,1,60,26,6,3,33,24,2,2
6480bba19701e99975ce7c59,2015,,,2,AB de Villiers,V Kohli,98,70,6,3,0,47,34,6,0,51,36,0,3
6480bb9c7bc1dc527c14f1ac,2009/10,,,2,DPMD Jayawardene,KC Sangakkara,98,53,9,4,1,58,31,7,2,38,22,2,2
6480bb99c6aa5989a16174d1,2023,,,2,D Padikkal,YBK Jaiswal,98,66,12,3,1,52,34,7,1,45,32,5,2
6480bb9b2abb1e5479b853f5,2009,,,1,G Gambhir,TM Dilshan,97,72,9,1,0,49,38,4,0,42,34,5,1
6480bb9fe8f5df13fc8d1bc3,2012,,,2,M Vijay,MEK Hussey,97,62,9,5,1,36,23,5,1,56,39,4,4
6480bba19e29de4f208211ac,2014,,,1,KA Pollard,RG Sharma,97,60,8,4,1,43,31,6,0,50,29,2,4
6480bba0c1c8569f19cc70f0,2013,,,2,AJ Finch,RV Uthappa,97,65,13,1,1,45,32,7,0,42,33,6,1
6480bb95e435367dc64d9844,2019,,,1,Q de Kock,SA Yadav,97,68,7,3,1,56,35,6,2,34,33,1,1
6480bb9c3803ef7726af83ab,2009/10,,,2,NV Ojha,SR Watson,97,44,6,8,1,34,19,1,3,60,25,5,5
6480bb987c720def5fbaf218,2022,,,1,MA Agarwal,S Dhawan,97,57,8,4,1,52,32,6,2,34,25,2,2
6480bb9dd778cb6c44535092,2009/10,,,1,BB McCullum,SC Ganguly,97,84,11,2,1,46,48,7,0,42,36,4,2
6480bb98bd3ca4df44cf9d8f,2022,,,1,KD Karthik,Shahbaz Ahmed,97,52,7,6,0,66,34,5,5,27,18,2,1
6480bba29f384ce360fa8131,2016,,,1,M Vijay,M Vohra,97,74,12,1,1,44,41,5,1,51,33,7,0
6480bb9824c4678d005d7aeb,2022,,,1,D Padikkal,JC Buttler,97,59,9,5,1,24,18,3,1,67,41,6,4
6480bb9f5867d07199aa832a,2013,,,2,AJ Finch,RV Uthappa,96,75,12,2,1,67,45,10,2,24,30,2,0
6480bb9eee740f701b0ee154,2011,,,1,MS Dhoni,S Badrinath,96,57,9,3,1,51,29,5,2,41,28,4,1
6480bb9b50f9e801edc13d5a,2007/08,,,2,SR Tendulkar,ST Jayasuriya,96,69,6,5,1,30,32,2,1,54,37,4,4
6480bb96ef6f4c2c85264241,2019,,,1,CA Lynn,Shubman Gill,96,57,11,4,1,54,29,8,2,42,28,3,2
6480bb9ea49fe0f895bf242a,2012,,,1,AT Rayudu,KA Pollard,96,52,7,6,1,29,19,1,2,64,33,6,4
6480bb9894cc2d00f057a1f1,2021,,,2,Shubman Gill,VR Iyer,96,74,5,3,1,31,33,1,0,55,41,4,3
6480bb979e91d1ff9b54c737,2020/21,,,1,RR Pant,SS Iyer,96,69,7,3,1,56,38,4,2,37,31,3,1
6480bb9e591b94e62772e66a,2012,,,2,AT Rayudu,KD Karthik,96,58,11,3,1,54,33,4,3,40,25,7,0
6480bb9f90a251567178de39,2012,,,2,CL White,S Dhawan,96,61,8,2,1,47,33,6,0,44,28,2,2
6480bb9561509a2f4f139254,2019,,,1,Q de Kock,RG Sharma,96,65,8,5,1,49,33,2,4,47,32,6,1
6480bba32e54551792a9e915,2016,,,1,BB McCullum,SK Raina,96,54,14,3,1,48,27,8,1,45,27,6,2
6480bb9fa236b26050f19633,2012,,,2,KP Pietersen,V Sehwag,96,59,12,2,1,36,34,3,1,55,25,9,1
6480bb99315aee6cd9d56504,2023,,,1,F du Plessis,V Kohli,96,69,7,4,1,31,25,3,0,61,44,4,4
6480bb94988cb8c136ec7e46,2018,,,1,CH Gayle,KL Rahul,96,48,14,4,1,58,26,7,4,37,22,7,0
6480bb9bbb0ec0266749f518,2007/08,,,2,RG Sharma,VVS Laxman,96,70,10,3,1,57,42,5,3,37,28,5,0
6480bb9800ba03eb1f9437d2,2022,,,1,AK Markram,Abhishek Sharma,96,61,6,5,1,41,31,2,2,53,30,4,3
6480bb999424dd02cf40772a,2022,,,2,DJ Hooda,KL Rahul,96,61,3,7,1,45,26,1,4,48,35,2,3
6480bb9f014bd6e0ac2b51a8,2013,,,2,RG Sharma,SR Tendulkar,96,67,7,4,1,52,33,5,2,42,34,2,2
6480bba23ed328dbb847b4e7,2016,,,2,AD Russell,YK Pathan,96,44,6,6,1,39,24,1,4,45,20,5,2
6480bba1ebb63d1bd8c60b9d,2014,,,1,DA Miller,M Vohra,96,60,8,3,1,41,32,4,1,42,28,4,2
6480bb981dc3f7250f93bc92,2022,,,1,DJ Hooda,KL Rahul,95,61,8,3,1,52,34,6,1,38,27,2,2
6480bb9edb0554f003f5428a,2012,,,1,BB McCullum,G Gambhir,95,63,16,1,1,43,37,8,0,49,26,8,1
6480bb9c2778066dafd78a71,2009/10,,,2,A Symonds,HH Gibbs,95,75,8,3,1,41,40,3,2,45,35,5,1
6480bba0bc196f7168b3d989,2013,,,2,DA Miller,SE Marsh,95,52,9,4,1,48,24,5,2,46,28,4,2
6480bb9b9ca80d1c48994e04,2007/08,,,2,MS Dhoni,S Badrinath,95,61,12,3,1,38,33,5,1,51,28,7,2
6480bb9d7aa8d2c4c947d164,2009/10,,,1,JH Kallis,V Kohli,95,52,7,4,1,36,21,5,0,50,31,2,4
6480bba065b341458c934986,2013,,,1,DA Warner,UBT Chand,95,76,8,3,1,61,39,5,3,33,37,3,0
6480bba1827557ebdfc70821,2015,,,2,AD Russell,YK Pathan,95,59,13,2,1,66,36,9,2,28,23,4,0
6480bb98e87e6f83b61088ea,2022,,,1,LS Livingstone,S Dhawan,95,52,8,6,1,55,29,4,5,33,23,4,1
6480bb95f37ebb69ffb216e0,2019,,,1,AD Russell,KD Karthik,95,53,7,6,1,62,28,4,6,27,25,3,0
6480bb954e496ec9b12aa120,2019,,,2,AT Rayudu,MS Dhoni,95,71,3,5,1,45,36,2,2,44,35,1,3
6480bb99864a94e086c8395e,2022,,,2,Ishan Kishan,RG Sharma,95,66,6,5,1,38,30,4,1,48,36,2,4
6480bb9a8ac627a1ebf8dacf,2007/08,,,2,MEK Hussey,MS Dhoni,95,47,11,5,1,29,17,2,2,65,30,9,3
6480bb95b33a36f0dd77d1a1,2018,,,2,AM Rahane,JC Buttler,95,74,10,2,1,37,36,4,0,55,38,6,2
6480bb9558345af5a1bb044d,2019,,,1,AB de Villiers,MM Ali,95,61,4,7,1,44,29,3,2,50,32,1,5
6480bb9c07d77f83fb139c41,2009,,,1,A Symonds,Y Venugopal Rao,95,57,3,6,1,58,32,2,4,32,25,1,2
6480bba1017a98eead1ec861,2015,,,1,AM Rahane,SR Watson,95,69,10,2,1,43,34,5,0,45,35,5,2
6480bb9d79d603cc45fc9b3c,2011,,,1,AT Rayudu,SR Tendulkar,95,72,10,2,1,51,37,8,1,42,35,2,1
6480bb9f9eae77e599a46300,2012,,,2,CH Gayle,V Kohli,94,58,3,7,0,55,33,2,5,36,25,1,2
6480bb9fc28e897b3c53f359,2012,,,1,MEK Hussey,S Badrinath,94,72,13,2,1,43,33,7,1,47,39,6,1
6480bb9d4e112d675b2925df,2009/10,,,1,CH Gayle,SC Ganguly,94,62,12,3,1,40,21,5,2,49,41,7,1
6480bba0587190387a754733,2013,,,2,AB de Villiers,V Kohli,94,40,8,6,1,32,17,2,2,62,23,6,4
6480bb9edbd8851db7e06741,2012,,,2,KC Sangakkara,S Dhawan,94,64,12,1,1,44,32,5,1,42,32,7,0
6480bb9f955d5c84cde78f58,2012,,,1,AM Rahane,SR Watson,94,60,9,4,1,36,29,3,0,58,31,6,4
6480bba3412663673a969a24,2016,,,1,KL Rahul,V Kohli,94,67,5,5,1,38,35,1,2,52,32,4,3
6480bb9af1b34d6aa89e434e,2023,,,1,DA Warner,PP Shaw,94,62,11,3,1,46,31,5,2,46,31,6,1
6480bb97ea8bfb43e3f7515f,2020/21,,,1,PP Shaw,S Dhawan,94,64,11,2,1,57,37,8,1,35,27,3,1
6480bb93f866249511c76dbc,2017,,,1,BB McCullum,DR Smith,94,53,13,4,1,45,23,5,3,47,30,8,1
6480bb989bf19eb260a04f0e,2022,,,2,AK Markram,RA Tripathi,94,54,6,7,1,35,23,4,1,59,31,2,6
6480bb964752e7c0f9e39d3c,2020/21,,,2,Q de Kock,RG Sharma,94,63,13,3,1,54,27,8,2,35,36,5,1
6480bba0da054e3d917f71fb,2013,,,1,SR Watson,STR Binny,93,45,7,7,1,57,23,5,5,35,22,2,2
6480bba278153a5979e31ec9,2016,,,2,BB McCullum,DR Smith,93,49,11,3,1,43,22,5,2,46,27,6,1
6480bb962fbc99d08dc59f56,2020/21,,,2,CH Gayle,KL Rahul,93,71,1,8,1,53,45,1,5,33,26,0,3
6480bb957e6d387fe3a6b26e,2018,,,1,RR Pant,SS Iyer,93,62,8,4,1,61,34,5,4,28,28,3,0
6480bb9e9162dceff15dc334,2011,,,1,BB McCullum,DPMD Jayawardene,93,52,8,3,1,32,27,2,2,42,25,6,1
6480bb98291bb8b3f3e8145d,2022,,,1,DA Warner,PP Shaw,93,52,12,3,1,37,23,5,1,51,29,7,2
6480bb9e59fe7a0f48b7f9b9,2012,,,2,JD Ryder,SC Ganguly,93,64,9,2,1,41,29,4,1,41,35,5,1
6480bb975156c246a0ee40b1,2021,,,1,N Rana,RA Tripathi,93,50,6,6,1,40,21,1,4,53,29,5,2
6480bba07b5396a7b65684d3,2013,,,1,DR Smith,SR Tendulkar,93,78,14,0,1,41,50,6,0,48,28,8,0
6480bb9359a2cade3b5213d3,2017,,,2,KA Pollard,KH Pandya,93,57,5,5,1,56,31,3,4,31,26,2,1
6480bb9482dff502bff80bcf,2017,,,2,MC Henriques,Yuvraj Singh,93,51,13,1,0,25,18,2,0,65,33,11,1
6480bb9cd0eb4289b2222e37,2009/10,,,1,JH Kallis,MK Pandey,93,64,14,1,0,44,34,7,0,42,30,7,1
6480bba28724848c0f3ef034,2015,,,1,HH Pandya,KA Pollard,92,52,8,3,0,61,31,8,2,24,21,0,1
6480bb9e05571c1a4c163ef1,2012,,,2,AL Menaria,OA Shah,92,65,6,3,1,36,34,2,1,43,31,4,2
6480bb999424dd02cf40772a,2022,,,1,KD Karthik,RM Patidar,92,41,8,6,0,37,23,5,1,49,18,3,5
6480bb973e451a92813d78cc,2020/21,,,2,EJG Morgan,Shubman Gill,92,70,5,3,0,42,29,3,2,45,41,2,1
6480bb948a69b3d86293b12b,2017,,,1,AJ Finch,KD Karthik,92,58,6,4,1,49,31,3,3,36,27,3,1
6480bb9dfa7d0510ae3a7b40,2011,,,2,KC Sangakkara,S Sohal,92,63,14,1,1,49,35,8,1,40,28,6,0
6480bb94bf9a1728b1b12f4d,2018,,,1,AD Hales,KS Williamson,92,68,9,2,1,34,30,2,0,58,38,7,2
6480bb955f4b3a84d6973620,2018,,,1,RR Pant,SS Iyer,92,43,8,5,1,63,26,7,4,24,17,1,1
6480bb94457bfc7687322f80,2017,,,2,AJ Finch,SK Raina,92,49,7,6,1,72,34,5,6,16,15,2,0
6480bb99349f00f851e8d2fd,2023,,,1,Harpreet Singh,SM Curran,92,50,7,6,1,40,26,4,2,46,24,3,4
6480bb9c54a72690027ba3d4,2009/10,,,2,S Dhawan,SR Tendulkar,92,54,8,3,1,56,34,5,3,24,20,3,0
6480bba296f606ef91305124,2016,,,2,G Gambhir,RV Uthappa,92,75,10,1,1,50,41,7,0,38,34,3,1
6480bb9825eb960aded1ff64,2022,,,1,AT Rayudu,RD Gaikwad,92,56,6,6,1,46,31,4,2,45,25,2,4
6480bb9506d56930505d45ae,2019,,,2,S Dhawan,SS Iyer,92,64,8,2,1,45,33,5,1,39,31,3,1
6480bb95c701f5c8388f7f88,2018,,,2,PA Patel,V Kohli,92,50,13,2,0,40,22,7,0,48,28,6,2
6480bb975156c246a0ee40b1,2021,,,2,JM Bairstow,MK Pandey,92,65,7,4,1,55,40,5,3,35,25,2,1
6480bba2fbc243afec641844,2015,,,2,F du Plessis,SK Raina,92,70,8,1,1,52,40,5,1,34,30,3,0
6480bb9d7aa8d2c4c947d164,2009/10,,,2,A Symonds,TL Suman,91,46,6,6,0,53,24,5,3,36,22,1,3
6480bba1ece63aa1c77a954e,2015,,,2,DJ Bravo,MS Dhoni,91,65,11,1,0,54,28,7,1,31,37,4,0
6480bba21bbf76a62abea528,2016,,,1,AM Rahane,MS Dhoni,91,73,9,0,1,49,38,6,0,39,35,3,0
6480bba3041017fe2c0593f2,2016,,,2,AB de Villiers,Iqbal Abdulla,91,53,6,5,0,51,28,3,4,33,25,3,1
6480bb95430629e254bbc4fd,2018,,,1,E Lewis,SA Yadav,91,56,11,4,1,43,28,5,2,47,28,6,2
6480bb9fe489b0d429e97599,2012,,,1,CH Gayle,TM Dilshan,91,64,8,4,1,26,22,1,2,62,42,7,2
6480bb94f1c027945eeb8b10,2017,,,1,MC Henriques,S Dhawan,91,66,10,2,1,44,35,6,0,46,31,4,2
6480bb974123cbc9756ceefa,2021,,,2,KL Rahul,MA Agarwal,91,66,6,4,1,39,35,1,2,47,31,5,2
6480bb9f3ca20834ecc7607a,2012,,,1,JH Kallis,YK Pathan,91,62,6,3,1,49,31,4,2,40,31,2,1
6480bba2e680f2464af841ae,2015,,,1,KM Jadhav,SS Tiwary,91,58,10,3,0,62,33,8,2,26,25,2,1
6480bb950ddd55d8aed7d015,2019,,,2,CA Lynn,SP Narine,91,51,11,5,1,38,26,5,2,47,25,6,3
6480bba2b5d601f8354f5b5a,2016,,,1,Q de Kock,SV Samson,91,64,10,2,1,48,32,7,1,33,32,3,1
6480bb9384cbae8edee3707f,2017,,,2,CH Morris,K Rabada,91,73,8,2,1,45,38,4,1,42,35,4,1
6480bb94351a8b10e20d14d9,2017,,,2,DR Smith,Ishan Kishan,91,57,11,2,1,60,33,8,2,29,24,3,0
6480bb9b8860198955e581d8,2007/08,,,1,MS Dhoni,S Badrinath,91,64,5,5,1,44,34,1,3,44,30,4,2
6480bb9d93cca4d1a7635fba,2011,,,1,AB de Villiers,TM Dilshan,91,74,7,2,1,38,36,3,1,44,38,4,1
6480bb98373b1ea5035ab3da,2021,,,2,Shubman Gill,VR Iyer,91,64,10,3,1,39,32,5,0,50,32,5,3
6480bba1b85900d7d83de308,2014,,,2,M Vohra,WP Saha,91,41,13,3,1,36,15,5,1,54,26,8,2
6480bb96d1b3bea0aa2127e4,2020/21,,,1,RG Sharma,SA Yadav,90,58,7,4,1,41,30,1,3,47,28,6,1
6480bba2f3ed8323f852acfa,2016,,,1,DA Warner,S Dhawan,90,59,9,3,1,59,31,7,3,28,28,2,0
6480bba250b404cdcbff22c8,2015,,,2,LMP Simmons,PA Patel,90,65,7,5,1,52,40,3,4,35,25,4,1
6480bb98d2cd0fa3ed0ffc21,2022,,,2,AD Russell,SW Billings,90,47,2,9,0,70,31,2,8,16,16,0,1
6480bb9523e6dc3c988ce398,2019,,,1,MM Ali,V Kohli,90,43,6,7,1,66,28,5,6,22,15,1,1
6480bb9f9a70ecf3467829df,2013,,,1,MEK Hussey,SK Raina,90,61,9,2,1,36,26,5,0,51,35,4,2
6480bb9a58bc8710c38f4c1c,2023,,,2,Ishan Kishan,RG Sharma,90,58,7,4,1,49,33,6,1,37,25,1,3
6480bb9ed6aefcc9cd13d851,2012,,,2,MJ Clarke,SC Ganguly,90,69,12,1,1,41,31,7,0,45,38,5,1
6480bb991a76403912eef285,2023,,,1,P Simran Singh,S Dhawan,90,58,10,3,1,60,34,7,3,26,24,3,0
6480bb9bef0d1fffea8bfd11,2009,,,2,DPMD Jayawardene,Yuvraj Singh,90,53,7,3,0,44,25,3,2,42,28,4,1
6480bb96593f4f87a2c294bc,2020/21,,,1,AJ Finch,D Padikkal,90,68,9,2,1,29,26,1,2,56,42,8,0
6480bb9ccfdcb55be258ec95,2009,,,2,BB McCullum,BJ Hodge,90,56,8,4,1,52,33,6,2,34,23,2,2
6480bb9d59f2ded94f736145,2011,,,2,CL White,KC Sangakkara,90,69,11,1,1,31,34,2,1,58,35,9,0
6480bb9b4b74852492343291,2007/08,,,2,G Gambhir,V Sehwag,90,42,15,1,1,33,23,6,0,47,19,9,1
6480bb9e3db1392e753dd785,2012,,,2,KP Pietersen,V Sehwag,89,50,8,4,1,27,21,1,2,58,29,7,2
6480bba069c0322e91e50958,2013,,,1,PA Patel,S Dhawan,89,69,10,2,1,45,34,7,0,42,35,3,2
6480bb98c0ad46409044aad2,2022,,,2,Abhishek Sharma,KS Williamson,89,73,6,3,1,56,33,4,2,32,40,2,1
6480bb9a8ac627a1ebf8dacf,2007/08,,,1,LRPL Taylor,W Jaffer,89,47,8,4,1,39,22,3,2,47,25,5,2
6480bb9c5d0fccb6a3a6d37d,2009,,,1,ML Hayden,S Badrinath,89,65,9,2,1,36,31,2,1,45,34,7,1
6480bb99f33a7dd80eb0a544,2023,,,1,A Badoni,MP Stoinis,89,47,6,6,1,39,20,2,3,47,27,4,3
6480bb9e65a802582c071438,2012,,,1,DA Miller,DJ Hussey,89,43,4,6,0,34,17,1,3,48,26,3,3
6480bb97951f1bc43b462c46,2021,,,2,S Dube,SV Samson,89,58,7,4,1,59,38,4,4,24,20,3,0
6480bb9ba6cd609c32579bde,2009,,,1,BJ Hodge,MN van Wyk,89,75,7,2,1,51,40,4,2,32,35,3,0
6480bb96686655f09172741d,2020/21,,,1,MP Stoinis,RR Pant,89,43,8,4,1,48,23,5,2,33,20,3,2
6480bba237377ccc608266d2,2016,,,1,GJ Maxwell,SE Marsh,89,61,8,2,1,48,32,5,1,39,29,3,1
6480bb95f37ebb69ffb216e0,2019,,,2,PP Shaw,SS Iyer,89,56,7,5,1,44,24,3,3,43,32,4,2
6480bb97aad3147696268239,2021,,,2,KA Pollard,KH Pandya,89,41,5,8,1,56,21,3,6,30,20,2,2
6480bba1f2392e6761d39d66,2014,,,1,DJ Hussey,SK Raina,89,56,5,5,0,40,29,2,3,46,27,3,2
6480bb976caaa0cc91f652c7,2021,,,2,RA Tripathi,VR Iyer,88,52,7,3,1,55,31,6,2,26,21,1,1
6480bb96c10dfe3d8c259db3,2020/21,,,2,AM Rahane,S Dhawan,88,65,9,1,1,42,29,5,1,44,36,4,0
6480bba0e52e9733fc6d9937,2013,,,1,KA Pollard,RG Sharma,88,47,5,7,0,20,21,1,1,63,26,4,6
6480bb9baa08d0494c0b8dc3,2007/08,,,1,GC Smith,SR Watson,88,46,10,1,0,35,18,4,1,46,28,6,0
6480bb96902b7c96b94f406a,2019,,,2,RG Sharma,SA Yadav,88,60,11,2,0,41,33,6,0,46,27,5,2
6480bb94ce8e0a620532955b,2018,,,2,RR Pant,V Shankar,88,53,7,4,1,60,32,6,3,24,21,1,1
6480bb9edbd8851db7e06741,2012,,,2,DT Christian,JP Duminy,88,41,5,6,0,26,15,2,1,58,26,3,5
6480bb9aa37f3b44678752d9,2023,,,2,AS Joseph,Rashid Khan,88,40,4,10,0,7,12,1,0,77,28,3,10
6480bba30373b229e0090b67,2016,,,2,AB de Villiers,Sachin Baby,88,55,6,2,1,61,32,5,2,27,23,1,0
6480bb97dee20878b0c4246c,2021,,,1,PP Shaw,S Dhawan,88,62,7,3,1,40,27,4,1,43,35,3,2
6480bb9a6a7169d0e413bcfa,2023,,,2,KR Mayers,Q de Kock,88,50,14,2,1,48,32,7,2,35,18,7,0
6480bb9db6a011b38afed5dc,2011,,,2,BJ Hodge,RA Jadeja,88,64,5,5,1,38,33,2,2,46,31,3,3
6480bb9e2c96ab2b87d9466a,2011,,,2,JR Hopes,Y Venugopal Rao,87,65,13,1,1,49,40,9,0,36,25,4,1
6480bb9dbefe5e2cceb23e01,2011,,,1,A Symonds,RG Sharma,87,49,5,6,1,30,24,1,2,54,25,4,4
6480bb9a7194d8b20952afae,2007/08,,,2,JH Kallis,R Dravid,87,64,8,2,1,40,34,4,1,38,30,4,1
6480bb9af85f41b4de44ca19,2023,,,1,DP Conway,RD Gaikwad,87,64,10,1,1,25,20,3,0,60,44,7,1
6480bb96a43476c5d9a56c4e,2020/21,,,1,F du Plessis,SR Watson,87,67,11,2,1,50,39,5,2,36,28,6,0
6480bb99c26e725b7b6f1637,2023,,,2,JC Buttler,YBK Jaiswal,87,70,8,3,1,35,35,4,1,44,35,4,2
6480bba18a289cc4b8d173a4,2014,,,1,LMP Simmons,MEK Hussey,87,48,12,1,1,35,25,5,0,44,23,7,1
6480bb981b01a21305fd65d5,2022,,,2,PBB Rajapaksa,S Dhawan,87,59,10,2,1,40,28,5,1,42,31,5,1
6480bb964752e7c0f9e39d3c,2020/21,,,1,EJG Morgan,PJ Cummins,87,56,6,4,0,32,20,1,2,53,36,5,2
6480bba38056992b92414bab,2016,,,1,MK Pandey,YK Pathan,87,49,4,5,1,44,25,2,3,41,24,2,2
6480bba2965d1d15aa6f723e,2016,,,1,CH Morris,JP Duminy,87,39,3,9,1,59,19,1,8,28,20,2,1
6480bb9fc9e4047271240a59,2012,,,2,M Vijay,MEK Hussey,87,64,7,3,1,42,32,4,1,41,32,3,2
6480bb9836d24b9817a35f7d,2022,,,1,A Badoni,DJ Hooda,87,68,8,4,1,35,30,2,2,51,38,6,2
6480bb99cbb648c5c0ecb205,2023,,,2,DA Miller,V Shankar,87,39,4,7,0,32,18,2,2,49,21,2,5
6480bb95b33a36f0dd77d1a1,2018,,,1,E Lewis,SA Yadav,87,64,11,2,1,45,33,4,2,38,31,7,0
6480bb984f6c41cd28aa0353,2022,,,1,DJ Hooda,KL Rahul,87,62,6,3,1,51,33,3,3,35,29,3,0
6480bb9e2c96ab2b87d9466a,2011,,,1,AT Rayudu,RG Sharma,87,56,6,4,1,35,24,4,1,49,32,2,3
6480bb93894ff5c944493650,2017,,,1,KD Karthik,SK Raina,87,57,9,2,1,47,25,6,2,38,32,3,0
6480bb9561509a2f4f139254,2019,,,2,JC Buttler,SV Samson,87,42,6,7,1,67,26,5,6,18,16,1,1
6480bb99cf7659c6e45bd01d,2023,,,2,DP Conway,RD Gaikwad,87,66,10,1,1,50,36,8,1,35,30,2,0
6480bb9cf1471ad233c7b0af,2009,,,1,AB de Villiers,TM Dilshan,87,83,7,0,1,52,42,6,0,33,41,1,0
6480bb9ccba48a6bb44ccc21,2009,,,1,ML Hayden,MS Dhoni,87,50,6,1,0,44,28,4,1,23,22,2,0
6480bba192383a244f185c5a,2014,,,2,DR Smith,SK Raina,86,44,9,4,1,37,18,3,3,46,26,6,1
6480bb99f816e64203e3c687,2023,,,1,PBB Rajapaksa,S Dhawan,86,55,11,2,1,50,32,5,2,34,23,6,0
6480bb9dd4e6757f7ded95e9,2009/10,,,1,DPMD Jayawardene,KC Sangakkara,86,64,13,1,1,30,27,4,0,52,37,9,1
6480bb954da239b357833c8a,2018,,,1,PP Shaw,SS Iyer,86,51,8,3,1,58,29,6,2,27,22,2,1
6480bb9fe489b0d429e97599,2012,,,2,DJ Harris,S Dhawan,86,71,7,4,1,47,41,2,4,36,30,5,0
6480bb978c66ea3d9c85132d,2020/21,,,1,MP Stoinis,S Dhawan,86,51,10,2,1,38,27,5,1,45,24,5,1
6480bb9b69f390d624466843,2007/08,,,1,DB Das,Salman Butt,86,67,7,3,1,27,32,1,2,53,35,6,1
6480bba2f05e90a9005771d2,2015,,,1,DA Warner,S Dhawan,86,50,13,1,1,61,28,11,1,22,22,2,0
6480bba22daffa649f339a05,2016,,,2,F du Plessis,KP Pietersen,86,61,5,4,1,48,30,3,3,37,31,2,1
6480bb95c28e7980e1768064,2018,,,1,SK Raina,SR Watson,86,57,7,3,1,48,30,6,1,32,27,1,2
6480bb97a4220e27710e38de,2021,,,1,D Padikkal,GJ Maxwell,86,57,10,2,1,23,23,2,0,60,34,8,2
6480bb9d6ea22feab98beb5b,2011,,,2,R Dravid,SR Watson,86,61,14,0,1,49,35,9,0,32,26,5,0
6480bb9a21e416835389fd53,2023,,,1,DP Conway,RD Gaikwad,86,58,12,2,1,45,27,8,1,37,31,4,1
6480bb9834c7569d5fa64353,2022,,,1,A Manohar,HH Pandya,86,55,7,4,1,43,28,4,2,42,27,3,2
6480bb99409885bcc7b67109,2023,,,1,JC Buttler,YBK Jaiswal,86,50,10,3,1,27,21,4,0,53,29,6,3
6480bb9dd4e6757f7ded95e9,2009/10,,,1,DPMD Jayawardene,Yuvraj Singh,86,51,10,3,1,63,31,9,2,20,20,1,1
6480bb9aded509be64de3bfb,2007/08,,,1,ML Hayden,MS Dhoni,86,52,5,3,0,36,25,2,1,43,27,3,2
6480bb9ca181f55cb21526f5,2009/10,,,2,JH Kallis,MK Pandey,85,59,11,2,1,43,32,8,0,40,27,3,2
6480bb967c50ceac62ba0719,2020/21,,,1,S Dhawan,SS Iyer,85,62,8,1,1,42,29,3,1,42,33,5,0
6480bba18a289cc4b8d173a4,2014,,,2,JP Duminy,MK Tiwary,85,54,5,5,1,41,25,0,4,40,29,5,1
6480bba3041017fe2c0593f2,2016,,,1,DR Smith,KD Karthik,85,61,7,4,1,58,34,5,4,24,27,2,0
6480bb931ee18ac840f40603,2017,,,2,JC Buttler,N Rana,85,44,1,8,1,37,20,1,3,45,24,0,5
6480bb9d66dc7da0d45e453c,2011,,,1,G Gambhir,MK Tiwary,85,78,7,1,0,39,37,4,0,34,41,3,1
6480bb939b2499e9af6ee18c,2017,,,1,JC Buttler,N Rana,85,54,5,4,1,23,18,1,2,53,36,4,2
6480bb964592640608a9163c,2020/21,,,2,R Parag,R Tewatia,85,47,6,4,0,37,19,2,2,45,28,4,2
6480bb99e909d98c8193bac5,2023,,,1,JC Buttler,YBK Jaiswal,85,35,13,3,1,54,22,7,3,30,13,6,0
6480bba16796f9a72374865f,2015,,,1,G Gambhir,MK Pandey,85,55,7,4,1,44,31,5,1,40,24,2,3
6480bb99bbae76f3f761d060,2023,,,1,AM Rahane,S Dube,85,32,4,8,1,33,11,2,3,50,21,2,5
6480bb9575ad32214d0f6ec0,2019,,,1,DA Miller,KL Rahul,85,52,4,4,1,34,23,1,2,45,29,3,2
6480bba08ffdd4393211d261,2014,,,2,BB McCullum,DR Smith,85,65,6,5,1,40,33,3,2,42,32,3,3
6480bba13b673297bce003e2,2014,,,2,V Kohli,YV Takawale,85,63,8,2,1,38,31,3,1,44,32,5,1
6480bb971ffe5345804e7f32,2020/21,,,1,S Dhawan,SS Iyer,85,57,7,2,1,51,28,5,2,29,29,2,0
6480bba3b830360cf7031278,2016,,,2,S Dhawan,Yuvraj Singh,85,49,9,3,1,44,26,6,1,39,23,3,2
6480bba03ef1ed797291b091,2013,,,1,KA Pollard,RG Sharma,85,38,2,10,0,66,27,2,8,17,11,0,2
6480bb95fbd4f1b7f3d8dfc0,2019,,,2,AB de Villiers,V Kohli,85,70,9,0,1,41,31,5,0,43,39,4,0
6480bb9c968c81bdfcc6df5b,2009,,,1,TM Dilshan,V Sehwag,85,59,11,1,1,40,28,6,1,39,31,5,0
6480bb94b882fb725e3f98e5,2018,,,1,CH Gayle,KK Nair,85,44,3,7,1,52,23,0,6,31,21,3,1
6480bb980ea7c3bcea4fdf9c,2022,,,1,DJ Hooda,Q de Kock,85,59,5,4,1,34,28,1,2,43,31,4,2
6480bba22daffa649f339a05,2016,,,1,AJ Finch,BB McCullum,85,51,9,4,1,50,36,7,2,29,15,2,2
6480bba3b830360cf7031278,2016,,,2,DA Warner,S Dhawan,85,59,11,1,1,48,33,7,1,34,26,4,0
6480bba1568e0f3990191600,2014,,,2,JP Faulkner,SPD Smith,85,33,7,6,0,41,17,3,3,39,16,4,3
6480bba0cdc200ad3ab8fbf5,2014,,,2,CJ Anderson,RG Sharma,84,64,6,3,1,38,29,3,1,46,35,3,2
6480bba22349149c9ec92d49,2016,,,1,SPD Smith,SS Tiwary,84,45,7,5,1,45,23,4,3,36,22,3,2
6480bb95430629e254bbc4fd,2018,,,2,N Rana,RV Uthappa,84,56,9,4,1,29,22,3,1,54,34,6,3
6480bb952f20835ddd6e533f,2019,,,1,CH Gayle,SN Khan,84,42,10,3,1,52,22,6,3,26,20,4,0
6480bb987c720def5fbaf218,2022,,,2,D Brevis,Tilak Varma,84,41,7,7,1,49,23,4,5,34,18,3,2
6480bb9bb070eb19f9ac8a76,2007/08,,,1,KC Sangakkara,SE Marsh,84,46,9,4,1,50,25,7,2,33,21,2,2
6480bb99315aee6cd9d56504,2023,,,2,A Badoni,N Pooran,84,35,7,6,1,22,18,3,0,56,17,4,6
6480bba223f162806c0794ac,2015,,,2,LMP Simmons,PA Patel,84,61,9,2,1,38,29,3,2,45,32,6,0
6480bba23ed328dbb847b4e7,2016,,,1,KL Rahul,V Kohli,84,58,8,2,1,51,30,6,2,32,28,2,0
6480bb956e3f7f62e4b24c01,2019,,,2,PP Shaw,RR Pant,84,48,8,3,1,23,18,2,1,60,30,6,2
6480bba0a222eb875a07f5a3,2014,,,2,V Kohli,Yuvraj Singh,84,48,3,8,0,30,19,0,3,52,29,3,5
6480bb9797043717cd96890a,2021,,,1,MK Lomror,SV Samson,84,55,4,4,1,27,26,1,1,52,29,3,3
6480bba0da054e3d917f71fb,2013,,,2,M Vijay,MEK Hussey,83,69,11,0,1,37,29,5,0,40,40,6,0
6480bb97b97c36ac8be3582f,2021,,,2,DA Warner,MK Pandey,83,66,8,3,1,47,32,6,1,33,34,2,2
6480bb9813fa79617f791851,2022,,,1,JC Buttler,SO Hetmyer,83,51,4,6,0,37,20,0,4,42,31,4,2
6480bb966539f85263cb6429,2019,,,1,F du Plessis,SK Raina,83,61,8,2,1,35,30,2,2,44,31,6,0
6480bb9d716a89dbf5e486d0,2011,,,2,DA Warner,Y Venugopal Rao,83,61,8,3,1,39,27,5,1,42,34,3,2
6480bb979e8cc2484c1a8c7b,2020/21,,,1,Ishan Kishan,SA Yadav,83,59,8,2,1,36,35,4,1,39,24,4,1
6480bb931ee18ac840f40603,2017,,,1,GJ Maxwell,HM Amla,83,34,9,5,1,40,18,4,3,38,16,5,2
6480bb98dd9a2108c79e1014,2022,,,2,DA Warner,PP Shaw,83,39,14,1,1,37,19,7,0,41,20,7,1
6480bb9bdde9db92f880e40d,2007/08,,,2,KC Sangakkara,SE Marsh,83,57,8,3,1,45,35,5,1,35,22,3,2
6480bb958c7b985a2b586a02,2018,,,2,KD Karthik,Shubman Gill,83,36,9,3,0,45,18,7,1,34,18,2,2
6480bb9822eeb0c1c117f221,2021,,,1,RR Pant,SO Hetmyer,83,50,5,3,1,40,26,2,2,37,24,3,1
6480bb9b0e32875998e9bfdc,2009,,,2,GC Smith,YK Pathan,83,47,4,6,0,17,17,1,0,62,30,3,6
6480bb953aab41e7ed166b9d,2019,,,1,CA Ingram,S Dhawan,83,56,11,2,1,47,32,7,1,36,24,4,1
6480bb98bc3569cc8d04101a,2022,,,1,SA Yadav,Tilak Varma,83,49,8,4,1,44,22,5,2,38,27,3,2
6480bb9e32ed1b9e077b8c11,2011,,,2,CH Gayle,V Kohli,83,62,6,4,0,43,28,3,3,39,34,3,1
6480bb9f218f37b46bef4afb,2013,,,2,AJ Finch,RV Uthappa,83,63,10,1,1,44,30,6,1,37,33,4,0
6480bb9908b154f78b12b8fb,2023,,,1,JJ Roy,N Jagadeesan,83,56,8,5,1,55,27,4,5,27,29,4,0
6480bb995f3db9699a1f794d,2022,,,1,DP Conway,MM Ali,83,39,12,4,1,16,14,1,1,66,25,11,3
6480bb9f210b6e50fb2072ae,2013,,,1,AB de Villiers,CH Gayle,83,51,4,7,0,22,22,2,1,54,29,2,6
6480bb96e76ccde6082d7564,2020/21,,,1,KD Karthik,Shubman Gill,82,43,10,2,1,53,23,7,2,28,20,3,0
6480bba2a01f4062fc561247,2016,,,2,G Gambhir,RV Uthappa,82,51,11,0,1,22,23,2,0,53,28,9,0
6480bb9993e6e474a4e37366,2023,,,2,AM Rahane,RD Gaikwad,82,44,7,3,1,61,27,7,3,14,17,0,0
6480bb955f4b3a84d6973620,2018,,,2,DJM Short,JC Buttler,82,40,5,7,1,13,14,1,0,67,26,4,7
6480bb9a58bc8710c38f4c1c,2023,,,1,KH Pandya,MP Stoinis,82,59,1,4,1,36,28,0,1,41,31,1,3
6480bb9f36da1a646c80be45,2013,,,2,DA Warner,MC Juneja,82,48,7,4,1,52,28,3,4,28,20,4,0
6480bb9c761c43b2dfb9767d,2009,,,2,DJ Bravo,SR Tendulkar,82,65,8,2,0,37,36,4,1,41,29,4,1
6480bb9b9ca80d1c48994e04,2007/08,,,1,SR Tendulkar,ST Jayasuriya,82,44,4,8,1,12,16,1,1,59,28,3,7
6480bb9a325c576efe386437,2023,,,1,F du Plessis,V Kohli,82,63,9,1,1,45,32,5,1,36,31,4,0
6480bb9fd9db46138a9bb209,2013,,,2,AB de Villiers,V Kohli,82,49,6,2,1,41,23,6,0,37,26,0,2
6480bb9c4934a2adde9d76ce,2009/10,,,2,CH Gayle,OA Shah,82,50,8,1,1,46,27,5,1,31,23,3,0
6480bb9698a1d9136a13faf6,2020/21,,,2,F du Plessis,RD Gaikwad,82,59,6,3,1,48,34,4,2,25,25,2,1
6480bb97e5be965d3c00760e,2021,,,2,Shubman Gill,VR Iyer,82,56,10,2,1,48,34,6,1,29,22,4,1
6480bba177ab201442a0e3c8,2015,,,2,DA Warner,S Dhawan,82,47,10,4,1,57,27,6,4,24,20,4,0
6480bb9fe489b0d429e97599,2012,,,2,CL White,S Dhawan,82,44,7,4,1,45,24,2,3,36,20,5,1
6480bba1ff55936e203ca5a6,2014,,,2,G Gambhir,MK Pandey,82,66,7,0,0,45,31,4,0,36,35,3,0
6480bb9ea49fe0f895bf242a,2012,,,2,AM Rahane,OA Shah,82,57,6,4,1,36,27,3,2,44,30,3,2
6480bb99c26e725b7b6f1637,2023,,,1,KL Rahul,KR Mayers,82,65,6,4,1,39,32,4,1,39,33,2,3
6480bb9553f3fc8903579544,2018,,,1,Ishan Kishan,RG Sharma,82,34,7,6,1,62,21,5,6,18,13,2,0
6480bb9d918bd358d046889d,2011,,,2,CH Gayle,V Kohli,82,43,11,3,1,26,13,4,1,48,30,7,2
6480bb9d61e9b86b0f0aae49,2009/10,,,1,MD Mishra,RG Sharma,82,61,6,3,1,41,30,1,3,37,31,5,0
6480bb9f895e5780080c8059,2012,,,2,DA Warner,UBT Chand,82,54,6,6,1,58,30,6,4,18,24,0,2
6480bb98cbaaf700d226941a,2022,,,1,JC Buttler,SV Samson,82,50,8,4,1,49,29,7,1,30,21,1,3
6480bb97d5e3b0911408f222,2020/21,,,1,AB de Villiers,V Kohli,82,69,5,1,1,39,36,4,0,41,33,1,1
6480bba192383a244f185c5a,2014,,,2,BB McCullum,DR Smith,82,68,6,5,1,32,35,5,0,42,33,1,5
6480bb96e18d7a1b3e62552d,2019,,,1,DA Warner,MK Pandey,82,55,6,1,1,43,30,3,0,36,25,3,1
6480bb9b1fc007965b68d4d9,2009,,,2,JP Duminy,SR Tendulkar,82,56,7,4,1,39,31,4,2,34,25,3,2
6480bb97746881ab34c38bf8,2020/21,,,1,AJ Finch,D Padikkal,81,54,10,1,1,52,35,7,1,23,19,3,0
6480bb965f597c872396f67c,2020/21,,,1,EJG Morgan,Shubman Gill,81,47,7,6,1,40,25,5,2,40,22,2,4
6480bb9746dfc5c467942a84,2021,,,1,RA Jadeja,RD Gaikwad,81,64,5,2,1,26,33,1,0,48,31,4,2
6480bb97cca23939859c422e,2021,,,1,PP Shaw,S Dhawan,81,62,10,1,1,51,36,7,1,28,26,3,0
6480bb9836af59f8283f4081,2022,,,2,SA Yadav,Tilak Varma,81,56,4,4,1,39,28,3,2,35,28,1,2
6480bb975ea60ce128803d60,2021,,,2,AD Russell,KD Karthik,81,37,6,7,1,54,22,3,6,24,15,3,1
6480bb9e34659755628e7471,2012,,,1,MN Samuels,RV Uthappa,81,61,5,4,1,45,36,4,2,30,25,1,2
6480bb9fd26b695cee9d8761,2013,,,2,AM Rahane,R Dravid,81,68,11,0,1,30,27,3,0,48,41,8,0
6480bb9e88141830a7a309b5,2011,,,1,AC Blizzard,SR Tendulkar,81,47,12,2,1,51,30,7,2,28,17,5,0
6480bba1b85900d7d83de308,2014,,,1,DA Warner,NV Ojha,81,42,5,6,1,44,23,3,3,36,19,2,3
6480bba1af9481df8b4f9f0f,2015,,,1,G Gambhir,RV Uthappa,81,64,10,1,1,44,36,6,1,35,28,4,0
6480bb931ee18ac840f40603,2017,,,2,JC Buttler,PA Patel,81,35,10,4,1,40,17,6,2,37,18,4,2
6480bb9a577cde04d3672225,2023,,,1,B Sai Sudharsan,HH Pandya,81,33,6,7,1,60,22,6,5,21,11,0,2
6480bb945901306d3cb2b759,2018,,,1,SK Raina,SR Watson,81,44,10,3,1,46,29,9,0,33,15,1,3
6480bb98cbaaf700d226941a,2022,,,2,Ishan Kishan,Tilak Varma,81,54,4,4,1,31,27,2,0,49,27,2,4
6480bb96e834e1c16b33f325,2020/21,,,2,SPD Smith,SV Samson,81,40,7,5,1,38,20,4,2,41,20,3,3
6480bb9abfe839459b1a28f6,2007/08,,,2,DPMD Jayawardene,SE Marsh,81,48,9,2,0,45,23,6,1,31,25,3,1
6480bb93d5dc00a79edede9c,2017,,,2,DA Warner,S Dhawan,81,62,10,3,1,49,34,7,2,28,28,3,1
6480bb96c0ffb76dab723a2b,2019,,,2,F du Plessis,SR Watson,81,62,9,2,1,50,39,7,1,26,23,2,1
6480bba16e510ff78ef635a1,2014,,,1,AT Rayudu,CJ Anderson,81,31,11,3,1,30,10,5,1,49,21,6,2
6480bb96a467817b9b68ca94,2020/21,,,1,AT Rayudu,SR Watson,81,64,4,5,1,41,34,3,2,39,30,1,3
6480bb9b17739118ee6c3bd0,2007/08,,,2,M Kaif,YK Pathan,81,40,9,3,0,29,22,4,0,48,18,5,3
6480bb94cb5adf24f5ad15c3,2017,,,2,AM Rahane,MK Tiwary,80,65,7,2,1,50,36,5,1,30,29,2,1
6480bb9908b154f78b12b8fb,2023,,,1,N Rana,VR Iyer,80,44,6,4,1,48,21,3,4,29,23,3,0
6480bb980095555db76d49cb,2022,,,2,Anuj Rawat,V Kohli,80,52,7,3,1,37,22,2,3,41,30,5,0
6480bba06e8cb70fb4bdc83e,2013,,,2,CL White,NLTC Perera,80,45,3,6,1,36,21,2,2,40,24,1,4
6480bb9d3ab782f83ce3e381,2011,,,2,MK Tiwary,YK Pathan,80,50,5,4,1,33,28,3,1,42,22,2,3
6480bb95af5853799812b0f6,2019,,,2,N Rana,RV Uthappa,80,58,8,3,1,44,31,5,2,35,27,3,1
6480bb939b2499e9af6ee18c,2017,,,2,BB McCullum,SK Raina,80,66,7,2,1,51,37,5,2,28,29,2,0
6480bb9b9614f21d90333e15,2007/08,,,1,SE Marsh,Yuvraj Singh,80,35,3,8,1,35,22,1,3,42,13,2,5
6480bb9edb0554f003f5428a,2012,,,1,G Gambhir,JH Kallis,80,49,2,6,1,44,25,1,4,35,24,1,2
6480bb96e61ac20a6e10582e,2019,,,2,Ishan Kishan,SA Yadav,80,63,8,1,1,28,31,1,1,47,32,7,0
6480bb9e173228d1b18e376b,2012,,,1,LRPL Taylor,V Sehwag,80,61,7,2,1,22,30,0,0,55,31,7,2
6480bb939c56810fd88e895b,2017,,,2,AB de Villiers,STR Binny,80,41,2,9,0,59,21,1,8,18,20,1,1
6480bb9d105fba311a23a588,2011,,,1,BB McCullum,VVS Laxman,80,55,6,4,1,41,26,4,2,36,29,2,2
6480bb9fe7d0f611ba6ad229,2012,,,2,CH Gayle,TM Dilshan,80,52,4,6,1,57,31,3,6,17,21,1,0
6480bba2256bfaaf14c57ead,2015,,,1,AM Rahane,SR Watson,80,43,8,3,1,37,22,3,2,38,21,5,1
6480bb970d7cbd85b6ada680,2021,,,1,CH Gayle,KL Rahul,80,43,9,4,1,46,24,6,2,32,19,3,2
6480bb994877788ec5b187ff,2023,,,1,DP Conway,S Dube,80,37,6,6,1,34,14,4,2,45,23,2,4
6480bba2e3610f863b52b887,2016,,,2,F du Plessis,SPD Smith,80,50,9,2,1,30,21,3,2,38,29,6,0
6480bb97ce981c1918dce924,2021,,,1,Ishan Kishan,RG Sharma,80,33,13,2,1,61,20,10,2,18,13,3,0
6480bb961570df6942a00888,2019,,,2,AT Rayudu,SR Watson,80,43,7,4,1,18,19,1,0,61,24,6,4
6480bb9e335bec070f88430f,2011,,,1,CH Gayle,V Kohli,80,56,7,4,1,44,27,2,4,31,29,5,0
6480bba069d61566bb63ac2b,2014,,,2,CA Lynn,JH Kallis,80,61,5,4,1,45,31,3,3,33,30,2,1
6480bb9c9685addc4a78d7d0,2009/10,,,2,MK Tiwary,SC Ganguly,79,58,7,1,1,41,30,5,0,30,28,2,1
6480bb9814efd9a91e8c911f,2021,,,1,Shubman Gill,VR Iyer,79,65,4,4,1,35,30,1,2,38,35,3,2
6480bb94dfad571ef76493a9,2017,,,2,LMP Simmons,PA Patel,79,52,7,2,1,44,30,4,2,25,22,3,0
6480bb94566b0cf89fca84f9,2018,,,2,KS Williamson,YK Pathan,79,45,1,7,1,39,21,0,4,39,24,1,3
6480bb94ce8e0a620532955b,2018,,,1,AT Rayudu,MS Dhoni,79,36,5,6,1,28,15,3,1,49,21,2,5
6480bb9bb070eb19f9ac8a76,2007/08,,,2,AC Gilchrist,HH Gibbs,79,67,7,3,1,31,33,4,0,44,34,3,3
6480bb97ce8cbd211049f957,2021,,,2,CH Gayle,KL Rahul,79,62,6,4,0,43,35,5,2,33,27,1,2
6480bb97ce8cbd211049f957,2021,,,1,RG Sharma,SA Yadav,79,55,7,3,1,45,28,4,2,33,27,3,1
6480bb99d2bd76016d47896d,2023,,,1,DJ Hooda,KR Mayers,79,42,1,7,1,17,18,0,0,62,24,1,7
6480bb99ecbdaaf953b8eee5,2023,,,2,KL Rahul,KR Mayers,79,35,10,2,1,19,13,2,0,53,22,8,2
6480bb932d6ccb8870dcd72d,2017,,,1,DA Miller,GJ Maxwell,79,47,3,6,0,30,27,1,2,44,20,2,4
6480bb95fa6394e733c532a9,2018,,,1,S Dhawan,SP Goswami,79,53,9,2,1,36,27,5,1,35,26,4,1
6480bb980d1be75574871dcc,2022,,,2,DA Miller,R Tewatia,79,40,8,3,0,30,15,3,1,43,25,5,2
6480bb9525ace33768e8b671,2019,,,1,F du Plessis,SR Watson,79,59,7,3,1,45,30,3,3,31,29,4,0
6480bba1d3370c13ea1f79f3,2014,,,1,S Rana,Yuvraj Singh,79,36,1,9,0,15,14,1,0,59,22,0,9
6480bba0ca27548122e36880,2013,,,2,EJG Morgan,MS Bisla,79,37,10,3,1,28,16,2,2,47,21,8,1
6480bb96ed06a5693a66b9f0,2020/21,,,2,D Padikkal,V Kohli,79,58,3,2,1,28,27,2,0,43,31,1,2
6480bb9c89f35f11aae1f2d0,2009/10,,,1,G Gambhir,KD Karthik,79,50,5,3,1,29,23,2,0,47,27,3,3
6480bb9b2e179d359c1d446d,2009,,,2,KD Karthik,TM Dilshan,79,62,4,3,1,41,30,3,1,31,32,1,2
6480bba177ab201442a0e3c8,2015,,,2,KL Rahul,S Dhawan,78,47,4,3,0,44,28,4,1,23,19,0,2
6480bba2fc84811f520b04cf,2016,,,1,M Vijay,M Vohra,78,50,9,3,1,37,27,5,1,38,23,4,2
6480bb97f56e9d700b27a098,2021,,,2,RR Pant,SO Hetmyer,78,44,5,4,0,25,19,3,0,53,25,2,4
6480bba0c7bf2b92ac8d836a,2013,,,1,JH Kallis,YK Pathan,78,61,5,4,0,28,26,2,1,49,35,3,3
6480bba27b4786f36f706f8e,2016,,,2,AM Rahane,F du Plessis,78,59,7,4,1,40,26,6,1,34,33,1,3
6480bb976caaa0cc91f652c7,2021,,,1,Q de Kock,RG Sharma,78,56,7,3,1,42,26,3,3,33,30,4,0
6480bb9a0474602f26069e45,2007/08,,,1,GC Smith,SA Asnodkar,78,62,9,0,1,27,32,4,0,32,30,5,0
6480bb99f33a7dd80eb0a544,2023,,,2,Atharva Taide,Sikandar Raza,78,47,8,2,1,41,25,4,1,36,22,4,1
6480bb943565d22d24ec0ae8,2017,,,2,MK Pandey,RV Uthappa,78,51,7,2,1,39,29,3,0,38,22,4,2
6480bb9623a26d3fbfe59f25,2020/21,,,1,KK Nair,KL Rahul,78,28,6,6,0,15,8,2,0,62,20,4,6
6480bb96ee2a21f0d9b9f37f,2020/21,,,2,EJG Morgan,RA Tripathi,78,31,3,8,1,44,18,1,5,31,13,2,3
6480bb9af1b34d6aa89e434e,2023,,,2,Atharva Taide,LS Livingstone,78,50,6,3,1,30,22,3,0,47,28,3,3
6480bb99864a94e086c8395e,2022,,,1,PK Garg,RA Tripathi,78,43,9,3,1,37,20,3,2,39,23,6,1
6480bb96e18d7a1b3e62552d,2019,,,1,DA Warner,WP Saha,78,38,7,3,1,38,25,4,2,28,13,3,1
6480bb9c13fa57328b17e4e2,2009/10,,,2,ML Hayden,SK Raina,78,39,3,7,1,52,22,2,6,21,17,1,1
6480bba11c977a5d11c1aa38,2015,,,2,JP Duminy,SS Iyer,78,56,3,5,1,26,26,2,0,47,30,1,5
6480bb962fbc99d08dc59f56,2020/21,,,2,KL Rahul,MA Agarwal,78,48,5,5,1,28,23,1,2,45,25,4,3
6480bb9c9f9d5376b4227724,2009/10,,,1,DJ Hussey,SC Ganguly,78,51,4,5,1,19,21,0,1,54,30,4,4
6480bb9763013a01eae041f2,2020/21,,,1,Ishan Kishan,Q de Kock,78,45,3,5,1,23,18,1,1,54,27,2,4
6480bb952f20835ddd6e533f,2019,,,2,AM Rahane,JC Buttler,78,49,12,2,1,27,20,4,0,51,29,8,2
6480bb94ca3c1b1eac5e8dd3,2018,,,1,Ishan Kishan,SA Yadav,78,52,10,2,1,34,23,4,1,43,29,6,1
6480bb963d224b9be17f2c75,2019,,,2,AM Rahane,LS Livingstone,78,55,8,4,1,34,29,4,1,44,26,4,3
6480bb97aa725a640d0f8e2f,2021,,,1,E Lewis,YBK Jaiswal,77,50,6,5,1,46,28,3,3,31,22,3,2
6480bb9ee0795047740de5a7,2011,,,2,M Vijay,MEK Hussey,77,56,9,1,1,28,26,1,1,46,30,8,0
6480bb97951f1bc43b462c46,2021,,,2,E Lewis,YBK Jaiswal,77,32,8,5,1,27,12,2,2,50,20,6,3
6480bb9eeeaf037e5e41ab86,2012,,,1,AM Rahane,R Dravid,77,57,10,0,1,41,33,7,0,28,24,3,0
6480bb96ebf33df82879ad4c,2020/21,,,1,Abhishek Sharma,PK Garg,77,43,9,2,1,31,24,4,1,42,19,5,1
6480bba0295edd6084b9503b,2014,,,2,AM Rahane,STR Binny,77,58,6,1,1,41,34,4,0,34,24,2,1
6480bb961570df6942a00888,2019,,,2,SK Raina,SR Watson,77,45,9,3,1,38,24,6,1,33,21,3,2
6480bb9d7aa8d2c4c947d164,2009/10,,,2,AC Gilchrist,TL Suman,77,51,8,2,1,30,17,3,2,41,34,5,0
6480bb9c37b72d7a51019794,2009/10,,,2,FY Fazal,SR Watson,77,51,6,2,1,36,29,4,0,35,22,2,2
6480bb9936b7698da2c2030c,2023,,,1,D Padikkal,JC Buttler,77,41,6,3,1,38,26,5,0,33,15,1,3
6480bb947b065b9dc0256f0d,2018,,,2,Q de Kock,V Kohli,77,44,11,1,1,26,19,4,0,49,25,7,1
6480bb96ed06a5693a66b9f0,2020/21,,,2,AB de Villiers,Gurkeerat Singh,77,39,2,6,0,55,22,1,6,19,17,1,0
6480bba120182b9ca0b70004,2014,,,1,AT Rayudu,KA Pollard,77,57,6,3,1,28,22,4,0,47,35,2,3
6480bb938ed49c6d5c211429,2017,,,1,MK Pandey,RV Uthappa,77,52,5,3,1,20,22,1,0,52,30,4,3
6480bb961cdee4d82c395517,2020/21,,,1,DA Warner,JM Bairstow,77,57,3,3,1,45,33,3,2,28,24,0,1
6480bb9f70156528a31bb270,2013,,,1,CH Gayle,KB Arun Karthik,76,44,9,3,0,48,25,6,3,19,19,3,0
6480bb99315aee6cd9d56504,2023,,,2,KL Rahul,MP Stoinis,76,40,6,5,1,10,10,0,0,65,30,6,5
6480bb99349f00f851e8d2fd,2023,,,2,C Green,RG Sharma,76,50,7,4,1,36,26,4,1,39,24,3,3
6480bba1f2392e6761d39d66,2014,,,2,LMP Simmons,MEK Hussey,76,58,8,2,1,35,25,4,1,39,33,4,1
6480bba210201df0f7975000,2016,,,1,AT Rayudu,RG Sharma,76,56,7,2,1,31,23,5,0,43,33,2,2
6480bb94b882fb725e3f98e5,2018,,,2,KS Williamson,MK Pandey,76,56,4,2,1,44,32,2,2,27,24,2,0
6480bb95ff5da0069bc5274e,2018,,,1,AD Russell,KD Karthik,76,31,6,6,1,30,13,2,3,44,18,4,3
6480bb945f95e767a8a9cc10,2017,,,1,BA Stokes,MS Dhoni,76,64,3,4,1,46,31,2,3,26,33,1,1
6480bb99f33a7dd80eb0a544,2023,,,1,MP Stoinis,N Pooran,76,30,9,3,1,25,13,2,2,44,17,7,1
6480bba07e219ed95b7b06df,2013,,,2,AJ Finch,RV Uthappa,76,62,9,0,1,35,29,5,0,37,33,4,0
6480bba09d1874eb9ded0204,2013,,,2,BJ Rohrer,KM Jadhav,76,48,9,1,0,49,27,7,1,23,21,2,0
6480bb96edb3270eba0af1d4,2020/21,,,1,S Dube,V Kohli,76,34,4,4,0,22,14,2,1,49,20,2,3
6480bba0d3cbb27b257a9c1f,2013,,,2,AM Rahane,SV Samson,76,56,5,2,0,23,23,0,1,47,33,5,1
6480bba0c63a6317296391b7,2013,,,1,AP Tare,KD Karthik,76,51,10,1,1,51,30,7,1,21,21,3,0
6480bb9cc5312f3d7cfb650e,2009/10,,,2,KP Pietersen,V Kohli,76,51,5,2,1,31,25,1,1,42,26,4,1
6480bb94d8ce46258c13e90e,2017,,,2,AM Rahane,RA Tripathi,76,57,8,2,1,38,32,5,1,36,25,3,1
6480bb9affc08d6384ac3992,2023,,,1,AK Markram,H Klaasen,76,50,6,2,1,17,19,0,0,58,31,6,2
6480bb9bef0d1fffea8bfd11,2009,,,1,ML Hayden,SK Raina,76,54,10,2,1,43,34,6,1,32,20,4,1
6480bb97220be892fbfc2a36,2021,,,1,RG Sharma,SA Yadav,76,51,8,2,1,18,15,1,0,56,36,7,2
6480bb966c197bad273f91f1,2020/21,,,1,HH Pandya,SA Yadav,76,38,6,3,0,30,19,2,1,39,19,4,2
6480bb954da239b357833c8a,2018,,,2,AD Hales,S Dhawan,76,55,5,4,1,45,31,3,3,28,24,2,1
6480bb937dc0a09df8f7aeee,2017,,,1,G Gambhir,SP Narine,76,34,11,3,1,31,16,7,0,37,18,4,3
6480bba38ce35716815a1845,2016,,,1,G Gambhir,MK Pandey,76,49,9,1,1,39,24,5,0,34,25,4,1
6480bb99864a94e086c8395e,2022,,,1,N Pooran,RA Tripathi,76,42,5,5,1,38,22,2,3,37,20,3,2
6480bb9b7b8617115de9683b,2007/08,,,1,DB Ravi Teja,Y Venugopal Rao,76,50,6,2,1,40,28,4,1,29,22,2,1
6480bb941ab79050c3c90ee5,2018,,,1,AD Russell,KD Karthik,76,46,2,7,1,54,27,1,6,20,19,1,1
6480bb9b9ca80d1c48994e04,2007/08,,,1,RV Uthappa,ST Jayasuriya,76,39,8,4,0,16,19,2,0,55,20,6,4
6480bb962a1612c936d161ba,2019,,,1,E Lewis,RG Sharma,75,57,6,3,1,32,30,3,1,41,27,3,2
6480bb9837deb0fb66704166,2022,,,1,RR Pant,SN Khan,75,57,6,2,0,36,29,3,2,36,28,3,0
6480bb9e502d7987de08e5d5,2012,,,2,CL White,JP Duminy,75,38,4,5,1,53,22,4,4,18,16,0,1
6480bba1af51ddc81185931d,2014,,,2,F du Plessis,MS Dhoni,75,49,4,4,0,22,21,0,1,49,28,4,3
6480bba1abec4894f2f69a35,2014,,,1,DJ Hussey,SK Raina,75,59,7,2,1,25,29,1,1,47,30,6,1
6480bb9f54d17f50da495682,2012,,,1,M Vijay,MEK Hussey,75,61,10,1,1,36,29,5,0,38,32,5,1
6480bb99349f00f851e8d2fd,2023,,,2,C Green,SA Yadav,75,36,8,4,1,31,17,2,2,44,19,6,2
6480bba0e883438915efc1e6,2013,,,2,S Badrinath,SK Raina,75,59,4,1,1,34,31,2,0,39,28,2,1
6480bb94a0422f6d0abe276b,2017,,,2,SS Iyer,SV Samson,75,55,3,3,1,41,29,3,1,33,26,0,2
6480bb9d362f72789dcdc5a7,2009/10,,,2,G Gambhir,M Manhas,75,70,6,0,0,43,38,4,0,25,32,2,0
6480bb963d224b9be17f2c75,2019,,,1,DA Warner,MK Pandey,75,50,8,0,1,24,23,0,0,50,27,8,0
6480bb97aabcd4374e076d04,2021,,,2,F du Plessis,RD Gaikwad,75,61,7,4,1,29,23,3,2,45,38,4,2
6480bb9e5ad1f3182858e7c9,2012,,,1,JEC Franklin,KD Karthik,75,36,6,4,1,40,16,1,4,35,20,5,0
6480bba32e54551792a9e915,2016,,,2,JC Buttler,N Rana,75,54,5,3,1,33,31,3,0,39,23,2,3
6480bb9873e53eace3a69dc7,2022,,,1,HH Pandya,WP Saha,75,56,5,3,1,47,33,3,2,25,23,2,1
6480bb9b95eac8df5d0180b0,2007/08,,,1,G Gambhir,V Sehwag,75,42,8,3,1,40,28,7,0,29,14,1,3
6480bb98436587de59527f2e,2022,,,2,AR Patel,Lalit Yadav,75,30,5,5,0,38,17,2,3,31,13,3,2
6480bb9dec749d630afd07d1,2011,,,1,KC Sangakkara,S Dhawan,75,54,10,1,1,35,28,5,0,38,26,5,1
6480bb9d80e97e178e5f68de,2011,,,1,S Anirudha,SK Raina,75,57,9,1,1,39,28,5,1,33,29,4,0
6480bba1c0aa361f3c6e454c,2015,,,1,KA Pollard,RG Sharma,75,33,4,6,1,45,17,2,5,28,16,2,1
6480bba15b304732a6212cdf,2015,,,1,BB McCullum,DR Smith,75,52,7,4,1,35,26,3,3,27,26,4,1
6480bb99e520ec7a66b73adb,2022,,,1,R Powell,RR Pant,75,44,4,4,1,35,26,1,3,29,18,3,1
6480bba09d6b23c8722fd208,2013,,,2,DR Smith,KD Karthik,75,40,6,5,1,63,25,5,5,9,15,1,0
6480bb941ab79050c3c90ee5,2018,,,2,AT Rayudu,SR Watson,75,35,6,5,1,33,16,3,2,42,19,3,3
6480bb9b5d0191a0a2611916,2009,,,1,IK Pathan,KC Sangakkara,75,59,4,3,1,39,33,2,2,33,26,2,1
6480bb9e59fe7a0f48b7f9b9,2012,,,1,KP Pietersen,V Sehwag,75,42,4,7,1,32,23,1,3,43,19,3,4
6480bb95ff5da0069bc5274e,2018,,,1,RV Uthappa,SP Narine,75,37,8,4,1,24,16,2,1,49,21,6,3
6480bb987c52e15a2cac0697,2022,,,2,AK Markram,N Pooran,75,50,5,2,0,37,20,4,1,35,30,1,1
6480bba0295edd6084b9503b,2014,,,1,DA Warner,S Dhawan,75,64,4,1,1,29,30,1,0,38,34,3,1
6480bb94cf431881ac3e9cbf,2018,,,1,RR Pant,SS Iyer,75,49,5,4,1,34,26,3,1,40,23,2,3
6480bb9eeeaf037e5e41ab86,2012,,,1,AM Rahane,BJ Hodge,75,39,8,2,1,44,23,7,1,21,16,1,1
6480bb9da3dc1406b000cc98,2011,,,2,DA Warner,V Sehwag,75,42,10,2,1,46,28,6,2,22,14,4,0
6480bb9ab34d149420eae546,2023,,,1,A Badoni,N Pooran,74,47,6,4,1,24,20,2,1,46,27,4,3
6480bb9b4fc6889967a3cd54,2007/08,,,1,DB Ravi Teja,Y Venugopal Rao,74,49,5,5,1,31,25,2,2,41,24,3,3
6480bb994877788ec5b187ff,2023,,,1,AM Rahane,DP Conway,74,43,4,5,1,37,20,3,2,36,23,1,3
6480bb9fc3369c6f5a549d05,2013,,,2,MEK Hussey,MS Dhoni,74,40,8,2,1,28,17,3,1,44,23,5,1
6480bba1a6882d256a926a8b,2014,,,1,AM Rahane,SV Samson,74,39,5,4,1,32,18,3,1,39,21,2,3
6480bb9a577cde04d3672225,2023,,,2,DP Conway,RD Gaikwad,74,39,7,3,1,45,23,4,2,26,16,3,1
6480bb9b9dd7fe8c5cbdbab0,2009,,,2,AB de Villiers,MK Tiwary,74,35,5,5,1,65,22,4,5,9,13,1,0
6480bb9b77a0ff5cb3d0e3e0,2009,,,2,DA Warner,KD Karthik,74,54,7,2,1,26,26,1,1,47,28,6,1
6480bb95d4da0397e79acffa,2019,,,2,DA Miller,MA Agarwal,74,47,6,3,1,37,27,3,2,34,20,3,1
6480bb9404b444be6724e41e,2017,,,1,KK Nair,RR Pant,74,40,11,2,1,36,18,7,0,36,22,4,2
6480bba0f1ebf9ff255e1c91,2013,,,1,R Dravid,SR Watson,74,62,8,2,1,30,29,3,1,42,33,5,1
6480bba031c5cf0145ae8cfe,2014,,,1,SR Watson,SV Samson,74,42,6,5,1,50,29,5,3,23,13,1,2
6480bb9da9ca2f2d3738d79e,2011,,,1,AT Rayudu,SR Tendulkar,74,72,5,0,1,33,35,3,0,34,37,2,0
6480bb9c94ef2c2e850189ff,2009/10,,,1,JH Kallis,MK Pandey,74,50,6,4,1,27,24,4,1,38,26,2,3
6480bb984f0f3dc0df6d4531,2022,,,1,Ishan Kishan,RG Sharma,74,45,9,2,1,28,17,4,0,43,28,5,2
6480bb9affc08d6384ac3992,2023,,,1,H Klaasen,HC Brook,74,36,4,5,1,46,20,2,4,26,16,2,1
6480bb96ef6f4c2c85264241,2019,,,1,AD Russell,KD Karthik,74,29,5,7,0,56,22,4,6,15,7,1,1
6480bba2c56d0ef7222ee3b8,2015,,,1,AB de Villiers,Mandeep Singh,74,53,12,0,1,42,33,8,0,27,20,4,0
6480bba0bc196f7168b3d989,2013,,,1,JA Morkel,SK Raina,74,38,6,4,1,23,16,2,1,51,22,4,3
6480bb97b945155c90dccd3d,2021,,,2,F du Plessis,RD Gaikwad,74,50,8,3,1,33,22,6,0,40,28,2,3
6480bb9ccfdcb55be258ec95,2009,,,1,MS Dhoni,SK Raina,74,47,4,4,1,29,20,2,1,42,27,2,3
6480bb93ec7e3351941d3b5b,2017,,,1,MC Henriques,S Dhawan,74,53,7,1,1,35,25,2,1,39,28,5,0
6480bb9740aaba2132c0eb0e,2021,,,1,F du Plessis,RD Gaikwad,74,56,8,2,1,38,31,4,1,33,25,4,1
6480bb9d61e9b86b0f0aae49,2009/10,,,2,JH Kallis,R Dravid,74,62,9,0,1,18,27,1,0,49,35,8,0
6480bba0b07a395235841955,2013,,,1,GH Vihari,S Dhawan,74,57,8,0,1,25,23,2,0,47,34,6,0
6480bb96ee2a21f0d9b9f37f,2020/21,,,1,PP Shaw,SS Iyer,73,41,3,6,1,36,22,1,3,37,19,2,3
6480bb9a6e44b0c8da00ca72,2007/08,,,1,K Goel,KC Sangakkara,73,39,10,2,1,16,14,1,1,54,25,9,1
6480bb984a8abbb79a69e6ce,2022,,,1,D Padikkal,SV Samson,73,41,6,4,1,41,29,4,2,27,12,2,2
6480bba03ef1ed797291b091,2013,,,2,GH Vihari,S Dhawan,73,54,8,1,1,21,22,2,0,50,32,6,1
6480bb964592640608a9163c,2020/21,,,1,DA Warner,MK Pandey,73,60,2,4,1,41,29,2,2,31,31,0,2
6480bb9f6f311344dac147cc,2012,,,2,AD Mathews,SC Ganguly,73,56,4,4,1,31,21,0,3,36,35,4,1
6480bb94cb5adf24f5ad15c3,2017,,,2,MK Tiwary,MS Dhoni,73,45,2,6,1,28,19,2,1,40,26,0,5
6480bba3de527604cd2f96f3,2016,,,1,KK Nair,RR Pant,73,59,7,1,1,40,35,4,1,31,24,3,0
6480bb9837deb0fb66704166,2022,,,2,KL Rahul,Q de Kock,73,58,6,2,1,24,25,1,1,47,33,5,1
6480bb9e32ed1b9e077b8c11,2011,,,1,R Dravid,SR Watson,73,58,9,2,1,37,29,6,0,34,29,3,2
6480bb947b065b9dc0256f0d,2018,,,1,JC Buttler,SV Samson,73,37,2,6,1,23,14,2,1,43,23,0,5
6480bb9b7557e68b433167d5,2007/08,,,1,JA Morkel,PA Patel,73,40,6,4,1,44,23,4,3,26,17,2,1
6480bb9fc28e897b3c53f359,2012,,,1,DJ Bravo,MS Dhoni,73,29,8,3,0,33,14,3,2,39,15,5,1
6480bb94adb227976b33d30b,2018,,,1,GJ Maxwell,SS Iyer,73,32,2,8,1,27,18,1,2,44,14,1,6
6480bb9ca668b7b36823fb21,2009,,,2,AM Rahane,SR Tendulkar,73,55,9,0,1,25,24,3,0,36,31,6,0
6480bb9a77f349a0fd8d96d6,2023,,,2,D Padikkal,YBK Jaiswal,73,49,7,3,1,51,30,5,3,20,19,2,0
6480bb9fd4a1af6234c9e57c,2012,,,2,DJ Hussey,N Saini,73,45,5,4,1,41,22,2,4,31,23,3,0
6480bb97668d35800fa74139,2021,,,2,DA Warner,JM Bairstow,73,61,5,3,1,37,37,3,1,32,24,2,2
6480bb9a77f349a0fd8d96d6,2023,,,1,M Shahrukh Khan,SM Curran,73,37,7,4,0,41,23,4,2,31,14,3,2
6480bb955f4b3a84d6973620,2018,,,1,PP Shaw,SS Iyer,73,40,6,6,1,46,22,4,4,26,18,2,2
6480bb94fbd0b904d63e0e07,2017,,,1,EJG Morgan,SE Marsh,73,49,9,2,1,26,21,2,1,45,28,7,1
6480bb9d5d93b08a19c16313,2009/10,,,2,AD Mathews,MK Tiwary,73,64,4,2,1,36,34,2,2,27,30,2,0
6480bb99bbae76f3f761d060,2023,,,1,DP Conway,RD Gaikwad,73,45,5,5,1,38,25,3,2,35,20,2,3
6480bb9fc9e4047271240a59,2012,,,2,MEK Hussey,SK Raina,73,41,4,4,1,13,11,1,0,58,30,3,4
6480bb961ee814aee7b674ac,2020/21,,,1,RR Pant,SS Iyer,73,60,4,3,1,31,29,4,0,39,31,0,3
6480bb9ab83a3072124dda22,2023,,,2,MP Stoinis,PN Mankad,73,43,5,4,1,40,25,2,3,29,18,3,1
6480bb9a6935abf34d88ca97,2007/08,,,2,MEK Hussey,S Badrinath,73,27,5,6,0,42,13,2,4,31,14,3,2
6480bb974123cbc9756ceefa,2021,,,1,AB de Villiers,GJ Maxwell,73,40,3,6,1,23,18,1,2,47,22,2,4
6480bb9bee2e48d9c41b1e23,2009,,,2,DR Smith,RG Sharma,72,37,4,6,1,48,21,2,5,21,16,2,1
6480bb9a9514379c05d59c38,2023,,,1,JC Buttler,YBK Jaiswal,72,44,7,4,1,18,19,2,1,41,25,5,3
6480bb939c56810fd88e895b,2017,,,1,GJ Maxwell,HM Amla,72,38,4,6,0,43,22,3,4,26,16,1,2
6480bb97220be892fbfc2a36,2021,,,2,N Rana,Shubman Gill,72,53,9,3,1,37,29,4,2,33,24,5,1
6480bba03b6f98689b851317,2013,,,1,EJG Morgan,MS Bisla,72,44,5,5,1,42,26,3,4,24,18,2,1
6480bb954714437843ab3647,2019,,,2,DA Warner,JM Bairstow,72,60,6,2,1,29,29,1,1,41,31,5,1
6480bba154ce29a67e4752df,2015,,,2,LMP Simmons,UBT Chand,72,46,6,4,1,32,22,3,2,34,24,3,2
6480bb950ddd55d8aed7d015,2019,,,1,JC Buttler,SPD Smith,72,64,8,1,1,37,34,5,1,32,30,3,0
6480bb9db9ed29ce1ee8764f,2011,,,2,AC Gilchrist,SE Marsh,72,41,12,2,1,32,20,7,0,39,21,5,2
6480bb9d79d603cc45fc9b3c,2011,,,2,PC Valthaty,SE Marsh,72,60,6,2,1,32,35,1,2,33,25,5,0
6480bb949f5853dfe76c99d9,2017,,,1,RA Tripathi,SPD Smith,72,46,5,5,1,45,25,4,3,27,21,1,2
6480bb980095555db76d49cb,2022,,,1,JD Unadkat,SA Yadav,72,41,4,6,0,13,14,1,0,56,27,3,6
6480bb9774a44376e3b5eb6f,2021,,,1,RA Tripathi,VR Iyer,72,55,8,1,1,34,26,3,1,37,29,5,0
6480bb956e3f7f62e4b24c01,2019,,,2,PP Shaw,S Dhawan,72,45,10,2,1,18,18,2,0,54,27,8,2
6480bb9938b659481e3ab6dc,2022,,,2,MS Wade,Shubman Gill,72,44,10,1,1,30,23,5,0,35,21,5,1
6480bb9a365c63af4b3de24c,2023,,,1,P Simran Singh,SM Curran,72,54,3,4,1,48,30,2,4,20,24,1,0
6480bb9d05f8e769574069fa,2009/10,,,1,R Dravid,S Sriram,72,53,8,0,1,38,30,5,0,24,23,3,0
6480bb9cba868c69775db687,2009,,,1,MK Pandey,R Dravid,72,59,10,0,1,37,30,5,0,32,29,5,0
6480bb9bbb0ec0266749f518,2007/08,,,1,V Kohli,W Jaffer,72,54,7,1,1,28,22,1,1,41,32,6,0
6480bb9d22388e966342dba8,2009/10,,,1,MS Dhoni,SK Raina,72,35,5,4,1,22,15,2,1,47,20,3,3
6480bb9651b51fdcda05e4c8,2020/21,,,1,RA Tripathi,Shubman Gill,72,49,10,2,1,34,26,4,2,35,23,6,0
6480bba33dab752d79e587d2,2016,,,2,RR Pant,SV Samson,72,50,2,5,0,39,26,2,3,31,24,0,2
6480bb991a4f7e5f59dd1afc,2023,,,1,Abhishek Sharma,HC Brook,72,33,9,3,1,32,17,3,2,37,16,6,1
6480bb9698a1d9136a13faf6,2020/21,,,2,AT Rayudu,RD Gaikwad,72,54,6,0,0,30,30,2,0,37,24,4,0
6480bb96ebf33df82879ad4c,2020/21,,,2,MS Dhoni,RA Jadeja,72,56,7,2,1,20,21,2,0,50,35,5,2
6480bb96ee2a21f0d9b9f37f,2020/21,,,1,RR Pant,SS Iyer,72,31,9,2,1,38,17,5,1,32,14,4,1
6480bb94640655c49683aee1,2018,,,2,BA Stokes,SV Samson,72,51,4,1,1,40,27,3,1,29,24,1,0
6480bb991a4f7e5f59dd1afc,2023,,,1,AK Markram,HC Brook,72,47,3,5,1,50,26,2,5,20,21,1,0
6480bba2c5a614e0fd10cd19,2016,,,1,KA Pollard,RG Sharma,72,30,5,6,0,51,17,2,6,18,13,3,0
6480bb988b447f26d7a96c0c,2022,,,1,KL Rahul,MK Pandey,72,47,8,2,1,33,18,2,2,38,29,6,0
6480bb94fc240a33621b10a6,2018,,,1,CA Lynn,RV Uthappa,72,41,8,4,1,36,18,3,3,34,23,5,1
6480bb9dd10e35e6145534dc,2011,,,1,DT Christian,JP Duminy,71,35,4,4,1,18,13,2,0,48,22,2,4
6480bb96593f4f87a2c294bc,2020/21,,,2,JM Bairstow,MK Pandey,71,62,5,2,1,33,29,2,1,34,33,3,1
6480bb94704f6dfeb7f4d270,2017,,,1,GJ Maxwell,WP Saha,71,42,3,4,1,44,25,1,4,22,17,2,0
6480bba04b49d2ff5f997e02,2013,,,1,AD Mathews,LJ Wright,71,38,7,3,1,25,15,0,2,44,23,7,1
6480bb9bfcaabf33b5687e32,2007/08,,,2,SR Tendulkar,ST Jayasuriya,71,66,6,0,1,27,29,2,0,38,37,4,0
6480bba1e64915b9e7c849ca,2014,,,1,KD Karthik,KP Pietersen,71,48,7,2,1,26,23,2,1,42,25,5,1
6480bba255079696d5cfa453,2015,,,1,AB de Villiers,CH Gayle,71,34,4,6,1,31,16,1,3,37,18,3,3
6480bba2b7be71a15b2bb3de,2015,,,1,AT Rayudu,KA Pollard,71,40,2,6,1,35,22,0,3,36,18,2,3
6480bba192383a244f185c5a,2014,,,1,KD Karthik,M Vijay,71,51,5,3,1,51,36,4,3,18,15,1,0
6480bb9fa236b26050f19633,2012,,,1,AM Rahane,R Dravid,71,52,11,0,1,42,32,7,0,26,20,4,0
6480bb93ff8d1f4cd07859ce,2017,,,2,KK Nair,SV Samson,71,45,8,3,1,33,23,5,1,36,22,3,2
6480bb94c5d20726ee59d3d6,2017,,,1,Mandeep Singh,TM Head,71,63,4,1,1,33,33,2,0,36,30,2,1
6480bb987c52e15a2cac0697,2022,,,1,LS Livingstone,M Shahrukh Khan,71,49,3,5,1,38,21,2,3,26,28,1,2
6480bb9ef7c6084992b7cdf8,2012,,,2,PA Patel,S Dhawan,71,41,9,1,1,34,19,5,0,35,22,4,1
6480bba25855b7a7195a9bc5,2016,,,1,JP Duminy,SV Samson,71,51,3,3,1,25,19,1,1,43,32,2,2
6480bb9c8c6c106c6ffbeae4,2009/10,,,1,JH Kallis,MK Pandey,71,56,7,1,1,27,29,3,0,38,27,4,1
6480bb980cc3d01eab3a4748,2022,,,2,MA Agarwal,S Dhawan,71,43,7,2,1,32,24,2,2,29,19,5,0
6480bba1d9f266a28a109f29,2015,,,1,V Sehwag,WP Saha,71,53,2,4,1,29,25,2,1,39,28,0,3
6480bb98f98edd45b1ccb406,2022,,,1,DJ Hooda,Q de Kock,71,39,7,4,1,23,15,3,1,48,24,4,3
6480bba38ce35716815a1845,2016,,,2,CH Gayle,V Kohli,71,45,7,5,1,49,31,5,4,21,14,2,1
6480bb9b69f8ace7659e486d,2009,,,1,MS Dhoni,SK Raina,71,42,5,3,1,21,18,0,1,46,24,5,2
6480bb98d8f59b81335f4a3d,2021,,,2,F du Plessis,RD Gaikwad,71,51,6,3,1,31,25,2,2,38,26,4,1
6480bb998454ba791a8fdbf8,2023,,,2,Ishan Kishan,RG Sharma,71,45,10,3,1,31,26,6,0,39,19,4,3
6480bb99f47261f111a6cc1a,2023,,,1,A Manohar,DA Miller,71,35,4,5,1,42,21,3,3,28,14,1,2
6480bba1bd00c57fb3301f04,2014,,,1,MK Pandey,YK Pathan,71,44,2,7,1,34,22,2,3,36,22,0,4
6480bb9a36f2ab9a44baa0f8,2023,,,2,Shubman Gill,WP Saha,71,59,11,0,1,36,35,6,0,32,24,5,0
6480bb97aad3147696268239,2021,,,2,Q de Kock,RG Sharma,71,46,8,2,1,33,22,4,1,35,24,4,1
6480bb9baccf501985a56d64,2007/08,,,1,GC Smith,SR Watson,71,36,6,3,1,21,15,3,0,41,21,3,3
6480bb9ded279701c84af803,2011,,,2,S Dhawan,S Sohal,71,41,6,4,1,10,11,0,0,56,30,6,4
6480bb9f9a70ecf3467829df,2013,,,2,AM Rahane,SR Watson,71,44,6,3,1,16,15,1,0,54,29,5,3
6480bb9c6f1c8ea3dc73226f,2009/10,,,2,AT Rayudu,SS Tiwary,71,41,3,5,1,34,21,1,3,34,20,2,2
6480bb9d76ba2d9dd45c74a8,2011,,,1,R Dravid,SR Watson,71,64,7,1,1,44,37,4,1,25,27,3,0
6480bb9fa1611443840261b7,2012,,,1,JP Duminy,PA Patel,71,46,3,5,1,53,28,2,5,15,18,1,0
6480bb97a42828c5a5ebef1c,2020/21,,,2,AR Patel,MP Stoinis,71,44,5,5,1,30,21,2,2,41,23,3,3
6480bb9619eaed447b2a05d4,2020/21,,,1,D Padikkal,JR Philippe,71,47,11,1,1,38,23,7,0,33,24,4,1
6480bb94283e3f5a1a95839f,2018,,,1,AT Rayudu,SK Raina,71,42,5,5,1,32,20,1,3,36,22,4,2
6480bb990b96e91d3fbf421b,2022,,,1,F du Plessis,RM Patidar,70,53,7,1,1,23,24,3,0,37,29,4,1
6480bb9a3ffea6235f54cc1e,2023,,,2,AK Markram,H Klaasen,70,47,4,3,1,32,27,3,0,36,20,1,3
6480bb9774a44376e3b5eb6f,2021,,,2,KL Rahul,MA Agarwal,70,54,5,3,1,27,27,2,0,40,27,3,3
6480bb9c4934a2adde9d76ce,2009/10,,,2,CH Gayle,SC Ganguly,70,66,7,1,1,29,32,2,1,31,34,5,0
6480bb9e56c724ba25b94666,2011,,,1,AC Gilchrist,SE Marsh,70,42,5,1,1,22,20,1,1,30,22,4,0
6480bb9813fa79617f791851,2022,,,1,D Padikkal,JC Buttler,70,49,2,4,1,37,29,2,2,29,20,0,2
6480bb9439fcd1191cf17a90,2017,,,2,HM Amla,SE Marsh,70,48,8,3,1,36,24,4,2,30,24,4,1
6480bb9ce544a2fc17a48bee,2009,,,2,BB McCullum,DJ Hussey,70,54,5,2,1,22,27,2,0,43,27,3,2
6480bba107ba9f7f041862c1,2014,,,1,BB McCullum,SK Raina,70,49,8,2,1,38,24,4,1,31,25,4,1
6480bb9d5cca30c933d4baf4,2011,,,1,KD Karthik,SE Marsh,70,38,6,3,1,21,16,3,0,45,22,3,3
6480bb9558345af5a1bb044d,2019,,,2,Q de Kock,RG Sharma,70,43,7,4,1,40,24,5,2,28,19,2,2
6480bba22349149c9ec92d49,2016,,,2,JC Buttler,RG Sharma,70,41,6,2,0,27,17,2,1,38,24,4,1
6480bba3e9fa951efcfc8bfb,2016,,,2,Q de Kock,SV Samson,70,47,7,2,1,52,30,6,2,15,17,1,0
6480bb9825eb960aded1ff64,2022,,,2,DA Miller,Rashid Khan,70,37,4,5,1,30,16,2,2,40,21,2,3
6480bb9737b1d7284b5297c1,2021,,,1,CA Lynn,SA Yadav,70,43,6,4,1,37,20,2,3,31,23,4,1
6480bb95e435367dc64d9844,2019,,,2,R Parag,SPD Smith,70,58,7,1,1,43,29,5,1,26,29,2,0
6480bb98de3641699db2c5a1,2021,,,1,AT Rayudu,MS Dhoni,70,64,5,2,1,51,37,5,2,18,27,0,0
6480bb982fc21d541267f7b9,2022,,,1,MS Dhoni,RA Jadeja,70,56,7,2,0,50,38,7,1,18,18,0,1
6480bb9ee4565d108b29626f,2012,,,2,G Gambhir,JH Kallis,70,59,3,2,1,34,28,2,1,26,31,1,1
6480bb9866dd8ba9b48863c2,2022,,,1,F du Plessis,Shahbaz Ahmed,70,48,5,2,1,41,26,4,2,26,22,1,0
6480bba2d313234709068efb,2015,,,1,KA Pollard,LMP Simmons,70,37,7,3,1,49,24,6,2,20,13,1,1
6480bb9bcc2f6123673672d0,2007/08,,,2,SR Tendulkar,ST Jayasuriya,70,43,8,4,1,18,16,3,0,47,27,5,4
6480bb9be88c31fc563da86f,2009,,,2,K Goel,Yuvraj Singh,70,59,5,4,1,19,25,2,0,50,34,3,4
6480bb9ca5c1d511ad78e92d,2009,,,1,JH Kallis,R Dravid,70,69,5,1,1,32,35,1,1,38,34,4,0
6480bba0eb5a345386bdc825,2013,,,1,AP Tare,DR Smith,70,55,8,2,1,35,27,3,2,33,28,5,0
6480bb9d4e112d675b2925df,2009/10,,,1,AD Mathews,MK Tiwary,70,41,4,3,0,46,28,3,2,23,13,1,1
6480bb97c92184fed1a879f3,2021,,,1,JJ Roy,KS Williamson,70,58,8,0,1,36,29,4,0,31,29,4,0
6480bb9b7557e68b433167d5,2007/08,,,1,PA Patel,SK Raina,70,41,8,3,1,23,17,2,1,45,24,6,2
6480bb93ff8d1f4cd07859ce,2017,,,2,AD Mathews,SS Iyer,70,40,6,3,1,31,23,2,1,36,17,4,2
6480bb9a9dc58f49d783faa9,2023,,,1,F du Plessis,GJ Maxwell,69,47,4,3,1,25,21,0,1,41,26,4,2
6480bba1dd2f8125fc8b203f,2014,,,2,GJ Maxwell,WP Saha,69,51,6,3,1,45,27,5,2,18,24,1,1
6480bb9c968c81bdfcc6df5b,2009,,,2,AA Bilakhia,AC Gilchrist,69,42,4,5,1,10,20,0,0,56,22,4,5
6480bb97aa725a640d0f8e2f,2021,,,2,GJ Maxwell,KS Bharat,69,55,6,1,1,28,24,3,0,39,31,3,1
6480bb9a365c63af4b3de24c,2023,,,2,DA Warner,PD Salt,69,38,12,1,1,48,21,9,1,21,17,3,0
6480bba2ebdcfb98389cee5a,2015,,,1,SS Iyer,Yuvraj Singh,69,55,8,2,1,37,27,4,1,32,28,4,1
6480bb94b991069934e5c7d2,2018,,,2,RV Uthappa,SP Narine,69,49,10,2,1,34,25,5,1,34,24,5,1
6480bb9c94ef2c2e850189ff,2009/10,,,1,JH Kallis,RV Uthappa,69,35,4,5,1,18,14,0,1,51,21,4,4
6480bb99b0fa4d217ed7f255,2023,,,1,AR Patel,MK Pandey,69,59,6,0,1,34,34,4,0,32,25,2,0
6480bb9800ba03eb1f9437d2,2022,,,2,Shubman Gill,WP Saha,69,46,8,2,1,22,24,1,1,42,22,7,1
6480bb960d9d6af315534958,2019,,,1,MA Agarwal,N Pooran,69,40,4,5,1,20,13,1,1,48,27,3,4
6480bba18a2fe828fa106f6c,2014,,,1,BJ Hodge,JP Faulkner,69,41,1,5,1,38,23,0,3,28,18,1,2
6480bba24f6e6e2c212c7469,2016,,,1,G Gambhir,RV Uthappa,69,59,10,0,1,24,26,3,0,35,33,7,0
6480bb9eb559e2934b31c47c,2012,,,2,RE Levi,SR Tendulkar,69,47,7,4,1,50,35,6,3,14,12,1,1
6480bb94283e3f5a1a95839f,2018,,,2,E Lewis,SA Yadav,69,59,7,1,1,19,25,2,0,44,34,5,1
6480bba2c5a614e0fd10cd19,2016,,,2,G Gambhir,RV Uthappa,69,46,5,2,1,32,26,4,0,36,20,1,2
6480bb93182304739a535742,2017,,,2,SV Samson,SW Billings,69,42,10,0,1,40,27,6,0,24,15,4,0
6480bb9b46b4360184dc19f3,2007/08,,,2,A Chopra,SC Ganguly,69,57,11,0,1,24,23,3,0,43,34,8,0
6480bb931b06a170006b4713,2017,,,1,G Gambhir,RV Uthappa,69,49,6,2,1,30,25,2,1,37,24,4,1
6480bb9a5d25d853e1cbfe3e,2007/08,,,1,RA Jadeja,SR Watson,69,42,7,2,0,36,25,5,1,30,17,2,1
6480bb9c3803ef7726af83ab,2009/10,,,2,MJ Lumb,NV Ojha,69,44,9,2,1,37,26,6,1,25,18,3,1
6480bb9bf2869505c9393b7d,2009,,,1,HH Gibbs,RG Sharma,69,50,6,3,0,31,18,3,1,36,32,3,2
6480bb9d54ae15d3d0ed9e5e,2011,,,2,EJG Morgan,JH Kallis,69,62,9,0,1,22,21,4,0,45,41,5,0
6480bb991a4f7e5f59dd1afc,2023,,,2,N Rana,RK Singh,69,39,2,6,1,33,21,1,3,32,18,1,3
6480bb9f4bdcea2f81049fe9,2012,,,2,M Vijay,SK Raina,69,33,7,4,1,42,16,4,3,27,17,3,1
6480bb96f8379d02d3435ceb,2020/21,,,2,AT Rayudu,SR Watson,69,51,7,1,1,30,27,3,0,37,24,4,1
6480bb9429a15517bb46f3be,2018,,,2,JJ Roy,RR Pant,69,40,7,3,1,22,15,1,1,47,25,6,2
6480bb9b82dc3ec84c520466,2009,,,1,JH Kallis,SP Goswami,69,67,8,0,1,20,21,2,0,43,46,6,0
6480bb98291bb8b3f3e8145d,2022,,,2,N Rana,SS Iyer,69,42,3,4,1,30,20,0,3,35,22,3,1
6480bb9f79be50f1621abcc6,2012,,,2,R Dravid,SR Watson,69,39,10,2,1,31,22,6,0,36,17,4,2
6480bb9bfcaabf33b5687e32,2007/08,,,1,NK Patel,RA Jadeja,69,49,2,2,0,40,29,2,1,23,20,0,1
6480bb973e3a3dbbb7ae3707,2020/21,,,2,GJ Maxwell,N Pooran,69,40,5,3,1,16,15,0,0,49,25,5,3
6480bb9d91920239b62f48ad,2009/10,,,2,AT Rayudu,R McLaren,69,41,4,4,1,46,27,3,4,14,14,1,0
6480bb9b9dd7fe8c5cbdbab0,2009,,,2,AB de Villiers,TM Dilshan,68,39,8,3,1,18,12,1,1,50,27,7,2
6480bb9f7ff1377c4d13a645,2013,,,1,KA Pollard,RG Sharma,68,30,3,6,0,19,14,1,1,47,16,2,5
6480bb939b2499e9af6ee18c,2017,,,1,KA Pollard,RG Sharma,68,42,4,4,1,39,23,2,3,27,19,2,1
6480bb9ca668b7b36823fb21,2009,,,1,G Gambhir,V Sehwag,68,46,7,1,1,26,26,3,0,36,20,4,1
6480bb956b439141409fd739,2018,,,2,KL Rahul,MP Stoinis,68,35,4,4,0,44,19,2,3,23,16,2,1
6480bb95014388d3e8c62904,2019,,,2,PP Shaw,SS Iyer,68,48,9,1,1,27,20,5,0,33,28,4,1
6480bb94adb227976b33d30b,2018,,,1,PP Shaw,SS Iyer,68,42,4,4,1,36,20,3,2,32,22,1,2
6480bba0c3cc8c51bc6c1c3a,2013,,,1,SR Watson,SV Samson,68,46,6,2,1,25,21,3,0,41,25,3,2
6480bba097818bcc0db9555d,2014,,,1,DA Miller,GJ Maxwell,68,28,4,7,1,10,10,0,1,56,18,4,6
6480bba19cc161a3fb8a8795,2014,,,2,LMP Simmons,MEK Hussey,68,42,11,0,1,55,29,11,0,6,13,0,0
6480bb9ae4498012aa089436,2023,,,1,RA Jadeja,S Dube,68,53,1,4,1,20,24,0,1,44,29,1,3
6480bb9df60a79ae5f20b748,2011,,,2,RG Sharma,SR Tendulkar,68,64,6,1,0,27,30,3,0,35,34,3,1
6480bb9e32ed1b9e077b8c11,2011,,,2,CH Gayle,TM Dilshan,68,40,11,1,1,27,16,3,1,38,24,8,0
6480bb9936b7698da2c2030c,2023,,,2,AM Rahane,DP Conway,68,43,7,1,1,31,19,2,1,35,24,5,0
6480bb9940bd3bf36dd4897f,2023,,,1,HH Pandya,WP Saha,68,55,7,1,1,25,24,1,1,43,31,6,0
6480bb98af25209ef756aa2c,2021,,,1,KS Bharat,V Kohli,68,43,5,4,1,32,24,2,2,32,19,3,2
6480bba01893b0faadb9c761,2013,,,1,DR Smith,KD Karthik,68,39,4,4,1,46,27,4,3,17,12,0,1
6480bb96e8ba017befb2bc8a,2020/21,,,2,Ishan Kishan,Q de Kock,68,62,9,0,1,41,34,7,0,26,28,2,0
6480bba03ef1ed797291b091,2013,,,1,KD Karthik,SR Tendulkar,68,49,7,1,1,30,22,4,0,34,27,3,1
6480bba3bca9c998d5f3e3d0,2016,,,2,DA Warner,S Dhawan,68,49,8,1,1,40,27,4,1,25,22,4,0
6480bb98373b1ea5035ab3da,2021,,,1,F du Plessis,MM Ali,68,39,4,4,1,29,19,2,1,37,20,2,3
6480bb98f01e4672b988c112,2022,,,1,R Ashwin,SO Hetmyer,68,51,1,5,1,28,23,0,2,36,28,1,3
6480bba0120becd670aec59d,2013,,,2,AB de Villiers,MC Henriques,68,29,9,3,0,41,16,5,2,27,13,4,1
6480bb96a43476c5d9a56c4e,2020/21,,,2,S Dhawan,SS Iyer,68,44,8,1,1,43,21,7,0,23,23,1,1
6480bb9a24adc8d916dfe2db,2023,,,2,B Kumar,H Klaasen,68,47,5,2,1,20,21,2,0,41,26,3,2
6480bb9f231505ffc493730f,2012,,,2,CL White,S Dhawan,68,54,8,0,1,39,30,6,0,28,24,2,0
6480bb9c121ee402b7b2eda6,2009,,,2,AC Gilchrist,HH Gibbs,68,41,5,4,1,15,18,2,0,45,23,3,4
6480bb9fcbbfd8053f253537,2012,,,2,BB McCullum,G Gambhir,68,42,9,1,1,31,21,5,0,36,21,4,1
6480bb9a7d91d721555835e5,2007/08,,,2,DJ Hussey,SC Ganguly,68,47,2,4,1,31,21,1,2,34,26,1,2
6480bba1ff55936e203ca5a6,2014,,,2,G Gambhir,RV Uthappa,68,42,11,1,1,18,14,3,0,46,28,8,1
6480bb9f4bdcea2f81049fe9,2012,,,2,M Vijay,MEK Hussey,68,49,11,0,1,47,27,9,0,20,22,2,0
6480bb96686655f09172741d,2020/21,,,1,PP Shaw,S Dhawan,68,40,8,2,1,42,23,5,2,25,17,3,0
6480bb9ea75f51e7a33e90ed,2012,,,2,Mandeep Singh,SE Marsh,68,49,8,2,1,32,27,4,1,32,22,4,1
6480bb998454ba791a8fdbf8,2023,,,2,RG Sharma,Tilak Varma,68,50,2,5,1,22,21,1,1,41,29,1,4
6480bb96267b63eb2c6747b0,2019,,,1,S Dhawan,SS Iyer,68,53,5,2,1,34,26,3,1,34,27,2,1
6480bb9692a7f0d52bd43127,2019,,,2,DA Miller,N Pooran,68,48,3,5,1,22,22,2,0,45,26,1,5
6480bb9938b659481e3ab6dc,2022,,,1,JC Buttler,SV Samson,68,47,6,3,1,15,21,1,0,47,26,5,3
6480bb9cb881721acc1bab60,2009,,,1,AC Gilchrist,HH Gibbs,68,56,8,2,1,43,31,5,2,23,25,3,0
6480bb97f2f0fabec8f94d86,2020/21,,,2,AT Rayudu,RD Gaikwad,68,37,7,2,1,38,20,5,1,29,17,2,1
6480bb94aa9b082aa58a3822,2017,,,1,HM Amla,MJ Guptill,68,47,7,3,0,16,20,1,0,50,27,6,3
6480bb9448fe25ec89c5fcff,2017,,,2,MJ Guptill,WP Saha,68,35,11,1,1,36,18,5,1,29,17,6,0
6480bb974123cbc9756ceefa,2021,,,1,D Padikkal,V Kohli,68,58,6,3,1,38,34,4,2,25,24,2,1
6480bb9f8d3b0a3d1e28a4b7,2013,,,1,EJG Morgan,JH Kallis,67,30,8,3,1,47,21,5,3,16,9,3,0
6480bb9d5cca30c933d4baf4,2011,,,1,AC Gilchrist,PC Valthaty,67,29,8,3,1,28,16,4,1,33,13,4,2
6480bb9ef8d4c23c6e5be4c7,2011,,,1,CH Gayle,TM Dilshan,67,24,6,6,1,44,16,3,5,21,8,3,1
6480bb9e19dd5297ba8ca5f7,2011,,,2,S Dhawan,S Sohal,67,49,6,2,1,28,25,4,0,31,24,2,2
6480bb9ab49fc97bbb30576f,2023,,,1,F du Plessis,V Kohli,67,43,11,0,1,28,19,5,0,38,24,6,0
6480bba031c5cf0145ae8cfe,2014,,,2,CA Pujara,DA Miller,67,29,1,6,0,14,10,1,0,51,19,0,6
6480bb996c324f07ab7f763c,2023,,,1,B Sai Sudharsan,Shubman Gill,67,44,6,2,1,31,22,2,2,29,22,4,0
6480bb998454ba791a8fdbf8,2023,,,1,AR Patel,DA Warner,67,35,5,5,1,54,25,4,5,9,10,1,0
6480bba1e64915b9e7c849ca,2014,,,2,M Vohra,V Sehwag,67,38,6,3,1,42,19,4,3,16,19,2,0
6480bb9dd10e35e6145534dc,2011,,,2,IK Pathan,V Sehwag,67,36,7,3,1,11,12,1,0,55,24,6,3
6480bb9a577cde04d3672225,2023,,,1,Shubman Gill,WP Saha,67,42,9,1,1,39,20,7,0,28,22,2,1
6480bb97af05ebd5c4f575c4,2021,,,2,DA Warner,JM Bairstow,67,44,5,5,1,23,22,2,1,43,22,3,4
6480bb9765a785922ad360fe,2021,,,2,RR Pant,SS Iyer,67,42,5,3,0,35,21,3,2,28,21,2,1
6480bb9b1087ddfd207caa83,2009,,,2,K Goel,RS Bopara,67,36,3,5,1,38,21,3,3,22,15,0,2
6480bb98436587de59527f2e,2022,,,1,Ishan Kishan,RG Sharma,67,50,7,3,1,25,18,3,1,41,32,4,2
6480bb9824c4678d005d7aeb,2022,,,1,JC Buttler,SV Samson,67,34,5,2,1,24,15,2,0,38,19,3,2
6480bb96c880c7df4e055f14,2020/21,,,1,HH Pandya,KA Pollard,67,23,6,5,0,30,11,3,2,35,12,3,3
6480bba33dab752d79e587d2,2016,,,1,DA Warner,S Dhawan,67,53,7,1,1,46,30,6,1,16,23,1,0
6480bb9d8f5769d3a514fd88,2009/10,,,2,AT Rayudu,SS Tiwary,67,51,3,3,1,17,21,0,0,46,30,3,3
6480bb97d5e3b0911408f222,2020/21,,,2,AT Rayudu,RD Gaikwad,67,50,5,3,1,39,27,3,2,28,23,2,1
6480bb9772f78629131db057,2021,,,1,F du Plessis,RA Jadeja,67,45,6,2,1,50,29,5,2,14,16,1,0
6480bb9f0f959bc6104820c3,2013,,,1,DA Warner,MC Juneja,67,42,6,2,1,43,24,5,1,20,18,1,1
6480bb9837deb0fb66704166,2022,,,1,DA Warner,PP Shaw,67,45,9,2,1,4,11,0,0,61,34,9,2
6480bb9c13fa57328b17e4e2,2009/10,,,1,TM Dilshan,V Sehwag,67,48,6,2,1,15,24,1,0,45,24,5,2
6480bba069d61566bb63ac2b,2014,,,1,PA Patel,YV Takawale,67,46,11,0,1,21,18,3,0,40,28,8,0
6480bb9e59fe7a0f48b7f9b9,2012,,,2,JD Ryder,SPD Smith,67,32,6,4,1,31,19,2,2,34,13,4,2
6480bb95fa6394e733c532a9,2018,,,2,CA Lynn,RV Uthappa,67,57,3,3,1,35,31,1,2,31,26,2,1
6480bb9fe31a789bcb52d583,2012,,,2,BB McCullum,Shakib Al Hasan,67,45,6,2,1,25,20,3,0,37,25,3,2
6480bb9813fa79617f791851,2022,,,2,KD Karthik,Shahbaz Ahmed,67,33,8,3,1,35,19,5,1,31,14,3,2
6480bba00be5cdbaf6648462,2013,,,1,CH Gayle,V Kohli,67,32,4,6,1,28,13,0,4,35,19,4,2
6480bb95d4da0397e79acffa,2019,,,1,AD Russell,RV Uthappa,67,32,5,5,1,48,17,3,5,18,15,2,0
6480bb94dcc956fa4ca06b92,2018,,,1,BB McCullum,Q de Kock,67,49,7,3,1,35,22,4,2,29,27,3,1
6480bba2704d23da78c3eb15,2016,,,2,DA Miller,GJ Maxwell,67,40,4,4,1,11,13,0,0,55,27,4,4
6480bb9bb7a4f1e16df25c8e,2009,,,2,AC Gilchrist,HH Gibbs,67,34,8,4,1,44,19,5,3,21,15,3,1
6480bb9b69f8ace7659e486d,2009,,,1,S Badrinath,SK Raina,67,46,8,2,1,29,27,4,0,38,19,4,2
6480bb97752fcb9cd9f23692,2021,,,1,CH Gayle,KL Rahul,67,43,8,2,1,40,28,4,2,25,15,4,0
6480bba296f606ef91305124,2016,,,1,EJG Morgan,NV Ojha,67,47,5,3,1,29,19,3,1,37,28,2,2
6480bb973d98bfd2d4a5f108,2020/21,,,1,AJ Finch,D Padikkal,67,46,7,2,1,33,23,3,1,32,23,4,1
6480bb971c9e4a3ef11759f3,2021,,,2,EJG Morgan,RA Tripathi,66,48,9,1,1,26,21,3,1,35,27,6,0
6480bb9e5de755887230bb00,2012,,,1,JD Ryder,SPD Smith,66,40,4,4,0,21,18,0,1,44,22,4,3
6480bb991a76403912eef285,2023,,,1,JM Sharma,S Dhawan,66,33,7,2,1,27,16,2,1,36,17,5,1
6480bb9399a527d39bc17dad,2017,,,1,AJ Finch,BB McCullum,66,34,4,5,1,19,15,2,1,41,19,2,4
6480bb987b6845947f7ca137,2022,,,2,N Rana,RK Singh,66,38,6,2,0,17,15,0,1,42,23,6,1
6480bba3aa840e4e9450a200,2016,,,2,KL Rahul,V Kohli,66,45,8,1,1,38,23,4,1,28,22,4,0
6480bb97aed297ca9686c94a,2021,,,2,F du Plessis,MM Ali,66,45,9,1,1,19,14,2,0,46,31,7,1
6480bb9a6935abf34d88ca97,2007/08,,,2,MEK Hussey,SK Raina,66,30,3,6,1,33,17,1,3,32,13,2,3
6480bb93d9581d69657887c3,2017,,,1,KM Jadhav,STR Binny,66,38,5,3,1,47,20,4,3,16,18,1,0
6480bba286cca051953c976a,2015,,,1,BB McCullum,SK Raina,66,46,6,2,1,42,29,5,2,15,17,1,0
6480bb9aded509be64de3bfb,2007/08,,,1,ML Hayden,PA Patel,66,51,7,2,1,34,24,4,2,21,27,3,0
6480bb9b77a0ff5cb3d0e3e0,2009,,,1,S Badrinath,SK Raina,66,41,5,4,1,33,22,3,2,32,19,2,2
6480bba06e8cb70fb4bdc83e,2013,,,1,MC Henriques,V Kohli,66,34,8,2,0,7,9,1,0,56,25,7,2
6480bb9b332c16fba9cd28bc,2009,,,2,AM Nayar,DJ Bravo,66,36,5,2,0,29,20,4,0,34,16,1,2
6480bba0d3cbb27b257a9c1f,2013,,,2,AM Rahane,SR Watson,66,50,6,3,1,35,25,3,2,31,25,3,1
6480bb947a7c9fe868fc901a,2017,,,2,CH Gayle,V Kohli,66,50,4,3,1,22,18,1,1,44,32,3,2
6480bb999424dd02cf40772a,2022,,,1,RM Patidar,V Kohli,66,46,9,1,1,43,26,7,1,22,20,2,0
6480bb9db0ecec8acdd30619,2011,,,1,AB de Villiers,V Kohli,66,46,4,3,1,26,20,1,1,40,26,3,2
6480bb96e61ac20a6e10582e,2019,,,1,AT Rayudu,MS Dhoni,66,48,2,4,0,27,19,2,1,37,29,0,3
6480bb9b8860198955e581d8,2007/08,,,2,RR Sarwan,SE Marsh,66,46,1,4,1,20,22,0,0,44,24,1,4
6480bb9dd4e6757f7ded95e9,2009/10,,,2,RG Sharma,TL Suman,66,40,5,4,1,40,22,4,2,26,18,1,2
6480bb9927b39ebcfd7820b0,2022,,,2,SS Iyer,SW Billings,66,40,4,4,1,33,20,2,2,28,20,2,2
6480bba03b6f98689b851317,2013,,,1,JH Kallis,MS Bisla,66,55,7,2,1,37,33,6,0,24,22,1,2
6480bb96c40b697b63d08717,2019,,,2,PP Shaw,S Dhawan,66,45,9,2,1,47,29,6,2,17,16,3,0
6480bb9d22388e966342dba8,2009/10,,,2,AM Nayar,SR Tendulkar,66,58,6,2,1,27,26,1,2,31,32,5,0
6480bb97493381c4d7dc7bf4,2021,,,1,R Parag,S Dube,66,37,7,2,1,25,16,4,0,35,21,3,2
6480bb9b2de4e62ee60b7e5c,2009,,,2,RS Bopara,Yuvraj Singh,66,34,4,4,1,48,21,2,4,17,13,2,0
6480bba136257b71aa9952cf,2014,,,1,DR Smith,SK Raina,66,28,7,4,1,6,10,0,0,55,18,7,4
6480bb95fbd4f1b7f3d8dfc0,2019,,,1,CH Gayle,KL Rahul,66,38,8,4,1,48,23,6,3,18,15,2,1
6480bb9525ace33768e8b671,2019,,,2,DA Warner,JM Bairstow,66,34,12,0,1,50,25,10,0,15,9,2,0
6480bba2b7be71a15b2bb3de,2015,,,2,DR Smith,SK Raina,66,44,10,1,1,41,29,8,0,22,15,2,1
6480bba2eea6f31945e4c5e2,2016,,,2,JC Buttler,RG Sharma,66,40,6,3,1,41,22,3,3,25,18,3,0
6480bb974e2f8e7f41c506dc,2021,,,1,JC Buttler,YBK Jaiswal,66,46,5,4,1,41,32,3,3,23,14,2,1
6480bb9a81d7fd0ac0307b4d,2023,,,1,C Green,SA Yadav,66,38,6,3,1,33,18,4,1,33,20,2,2
6480bb9cc5312f3d7cfb650e,2009/10,,,1,RS Bopara,Yuvraj Singh,65,40,5,2,1,25,20,2,0,36,20,3,2
6480bb9c963968000dfd00d1,2009/10,,,1,ML Hayden,PA Patel,65,53,6,3,1,33,24,4,2,25,29,2,1
6480bb947a7076697fc0b339,2017,,,1,AM Rahane,RA Tripathi,65,47,8,1,1,24,24,1,1,38,23,7,0
6480bba2c3207713bd927ce5,2015,,,1,DA Warner,MC Henriques,65,46,5,3,1,35,22,1,3,28,24,4,0
6480bba280f09c38002cf14b,2015,,,2,GJ Maxwell,WP Saha,65,34,4,4,1,43,22,4,3,19,12,0,1
6480bb95833c06e6c5119173,2019,,,2,CA Lynn,RV Uthappa,65,49,8,2,1,31,24,2,2,33,25,6,0
6480bba0ddcc30675d83403c,2013,,,1,M Vijay,MEK Hussey,65,45,7,2,1,18,22,2,0,44,23,5,2
6480bb9adb5d9ca80cb1c6a0,2023,,,2,Abhishek Sharma,RA Tripathi,65,41,3,3,1,37,24,2,2,25,17,1,1
6480bb9f0f959bc6104820c3,2013,,,2,AM Rahane,R Dravid,65,51,7,0,1,21,18,2,0,38,33,5,0
6480bb99bb362e3714226928,2022,,,2,DJ Hooda,KH Pandya,65,46,3,3,1,37,23,2,2,25,23,1,1
6480bb9808d6857eeb335d94,2022,,,2,DA Warner,Lalit Yadav,65,49,8,1,1,38,25,7,0,22,24,1,1
6480bb9b9d7aa6d8e47576d7,2007/08,,,2,SR Watson,YK Pathan,65,46,5,2,1,27,17,3,0,34,29,2,2
6480bb93c1cc671d66c471ba,2017,,,1,JC Buttler,PA Patel,65,45,4,3,1,27,18,1,2,30,27,3,1
6480bb95ea40317152ed9ca5,2018,,,1,HV Patel,V Shankar,65,32,2,6,0,36,16,1,4,27,16,1,2
6480bb98aae066234fd8f11e,2022,,,1,HH Pandya,Shubman Gill,65,47,8,0,1,31,27,4,0,34,20,4,0
6480bb9b2e179d359c1d446d,2009,,,1,DR Smith,TL Suman,65,33,5,3,1,40,20,4,2,22,13,1,1
6480bb954817ed0a4ba25bc2,2018,,,1,KA Pollard,KH Pandya,65,36,4,4,1,36,19,3,2,26,17,1,2
6480bba2563745309ee2bdfb,2016,,,2,M Vijay,MP Stoinis,65,40,8,1,1,36,23,5,0,27,17,3,1
6480bba1b85900d7d83de308,2014,,,1,AJ Finch,S Dhawan,65,51,7,2,1,20,23,2,0,39,28,5,2
6480bba3bca9c998d5f3e3d0,2016,,,1,Gurkeerat Singh,HM Amla,65,37,10,1,1,27,20,4,0,36,17,6,1
6480bb9af1b34d6aa89e434e,2023,,,1,PD Salt,RR Rossouw,65,30,5,4,0,26,14,2,2,37,16,3,2
6480bb94dcc956fa4ca06b92,2018,,,1,Mandeep Singh,V Kohli,65,45,5,3,1,19,14,0,2,44,31,5,1
6480bb94cf431881ac3e9cbf,2018,,,1,R Tewatia,RR Pant,65,25,5,6,1,9,7,2,0,49,18,3,6
6480bb97c48a16e84b55a325,2020/21,,,2,JO Holder,KS Williamson,65,47,5,2,0,24,20,3,0,41,27,2,2
6480bb96ec7d98e34055e8fc,2020/21,,,2,F du Plessis,MS Dhoni,65,31,1,7,1,55,19,1,7,9,12,0,0
6480bb95af5853799812b0f6,2019,,,2,AD Russell,Shubman Gill,65,25,4,6,0,46,15,4,4,18,10,0,2
6480bb99f2a793884331579e,2023,,,2,Ishan Kishan,RG Sharma,65,29,5,6,1,43,16,4,4,20,13,1,2
6480bb9f6b144f2a6d105b32,2013,,,2,Harbhajan Singh,KA Pollard,65,48,2,6,0,21,21,1,1,41,27,1,5
6480bba0a9f68a29bda72302,2013,,,2,MK Pandey,Yuvraj Singh,65,40,8,2,1,42,23,8,0,22,17,0,2
6480bb9c7b7d7712bdc663de,2009/10,,,1,AT Rayudu,SS Tiwary,65,46,2,4,1,26,19,2,1,37,27,0,3
6480bb9e93f969bcc8a79433,2011,,,2,JA Morkel,S Badrinath,65,54,5,1,1,30,30,3,0,32,24,2,1
6480bba1d3b4ddc36050e3f3,2014,,,2,MK Pandey,RV Uthappa,65,42,7,2,1,21,17,3,0,41,25,4,2
6480bb9d85a6220ec9bc7dcb,2011,,,2,S Badrinath,SK Raina,65,47,5,2,0,30,22,4,0,34,25,1,2
6480bb9ed74d222a3da56dfa,2012,,,2,G Gambhir,MS Bisla,65,43,4,3,1,18,14,2,0,46,29,2,3
6480bb9b52b93b56f5a16e52,2007/08,,,2,GC Smith,SA Asnodkar,65,40,11,1,1,25,21,5,0,39,19,6,1
6480bba1f5d65d6146678a7f,2015,,,2,G Gambhir,YK Pathan,65,47,9,1,1,25,21,3,0,40,26,6,1
6480bb9aa37f3b44678752d9,2023,,,1,SA Yadav,Vishnu Vinod,65,42,5,4,1,35,22,3,2,30,20,2,2
6480bb9ccba48a6bb44ccc21,2009,,,2,AM Nayar,JP Duminy,65,52,3,2,1,26,25,1,1,37,27,2,1
6480bba0f1ebf9ff255e1c91,2013,,,1,SR Watson,STR Binny,65,30,9,3,0,56,20,8,3,9,10,1,0
6480bba2fc84811f520b04cf,2016,,,2,AJ Finch,KD Karthik,65,38,10,0,1,44,25,7,0,20,13,3,0
6480bb99bbae76f3f761d060,2023,,,2,JJ Roy,RK Singh,65,37,5,4,1,42,22,5,2,21,15,0,2
6480bb96ef6f4c2c85264241,2019,,,2,HH Pandya,KH Pandya,64,28,5,4,1,45,18,5,3,15,10,0,1
6480bb9a77f349a0fd8d96d6,2023,,,1,JM Sharma,SM Curran,64,44,4,3,1,44,28,3,3,17,16,1,0
6480bb980b5b26e8c4335a4b,2022,,,2,AT Rayudu,RA Jadeja,64,32,5,4,1,46,20,4,4,12,12,1,0
6480bb94adb227976b33d30b,2018,,,2,AD Russell,Shubman Gill,64,36,5,4,1,43,22,3,4,18,14,2,0
6480bb9f231505ffc493730f,2012,,,1,F du Plessis,SK Raina,64,44,4,3,1,29,20,2,1,32,24,2,2
6480bb95f2e3c32afe233820,2018,,,1,KS Williamson,Shakib Al Hasan,64,47,6,2,1,34,20,3,2,26,27,3,0
6480bba278153a5979e31ec9,2016,,,1,MS Dhoni,SPD Smith,64,35,3,5,1,26,17,1,2,36,18,2,3
6480bb9d872bbb611f6266cb,2011,,,2,MS Dhoni,S Badrinath,64,32,6,2,1,43,20,4,2,20,12,2,0
6480bb9eb35365cccf73d55c,2011,,,2,G Gambhir,YK Pathan,64,50,7,1,1,32,25,4,0,29,25,3,1
6480bba0d4b2f9be71a5f230,2014,,,1,MK Pandey,RV Uthappa,64,56,5,0,1,45,37,5,0,15,19,0,0
6480bb96edb3270eba0af1d4,2020/21,,,2,AT Rayudu,N Jagadeesan,64,52,7,0,1,28,24,3,0,33,28,4,0
6480bba2bae80e615447f251,2015,,,1,F du Plessis,SK Raina,64,52,3,2,1,24,20,0,1,36,32,3,1
6480bb946efcc4cd9aa80399,2018,,,1,AB de Villiers,V Kohli,64,36,2,6,1,44,23,1,5,20,13,1,1
6480bb95833c06e6c5119173,2019,,,1,PA Patel,V Kohli,64,47,8,0,1,25,24,3,0,38,23,5,0
6480bb97ce981c1918dce924,2021,,,2,Abhishek Sharma,JJ Roy,64,32,9,1,1,25,11,3,1,34,21,6,0
6480bb988b447f26d7a96c0c,2022,,,2,SA Yadav,Tilak Varma,64,48,5,0,1,34,22,3,0,26,26,2,0
6480bb99a620a7afdb3217fe,2023,,,2,DA Warner,Lalit Yadav,64,44,6,0,1,23,20,1,0,38,24,5,0
6480bb9e713e850d3dd0cba9,2012,,,1,AL Menaria,BJ Hodge,64,45,5,2,1,20,16,2,0,44,29,3,2
6480bba19cc161a3fb8a8795,2014,,,1,M Vohra,SE Marsh,64,43,5,3,1,28,26,3,1,30,17,2,2
6480bba19052ba503c5f7c27,2015,,,2,AM Rahane,SV Samson,64,62,6,0,1,33,32,4,0,26,30,2,0
6480bb99fa79383bdc7df827,2022,,,2,GJ Maxwell,RM Patidar,64,37,4,3,1,35,20,3,1,26,17,1,2
6480bb9bb7a4f1e16df25c8e,2009,,,1,ML Hayden,SK Raina,64,41,8,2,1,35,22,7,0,25,19,1,2
6480bb9802d8f5ec4413766d,2022,,,2,Abhishek Sharma,KS Williamson,64,53,7,1,1,42,32,6,0,22,21,1,1
6480bb958f737f809dfb65e1,2019,,,2,DA Warner,JM Bairstow,64,41,9,1,1,7,13,0,0,48,28,9,1
6480bba11eff9b230a172302,2014,,,2,AM Rahane,SR Watson,64,45,7,1,1,31,21,2,1,33,24,5,0
6480bba141bcb000fa6fe2a4,2015,,,1,AM Rahane,SPD Smith,64,52,5,0,1,36,27,3,0,28,25,2,0
6480bba15f6842352b6338ae,2014,,,1,G Gambhir,RV Uthappa,64,42,11,0,1,21,20,3,0,42,22,8,0
6480bb93f866249511c76dbc,2017,,,2,RA Tripathi,SPD Smith,64,32,8,3,1,33,17,3,2,29,15,5,1
6480bb9dc8b09381d0f01a9d,2011,,,1,M Vijay,MEK Hussey,64,56,5,2,1,31,29,2,1,32,27,3,1
6480bb9523e6dc3c988ce398,2019,,,1,MP Stoinis,V Kohli,64,24,6,4,1,17,8,2,1,45,16,4,3
6480bb9ab49fc97bbb30576f,2023,,,1,Anuj Rawat,V Kohli,64,34,6,2,0,23,15,1,1,40,19,5,1
6480bb9d80e97e178e5f68de,2011,,,2,JH Kallis,MS Bisla,64,53,7,0,1,31,24,4,0,27,29,3,0
6480bb9a577cde04d3672225,2023,,,1,B Sai Sudharsan,WP Saha,64,42,5,1,1,36,25,2,1,26,17,3,0
6480bb99bb362e3714226928,2022,,,1,SV Samson,YBK Jaiswal,64,40,10,1,1,32,24,6,0,30,16,4,1
6480bba2e680f2464af841ae,2015,,,2,MC Henriques,RS Bopara,64,30,1,4,0,46,19,0,4,17,11,1,0
6480bb9525c593ee45bb038c,2019,,,2,KL Rahul,MA Agarwal,64,37,4,2,1,18,16,0,0,43,21,4,2
6480bb96ee2a21f0d9b9f37f,2020/21,,,2,N Rana,Shubman Gill,64,41,5,3,1,34,22,3,2,27,19,2,1
6480bb95c8ecc2185a67f4fd,2019,,,1,BA Stokes,SV Samson,64,25,8,2,0,16,9,3,0,46,16,5,2
6480bba1587a54176a9badf4,2014,,,2,NV Ojha,S Dhawan,64,46,10,1,1,26,23,5,1,24,23,5,0
6480bb984a44a355b856fd1a,2022,,,2,Abhishek Sharma,KS Williamson,64,44,10,1,1,47,28,8,1,15,16,2,0
6480bb979e8cc2484c1a8c7b,2020/21,,,1,HH Pandya,SS Tiwary,64,31,4,5,1,33,14,0,4,30,17,4,1
6480bb95960e393c939ab44c,2018,,,1,RR Pant,V Shankar,64,47,2,4,1,32,26,0,3,27,21,2,1
6480bb96267b63eb2c6747b0,2019,,,2,PA Patel,V Kohli,63,35,9,2,1,39,20,7,1,22,15,2,1
6480bb99b35dc0981e512451,2022,,,2,HH Pandya,Shubman Gill,63,53,5,1,1,34,30,3,1,26,23,2,0
6480bb95481ab7c06b86419b,2018,,,1,GJ Maxwell,RR Pant,63,31,6,4,1,9,8,1,0,53,23,5,4
6480bba2ad3f26917361061f,2016,,,1,SR Watson,V Kohli,63,30,5,5,1,33,19,2,3,29,11,3,2
6480bb9de80788b3c3ebe4e1,2009/10,,,2,JP Duminy,SR Tendulkar,63,52,7,0,1,31,32,4,0,26,20,3,0
6480bb9359a2cade3b5213d3,2017,,,1,CH Gayle,V Kohli,63,56,5,2,1,22,27,2,1,37,29,3,1
6480bba2c04b3acd88a50839,2015,,,2,MK Tiwary,SS Iyer,63,59,5,3,1,25,28,3,1,35,31,2,2
6480bba1827557ebdfc70821,2015,,,1,GJ Bailey,GJ Maxwell,63,44,5,2,1,23,19,3,0,33,25,2,2
6480bb9e5ab10d1241d6509d,2012,,,2,JD Ryder,RV Uthappa,63,42,7,2,1,34,22,4,1,26,20,3,1
6480bb95d675b7da24db1a57,2019,,,1,RV Uthappa,Shubman Gill,63,52,9,1,1,28,30,4,1,33,22,5,0
6480bba136257b71aa9952cf,2014,,,2,DA Miller,V Sehwag,63,32,7,3,1,31,15,4,1,31,17,3,2
6480bba1d3370c13ea1f79f3,2014,,,2,KP Pietersen,MA Agarwal,63,44,4,3,1,28,22,2,1,28,22,2,2
6480bb9b95eac8df5d0180b0,2007/08,,,2,DPMD Jayawardene,LA Pomersbach,63,27,3,5,0,36,17,3,2,24,10,0,3
6480bb974e2f8e7f41c506dc,2021,,,2,KH Pandya,Q de Kock,63,44,2,2,1,39,26,2,2,17,18,0,0
6480bba29f384ce360fa8131,2016,,,2,F du Plessis,SPD Smith,63,46,6,0,1,22,20,1,0,38,26,5,0
6480bb9c7ac2dca34620d56e,2009/10,,,2,JH Kallis,V Kohli,63,52,6,1,1,28,28,3,0,34,24,3,1
6480bb9932735ca83d38f6e7,2022,,,1,AD Russell,SW Billings,63,44,5,2,1,30,23,3,1,26,21,2,1
6480bb9448fe25ec89c5fcff,2017,,,2,GJ Maxwell,WP Saha,63,33,4,5,1,47,21,2,5,14,12,2,0
6480bb974086cbea889134af,2021,,,1,AT Rayudu,SK Raina,63,33,1,6,1,23,16,1,2,35,17,0,4
6480bb9a5d25d853e1cbfe3e,2007/08,,,2,IK Pathan,Yuvraj Singh,63,47,5,4,1,12,17,0,1,51,30,5,3
6480bb9b1fc007965b68d4d9,2009,,,1,AC Gilchrist,HH Gibbs,63,41,7,3,1,35,20,3,3,23,21,4,0
6480bb9dd778cb6c44535092,2009/10,,,2,JP Duminy,SS Tiwary,63,60,6,1,1,19,27,2,0,43,33,4,1
6480bb96ef6f4c2c85264241,2019,,,2,HH Pandya,KA Pollard,63,30,3,6,1,46,16,1,6,16,14,2,0
6480bb9ce93a7b4315d8fa30,2009,,,1,A Symonds,DB Ravi Teja,63,37,6,2,1,41,21,3,2,18,16,3,0
6480bb9341152e168005ccc9,2017,,,2,AM Rahane,RA Tripathi,63,46,7,1,1,30,25,5,0,27,21,2,1
6480bb98373b1ea5035ab3da,2021,,,1,F du Plessis,RV Uthappa,63,32,2,5,1,30,17,2,2,31,15,0,3
6480bb9f302200e3bc89464e,2012,,,1,PA Reddy,S Dhawan,63,51,5,3,1,33,27,3,1,26,24,2,2
6480bba2679194b06d4834db,2016,,,2,AT Rayudu,KH Pandya,63,39,3,4,1,26,20,1,1,35,19,2,3
6480bb9ec0a4e3f137edb047,2011,,,2,S Badrinath,SK Raina,63,58,8,1,1,34,32,5,0,26,26,3,1
6480bb95f214d4f82ab97ee5,2018,,,1,JC Buttler,RA Tripathi,63,29,9,3,1,35,14,5,2,27,15,4,1
6480bba15b304732a6212cdf,2015,,,1,BB McCullum,MS Dhoni,63,35,5,4,1,9,6,1,0,53,29,4,4
6480bb9f210b6e50fb2072ae,2013,,,1,CH Gayle,V Kohli,63,41,5,5,1,26,14,1,3,35,27,4,2
6480bba210201df0f7975000,2016,,,2,SN Khan,TM Head,63,34,4,3,1,22,16,2,1,35,18,2,2
6480bb962831291a868490e7,2020/21,,,2,RR Pant,SS Iyer,63,55,6,1,1,27,33,2,1,31,22,4,0
6480bba0120becd670aec59d,2013,,,1,AD Mathews,RV Uthappa,63,33,1,6,1,32,19,0,3,30,14,1,3
6480bba30373b229e0090b67,2016,,,2,KL Rahul,V Kohli,63,45,8,1,1,42,25,6,1,20,20,2,0
6480bba1553f17c77d5f1ca2,2014,,,1,AJ Finch,DA Warner,63,54,5,1,1,22,27,1,0,39,27,4,1
6480bba2bae80e615447f251,2015,,,2,KD Karthik,V Kohli,63,52,5,1,1,23,19,4,0,39,33,1,1
6480bba0120becd670aec59d,2013,,,2,SS Tiwary,V Kohli,63,39,4,1,1,28,21,1,1,25,18,3,0
6480bb9cc5312f3d7cfb650e,2009/10,,,1,KC Sangakkara,MS Bisla,63,44,10,0,1,31,19,6,0,27,25,4,0
6480bb96acacf3be646d300a,2020/21,,,1,MK Pandey,WP Saha,63,29,6,2,1,11,8,0,0,47,21,6,2
6480bba154ce29a67e4752df,2015,,,2,RG Sharma,UBT Chand,63,25,7,4,1,37,12,2,4,24,13,5,0
6480bba140ee53a14fe06e0d,2014,,,2,DR Smith,F du Plessis,63,46,4,4,1,37,26,3,3,25,20,1,1
6480bba388682c5ca10ff37a,2016,,,2,DA Warner,S Dhawan,63,40,6,3,1,32,15,3,2,28,25,3,1
6480bb9774dd8e44bbeeb5a4,2021,,,2,PP Shaw,S Dhawan,63,37,7,3,1,39,22,3,3,22,15,4,0
6480bba07e219ed95b7b06df,2013,,,1,DA Warner,KM Jadhav,63,35,3,5,1,36,16,3,3,25,19,0,2
6480bb94cf431881ac3e9cbf,2018,,,2,AB de Villiers,V Kohli,63,39,7,2,1,40,19,6,1,22,20,1,1
6480bb9f777b7b1e89543a6e,2013,,,1,AM Rahane,SR Watson,62,44,8,2,1,25,19,3,1,31,25,5,1
6480bb991a4f7e5f59dd1afc,2023,,,2,N Jagadeesan,N Rana,62,29,8,3,1,28,15,4,1,34,14,4,2
6480bb97a42828c5a5ebef1c,2020/21,,,1,Q de Kock,SA Yadav,62,37,6,3,1,24,17,2,1,35,20,4,2
6480bb9808d6857eeb335d94,2022,,,1,N Rana,RK Singh,62,35,5,3,1,36,19,2,3,23,16,3,0
6480bb9558c0acb502a3b1a9,2019,,,1,DA Miller,SN Khan,62,40,5,2,1,33,24,2,2,22,16,3,0
6480bb96c880c7df4e055f14,2020/21,,,1,Ishan Kishan,RG Sharma,62,56,5,1,1,28,32,1,1,31,24,4,0
6480bb9edbd8851db7e06741,2012,,,1,AM Rahane,R Dravid,62,35,10,1,1,17,11,3,0,42,24,7,1
6480bb9a61edc0c77bc4bc86,2007/08,,,2,S Vidyut,SP Fleming,62,37,9,1,1,40,23,6,1,18,14,3,0
6480bb9f7bae5ad85c4473ba,2012,,,2,DJ Bravo,SK Raina,62,45,5,2,1,21,24,2,0,36,21,3,2
6480bb9bc8bcea920f081be8,2009,,,1,KP Pietersen,LRPL Taylor,62,50,5,2,1,30,22,2,2,27,28,3,0
6480bba1c67d2c9c1279a4c8,2014,,,2,DA Warner,S Dhawan,62,55,7,0,1,31,29,4,0,27,26,3,0
6480bb9558c0acb502a3b1a9,2019,,,2,CA Ingram,RR Pant,62,41,6,3,1,37,26,4,1,25,15,2,2
6480bb9c3803ef7726af83ab,2009/10,,,1,M Vijay,ML Hayden,62,35,8,3,1,28,14,3,2,34,21,5,1
6480bb9e21655ee16a96b2c3,2012,,,2,AM Rahane,R Dravid,62,62,5,2,1,37,30,3,2,25,32,2,0
6480bb939c56810fd88e895b,2017,,,1,HM Amla,M Vohra,62,36,7,2,1,26,15,3,1,34,21,4,1
6480bb960d9d6af315534958,2019,,,2,CA Lynn,Shubman Gill,62,36,7,3,1,46,22,5,3,15,14,2,0
6480bba2679194b06d4834db,2016,,,1,DA Warner,MC Henriques,62,57,5,2,1,39,35,4,1,20,22,1,1
6480bb94009d0662ee94f07b,2018,,,2,S Dhawan,WP Saha,62,41,10,0,1,39,21,7,0,22,20,3,0
6480bb94c008939d7976abfe,2018,,,1,AM Rahane,SV Samson,62,41,5,2,1,25,19,3,0,37,22,2,2
6480bb97fcc6fccd233157f9,2021,,,1,RR Pant,SS Iyer,62,45,3,2,1,24,24,2,0,37,21,1,2
6480bb9a9514379c05d59c38,2023,,,2,TH David,Tilak Varma,62,23,4,5,0,45,14,2,5,15,9,2,0
6480bb991a76403912eef285,2023,,,2,Dhruv Jurel,SO Hetmyer,62,27,3,5,1,28,13,2,2,33,14,1,3
6480bb98c0ad46409044aad2,2022,,,1,AT Rayudu,MM Ali,62,50,7,1,1,27,27,4,0,35,23,3,1
6480bb9516b0dbc1972e5c3c,2018,,,2,AM Rahane,SV Samson,62,54,4,2,1,20,23,1,0,42,31,3,2
6480bb97746881ab34c38bf8,2020/21,,,1,AB de Villiers,D Padikkal,62,29,5,4,1,36,17,3,2,24,12,2,2
6480bba15f6842352b6338ae,2014,,,2,F du Plessis,SK Raina,62,36,3,4,1,23,20,2,0,38,16,1,4
6480bb96ef6f4c2c85264241,2019,,,1,AD Russell,Shubman Gill,62,35,5,4,1,24,18,2,2,34,17,3,2
6480bb98e87e6f83b61088ea,2022,,,2,MS Dhoni,S Dube,62,46,4,3,1,11,21,0,0,49,25,4,3
6480bb9d9f4551d7ec79c951,2009/10,,,2,S Badrinath,SK Raina,62,34,5,4,1,21,12,2,1,38,22,3,3
6480bb9d1f9a3cf1fa86e11c,2011,,,2,CA Pujara,V Kohli,62,35,6,2,1,25,15,4,0,35,20,2,2
6480bb973e451a92813d78cc,2020/21,,,1,MK Pandey,WP Saha,62,51,3,1,1,33,23,3,0,26,28,0,1
6480bb9a8cf29e28434bb1d5,2023,,,2,A Manohar,HH Pandya,62,63,3,1,1,26,33,0,1,32,30,3,0
6480bb945460b25d997060fb,2018,,,2,GJ Maxwell,RR Pant,62,33,9,2,1,22,12,3,1,36,21,6,1
6480bb98adf21699eaa67796,2022,,,1,F du Plessis,V Kohli,62,44,6,2,1,38,22,4,1,22,22,2,1
6480bb94fc240a33621b10a6,2018,,,1,CA Lynn,KD Karthik,62,34,7,1,1,30,14,3,1,31,20,4,0
6480bb9552e25b3867e5c38a,2019,,,1,KH Pandya,SA Yadav,62,49,7,1,1,42,32,5,1,20,17,2,0
6480bb9ed6aefcc9cd13d851,2012,,,2,RV Uthappa,SPD Smith,62,39,3,2,1,26,18,1,1,34,21,2,1
6480bb9a0a8baa96f94e8db9,2023,,,1,F du Plessis,V Kohli,62,54,4,1,1,29,24,1,1,31,30,3,0
6480bb9a9514379c05d59c38,2023,,,2,C Green,Ishan Kishan,62,38,6,2,1,41,22,4,2,19,16,2,0
6480bba0e883438915efc1e6,2013,,,2,MS Dhoni,SK Raina,61,27,6,3,0,45,16,4,3,15,11,2,0
6480bb9ee7a29c9b96ed61e5,2011,,,1,AC Gilchrist,KD Karthik,61,46,6,2,1,47,33,5,2,11,13,1,0
6480bb9b1fc007965b68d4d9,2009,,,1,DR Smith,HH Gibbs,61,36,3,4,1,35,22,2,2,24,14,1,2
6480bb96e29253678ca02869,2020/21,,,1,KL Rahul,MA Agarwal,61,49,7,0,1,32,30,4,0,26,19,3,0
6480bb95b33a36f0dd77d1a1,2018,,,2,JC Buttler,SV Samson,61,28,5,4,1,33,14,3,2,26,14,2,2
6480bb9bc74c35e494cec477,2007/08,,,2,AC Gilchrist,HH Gibbs,61,49,9,1,1,40,29,7,1,19,20,2,0
6480bb932d6ccb8870dcd72d,2017,,,2,BA Stokes,MK Tiwary,61,37,3,3,1,32,21,1,2,26,16,2,1
6480bb9e05571c1a4c163ef1,2012,,,1,F du Plessis,SK Raina,61,52,3,1,1,33,29,0,1,26,23,3,0
6480bb9c7ac2dca34620d56e,2009/10,,,1,M Vijay,ML Hayden,61,41,3,4,1,47,27,3,3,12,14,0,1
6480bb945460b25d997060fb,2018,,,1,AD Russell,N Rana,61,22,1,8,1,41,12,0,6,20,10,1,2
6480bba0b46cf5430edef3f5,2014,,,1,AT Rayudu,RG Sharma,61,45,2,1,1,30,25,2,0,27,20,0,1
6480bb93f866249511c76dbc,2017,,,1,AJ Finch,SK Raina,61,31,7,3,0,33,19,3,2,26,12,4,1
6480bb9558c0acb502a3b1a9,2019,,,2,S Dhawan,SS Iyer,61,43,9,0,1,27,21,4,0,28,22,5,0
6480bb96e834e1c16b33f325,2020/21,,,2,R Tewatia,SV Samson,61,43,1,5,1,14,21,0,1,44,22,1,4
6480bb98373b1ea5035ab3da,2021,,,1,F du Plessis,RD Gaikwad,61,50,6,1,1,27,23,3,0,32,27,3,1
6480bb957e6d387fe3a6b26e,2018,,,1,Abhishek Sharma,V Shankar,61,30,4,4,0,46,19,3,4,13,11,1,0
6480bb9e5de755887230bb00,2012,,,2,MS Dhoni,RA Jadeja,61,45,4,2,1,16,20,0,0,44,25,4,2
6480bb973da000031d26fbba,2021,,,1,AK Markram,DJ Hooda,61,47,6,1,1,36,26,5,0,25,21,1,1
6480bb9541caaeddc9ddaac3,2019,,,2,RA Tripathi,SPD Smith,61,42,7,1,1,39,24,5,1,19,18,2,0
6480bb9bc8bcea920f081be8,2009,,,1,MV Boucher,V Kohli,61,48,3,2,1,36,28,2,2,20,20,1,0
6480bb9c5ec0713155cad138,2009/10,,,1,AC Gilchrist,VVS Laxman,61,35,5,3,1,36,21,3,2,22,14,2,1
6480bb9ab34d149420eae546,2023,,,2,JJ Roy,VR Iyer,61,35,9,2,1,36,20,6,1,24,15,3,1
6480bb9bd918d2e963f0218a,2009,,,2,AC Gilchrist,RG Sharma,61,36,1,6,1,29,19,0,3,29,17,1,3
6480bb997d1393ca85856ec2,2022,,,1,DA Miller,HH Pandya,61,47,2,4,1,34,25,0,3,26,22,2,1
6480bb942efd740a6ffc47df,2017,,,1,JC Buttler,N Rana,61,44,8,1,1,33,21,4,1,26,23,4,0
6480bb9ec0a4e3f137edb047,2011,,,2,MS Dhoni,SK Raina,61,35,4,4,1,29,19,3,1,30,16,1,3
6480bb9c442caaabe9eb2275,2009,,,1,AB de Villiers,TM Dilshan,61,52,7,1,1,44,35,5,1,15,17,2,0
6480bb9541caaeddc9ddaac3,2019,,,1,MS Dhoni,SK Raina,61,53,5,1,1,28,26,2,0,31,27,3,1
6480bb9c94ef2c2e850189ff,2009/10,,,1,JH Kallis,V Kohli,61,29,5,4,0,44,17,4,3,16,12,1,1
6480bb94834e2b780c4782b5,2017,,,2,AT Rayudu,SS Tiwary,61,46,7,1,1,36,27,3,1,24,19,4,0
6480bb9d29051b8e40c07d52,2011,,,1,DJ Jacobs,SR Tendulkar,61,50,7,0,1,12,21,1,0,36,29,6,0
6480bb9c58b62383739c022e,2009,,,2,RA Jadeja,RJ Quiney,61,36,6,3,1,36,22,4,1,25,14,2,2
6480bb9d872bbb611f6266cb,2011,,,1,AC Gilchrist,PC Valthaty,61,35,9,1,1,19,15,2,0,41,20,7,1
6480bb990b96e91d3fbf421b,2022,,,2,JC Buttler,YBK Jaiswal,61,31,5,5,1,40,18,4,3,21,13,1,2
6480bb970d7cbd85b6ada680,2021,,,1,Harpreet Brar,KL Rahul,61,32,5,3,0,25,17,1,2,35,15,4,1
6480bb9dbefe5e2cceb23e01,2011,,,1,AT Rayudu,RG Sharma,61,45,8,1,1,24,22,4,0,33,23,4,1
6480bb9d85a6220ec9bc7dcb,2011,,,2,M Vijay,S Badrinath,61,44,3,3,1,24,22,1,1,33,22,2,2
6480bba0ffae8617ee64bd19,2013,,,1,M Vijay,MEK Hussey,61,44,6,1,1,31,23,3,1,23,21,3,0
6480bb9c2f07203e8e510386,2009/10,,,2,G Gambhir,M Manhas,61,42,5,1,1,35,20,4,1,26,22,1,0
6480bba1abec4894f2f69a35,2014,,,2,CH Gayle,V Kohli,61,64,3,2,1,24,35,2,1,27,29,1,1
6480bb9cba868c69775db687,2009,,,2,ML Hayden,PA Patel,61,42,9,1,1,26,19,2,1,34,23,7,0
6480bb9c4934a2adde9d76ce,2009/10,,,1,S Dhawan,SR Tendulkar,61,41,11,0,1,23,21,4,0,35,20,7,0
6480bba140ee53a14fe06e0d,2014,,,1,AT Rayudu,LMP Simmons,61,54,3,4,1,28,25,1,2,32,29,2,2
6480bb9d97cceb6330e84df0,2011,,,2,BB McCullum,M Klinger,61,32,8,2,1,37,19,5,2,14,13,3,0
6480bb98bc3569cc8d04101a,2022,,,2,PJ Cummins,VR Iyer,61,18,4,6,0,56,15,4,6,4,3,0,0
6480bb94b991069934e5c7d2,2018,,,2,KD Karthik,N Rana,61,38,2,3,0,42,23,2,2,18,15,0,1
6480bb9aa37f3b44678752d9,2023,,,1,Ishan Kishan,RG Sharma,61,37,7,3,1,31,19,4,1,29,18,3,2
6480bb9dd10e35e6145534dc,2011,,,2,TR Birt,V Sehwag,61,28,6,3,1,4,8,0,0,56,20,6,3
6480bb9b2de4e62ee60b7e5c,2009,,,1,JH Kallis,LRPL Taylor,61,36,5,2,1,32,20,2,1,24,16,3,1
6480bb9ec07aa72ec89917f0,2012,,,1,DPMD Jayawardene,KP Pietersen,61,44,4,2,0,20,21,1,0,40,23,3,2
6480bb98aae066234fd8f11e,2022,,,2,Lalit Yadav,RR Pant,61,41,8,1,1,25,22,2,1,32,19,6,0
6480bba1ff89cb428182daa6,2014,,,2,F du Plessis,MS Dhoni,61,37,7,1,1,46,21,7,1,15,16,0,0
6480bb9affabe4960a987464,2007/08,,,2,BB McCullum,SC Ganguly,61,32,7,3,1,41,20,5,3,10,12,2,0
6480bb9bee2e48d9c41b1e23,2009,,,1,M Vijay,ML Hayden,61,41,7,3,1,15,15,2,0,43,26,5,3
6480bb9ef8d4c23c6e5be4c7,2011,,,1,TM Dilshan,V Kohli,61,56,8,0,0,31,23,5,0,27,33,3,0
6480bb948a69b3d86293b12b,2017,,,2,PJ Cummins,SS Iyer,61,27,8,2,1,24,13,2,1,37,14,6,1
6480bb9a3ffea6235f54cc1e,2023,,,1,N Rana,RK Singh,61,40,5,3,1,37,25,2,3,22,15,3,0
6480bba119569fcc2d7859a4,2014,,,2,AB de Villiers,V Kohli,61,31,3,3,1,28,15,2,1,28,16,1,2
6480bba2b99fcf06aaeac805,2015,,,1,AT Rayudu,KA Pollard,61,30,5,3,1,34,16,3,2,24,14,2,1
6480bb9b5d0191a0a2611916,2009,,,2,RA Jadeja,SK Warne,60,57,4,0,1,25,29,1,0,29,28,3,0
6480bb9b332c16fba9cd28bc,2009,,,2,DJ Bravo,ST Jayasuriya,60,53,5,1,1,16,24,0,0,44,29,5,1
6480bb9a58bc8710c38f4c1c,2023,,,1,MP Stoinis,N Pooran,60,24,4,5,0,48,16,3,5,8,8,1,0
6480bb9be2940d96c1f903ca,2007/08,,,1,PA Patel,SP Fleming,60,56,6,1,1,24,29,4,0,29,27,2,1
6480bb9a325c576efe386437,2023,,,2,DA Warner,PD Salt,60,31,6,4,1,22,14,3,1,35,17,3,3
6480bb9c89e2e8ecb04f94cb,2009/10,,,1,RG Sharma,TL Suman,60,32,5,4,1,35,17,2,3,25,15,3,1
6480bb9c2f07203e8e510386,2009/10,,,1,IK Pathan,RS Bopara,60,43,8,0,1,21,16,2,0,38,27,6,0
6480bba2f39653e2f61baca2,2015,,,1,AT Rayudu,RG Sharma,60,60,3,1,1,24,29,1,0,32,31,2,1
6480bb9affabe4960a987464,2007/08,,,2,BB McCullum,DJ Hussey,60,30,4,3,1,45,18,3,3,12,12,1,0
6480bb9498a98d52f9285b52,2017,,,2,BA Stokes,SPD Smith,60,47,1,3,1,39,25,1,3,19,22,0,0
6480bba03a099a1a2e9c3dc5,2013,,,1,AC Gilchrist,SE Marsh,60,45,8,2,1,42,26,5,2,14,19,3,0
6480bb981dc3f7250f93bc92,2022,,,2,MR Marsh,RR Pant,60,25,7,4,1,32,13,2,3,28,12,5,1
6480bb93575636076d81e4c5,2017,,,1,DA Warner,NV Ojha,60,37,5,1,1,23,17,3,0,34,20,2,1
6480bb950ced01a335bd7833,2019,,,2,AM Rahane,JC Buttler,60,46,9,0,1,22,20,4,0,32,26,5,0
6480bb9b2abb1e5479b853f5,2009,,,1,DA Warner,G Gambhir,60,42,8,1,1,36,23,5,1,22,19,3,0
6480bb9836d24b9817a35f7d,2022,,,2,DA Miller,R Tewatia,60,34,4,4,1,27,16,1,2,32,18,3,2
6480bb9d40fc01528c7b7270,2009/10,,,2,KP Pietersen,RV Uthappa,60,35,7,2,1,33,14,5,1,26,21,2,1
6480bb95fbd4f1b7f3d8dfc0,2019,,,1,CH Gayle,Mandeep Singh,60,37,5,2,0,39,21,4,2,18,16,1,0
6480bb94351a8b10e20d14d9,2017,,,1,GJ Maxwell,HM Amla,60,25,4,5,1,20,11,0,2,40,14,4,3
6480bb9ca21b98f1be8254e2,2009/10,,,1,DL Vettori,PD Collingwood,60,33,4,4,0,19,17,2,0,36,16,2,4
6480bb9763013a01eae041f2,2020/21,,,2,DA Warner,MK Pandey,60,34,7,2,1,27,15,3,1,30,19,4,1
6480bba11a59d64bb4aa66f4,2014,,,1,DA Miller,GJ Bailey,60,33,1,3,0,25,15,0,2,26,18,1,1
6480bb9525c593ee45bb038c,2019,,,2,DA Miller,KL Rahul,60,31,7,1,0,15,10,2,0,41,21,5,1
6480bb9ded279701c84af803,2011,,,1,MEK Hussey,SK Raina,60,53,7,0,1,36,33,4,0,24,20,3,0
6480bb958f77e7d3929d28e3,2018,,,1,DA Miller,MK Tiwary,60,44,4,2,1,23,19,1,1,33,25,3,1
6480bba15b304732a6212cdf,2015,,,1,BB McCullum,SK Raina,60,33,3,5,1,45,21,2,5,14,12,1,0
6480bb95f45dffe4751efc46,2019,,,1,AT Rayudu,MS Dhoni,60,38,5,2,0,21,15,1,1,37,23,4,1
6480bb9fcbbfd8053f253537,2012,,,2,BB McCullum,JH Kallis,60,49,5,0,1,25,22,2,0,30,27,3,0
6480bb9429a15517bb46f3be,2018,,,2,JJ Roy,SS Iyer,60,40,5,3,0,31,20,2,2,27,20,3,1
6480bb94f1c027945eeb8b10,2017,,,2,HH Pandya,RG Sharma,60,49,5,1,1,15,24,0,0,44,25,5,1
6480bba1de7febd9f1f0138e,2014,,,2,Ankit Sharma,SR Watson,60,47,6,2,1,30,27,4,1,21,20,2,1
6480bb9f70156528a31bb270,2013,,,2,AT Rayudu,KD Karthik,60,35,2,4,1,18,17,1,0,39,18,1,4
6480bb9fc3369c6f5a549d05,2013,,,2,MEK Hussey,SK Raina,60,50,7,1,1,26,18,2,1,30,32,5,0
6480bb988545a7776b8c9306,2022,,,2,SS Prabhudessai,Shahbaz Ahmed,60,33,8,1,1,34,18,5,1,24,15,3,0
6480bb99f2a793884331579e,2023,,,2,SA Yadav,Tilak Varma,60,38,5,4,1,30,13,2,3,30,25,3,1
6480bb9561509a2f4f139254,2019,,,2,AM Rahane,JC Buttler,60,38,9,2,1,37,21,6,1,22,17,3,1
6480bb99fa79383bdc7df827,2022,,,1,JM Bairstow,S Dhawan,60,30,4,5,1,37,15,2,4,21,15,2,1
6480bb995193664eda3e9e10,2022,,,1,AM Rahane,VR Iyer,60,34,4,4,1,9,10,1,0,43,24,3,4
6480bb9435048f20502ba1e1,2018,,,1,BB McCullum,V Kohli,60,36,5,3,1,31,17,3,2,28,19,2,1
6480bb987b6845947f7ca137,2022,,,2,N Rana,SS Iyer,60,43,5,2,1,31,22,3,1,24,21,2,1
6480bba17bce347084729c56,2015,,,2,M Vijay,V Sehwag,60,40,10,1,1,22,21,4,0,36,19,6,1
6480bb96e18d7a1b3e62552d,2019,,,2,KL Rahul,MA Agarwal,60,40,4,2,1,30,22,2,1,27,18,2,1
6480bb97af44a48533f08540,2020/21,,,2,BA Stokes,RV Uthappa,60,33,6,4,1,50,26,6,3,9,7,0,1
6480bba1f2392e6761d39d66,2014,,,1,DR Smith,F du Plessis,60,38,9,1,1,24,20,4,0,34,18,5,1
6480bb9e88141830a7a309b5,2011,,,2,RN ten Doeschate,YK Pathan,60,45,6,2,1,37,29,3,2,23,16,3,0
6480bb9871b0ff7264721cbc,2022,,,2,AK Markram,N Pooran,60,35,5,4,1,40,18,4,3,19,17,1,1
6480bb9d6919e7181371271f,2011,,,1,JD Ryder,M Manhas,60,46,9,1,1,23,14,4,0,35,32,5,1
6480bb9dbefe5e2cceb23e01,2011,,,2,MEK Hussey,S Badrinath,60,39,7,1,1,24,17,3,0,36,22,4,1
6480bb97a42828c5a5ebef1c,2020/21,,,1,HH Pandya,Ishan Kishan,60,23,1,7,0,37,14,0,5,22,9,1,2
6480bb9d05f8e769574069fa,2009/10,,,1,LRPL Taylor,RV Uthappa,60,23,5,5,0,14,6,1,1,45,17,4,4
6480bb9ed74d222a3da56dfa,2012,,,2,G Gambhir,JH Kallis,60,38,9,2,1,35,15,6,1,22,23,3,1
6480bba3d3dc891a3092643e,2016,,,2,HM Amla,M Vijay,60,45,7,2,1,30,27,4,1,26,18,3,1
6480bb98cce4ab46512c2c03,2022,,,1,AT Rayudu,S Dube,60,37,4,3,1,27,20,2,2,25,17,2,1
6480bb9c454e9eefca545bde,2009/10,,,2,AC Voges,FY Fazal,60,37,7,1,1,34,20,3,1,24,17,4,0
6480bb9cd6fe6fad0d6efbd9,2009/10,,,1,AA Jhunjhunwala,P Dogra,60,49,2,3,1,29,23,1,1,29,26,1,2
6480bb9a1a3ab2ab8297871d,2007/08,,,2,GC Smith,M Kaif,60,31,4,4,1,25,15,2,1,34,16,2,3
6480bba1d21281c7385d5ce4,2014,,,2,Mandeep Singh,V Sehwag,60,36,7,0,1,21,15,2,0,28,21,5,0
6480bb94dcc956fa4ca06b92,2018,,,2,CA Lynn,SP Narine,59,43,7,2,1,29,24,4,1,27,19,3,1
6480bb996c5ae75a32d978e8,2022,,,2,Shubman Gill,WP Saha,59,43,10,1,1,18,17,3,0,40,26,7,1
6480bb9a6ecee5429e0468be,2023,,,1,A Badoni,N Pooran,59,48,1,2,1,38,26,1,2,15,22,0,0
6480bb9f8d3b0a3d1e28a4b7,2013,,,1,G Gambhir,MS Bisla,59,46,9,0,1,28,22,4,0,28,24,5,0
6480bb9f4780a208e13bfb3d,2013,,,1,CH Gayle,SS Tiwary,59,53,3,2,0,26,24,1,1,25,29,2,1
6480bb9d9f4551d7ec79c951,2009/10,,,2,MS Dhoni,S Badrinath,59,42,7,1,1,22,18,2,0,32,24,5,1
6480bba210201df0f7975000,2016,,,2,AB de Villiers,V Kohli,59,39,5,1,1,28,18,3,1,25,21,2,0
6480bb94adb227976b33d30b,2018,,,1,C Munro,PP Shaw,59,42,8,2,1,33,18,4,2,26,24,4,0
6480bb9800ba03eb1f9437d2,2022,,,2,R Tewatia,Rashid Khan,59,24,2,6,0,27,13,2,2,31,11,0,4
6480bba0b2a9d600114a43d7,2013,,,1,MK Pandey,Yuvraj Singh,59,50,2,3,1,26,24,1,1,32,26,1,2
6480bb9fe3bc767415c60bfa,2012,,,1,DPMD Jayawardene,NV Ojha,59,49,8,1,1,26,21,4,0,28,28,4,1
6480bb9936b7698da2c2030c,2023,,,2,MS Dhoni,RA Jadeja,59,30,2,5,0,32,17,1,3,23,13,1,2
6480bb9718a9b89de407178b,2021,,,2,PP Shaw,S Dhawan,59,33,8,2,1,32,17,3,2,26,16,5,0
6480bba2c5a614e0fd10cd19,2016,,,1,AT Rayudu,RG Sharma,59,34,8,2,1,32,20,5,1,25,14,3,1
6480bb9fd9db46138a9bb209,2013,,,1,MS Dhoni,RA Jadeja,59,36,3,2,1,30,20,1,2,26,16,2,0
6480bb94ebff9a116f68560b,2018,,,2,KS Williamson,Shakib Al Hasan,59,43,4,2,1,32,22,2,1,27,21,2,1
6480bb94aad1a08ca4276b4e,2018,,,2,AB de Villiers,Mandeep Singh,59,40,2,3,1,38,23,1,3,19,17,1,0
6480bba3ebbd8e4867dfa673,2016,,,2,AM Rahane,UT Khawaja,59,50,6,1,1,29,23,4,0,30,27,2,1
6480bba3b818a7cff6fe4f89,2016,,,1,DA Warner,MC Henriques,59,46,4,2,1,26,25,3,0,31,21,1,2
6480bb993e61058e682e2ff4,2023,,,1,HH Pandya,Shubman Gill,59,33,6,2,1,28,19,3,1,30,14,3,1
6480bb9b2ca4a7b325526f1f,2009,,,1,RG Sharma,TL Suman,59,42,3,3,1,32,23,2,2,24,19,1,1
6480bb9ccfdcb55be258ec95,2009,,,1,GJ Bailey,PA Patel,59,37,8,0,1,21,18,4,0,25,19,4,0
6480bb9929c7e430acd1ef18,2022,,,1,DP Conway,S Dube,59,33,3,3,1,23,15,1,1,32,18,2,2
6480bb9ec90f99c5ea40b014,2012,,,2,OA Shah,SP Goswami,59,50,4,1,1,30,29,3,0,23,21,1,1
6480bba328f7475f4b87d3ff,2016,,,1,AJ Finch,SK Raina,59,36,3,3,1,26,23,1,2,23,13,2,1
6480bb9d1ed71a4f47892d00,2009/10,,,2,NV Ojha,SR Watson,59,45,9,1,1,14,19,2,0,44,26,7,1
6480bb9a807eb5f39489408a,2023,,,2,MK Pandey,RR Rossouw,59,59,3,3,1,26,27,1,2,33,32,2,1
6480bb94283e3f5a1a95839f,2018,,,2,E Lewis,RG Sharma,59,38,2,4,1,28,18,1,2,28,20,1,2
6480bb94dfad571ef76493a9,2017,,,2,HH Pandya,KA Pollard,59,27,4,3,0,29,14,1,3,22,13,3,0
6480bb9575ad32214d0f6ec0,2019,,,2,RA Tripathi,SV Samson,59,45,5,0,1,31,24,3,0,27,21,2,0
6480bba11a59d64bb4aa66f4,2014,,,1,SE Marsh,WP Saha,59,40,7,1,1,31,24,3,1,25,16,4,0
6480bb9a325c576efe386437,2023,,,2,MR Marsh,PD Salt,59,32,7,2,1,26,17,3,1,29,15,4,1
6480bb9692a7f0d52bd43127,2019,,,2,KL Rahul,MA Agarwal,59,35,8,2,1,23,14,3,1,35,21,5,1
6480bb993e61058e682e2ff4,2023,,,2,SO Hetmyer,SV Samson,59,27,2,6,1,20,14,1,1,39,13,1,5
6480bb94bf9a1728b1b12f4d,2018,,,2,AM Rahane,SV Samson,59,44,5,1,1,18,14,2,0,40,30,3,1
6480bb9e5ab10d1241d6509d,2012,,,1,AB de Villiers,SS Tiwary,59,26,3,5,0,33,14,2,3,26,12,1,2
6480bba2c3207713bd927ce5,2015,,,2,AR Patel,DA Miller,59,29,3,4,1,15,11,2,0,40,18,1,4
6480bb9525c593ee45bb038c,2019,,,1,Q de Kock,Yuvraj Singh,58,40,6,2,1,41,25,4,2,15,15,2,0
6480bba0f1ebf9ff255e1c91,2013,,,2,A Mishra,DJG Sammy,58,48,5,1,1,21,28,2,0,29,20,3,1
6480bb9d40fc01528c7b7270,2009/10,,,1,AC Voges,AS Raut,58,41,6,1,0,26,21,3,0,32,20,3,1
6480bba192383a244f185c5a,2014,,,1,JP Duminy,KM Jadhav,58,34,7,2,0,27,16,5,0,29,18,2,2
6480bb9a9801c2dda3fe88e9,2007/08,,,1,DPMD Jayawardene,SM Katich,58,35,10,0,1,15,14,2,0,40,21,8,0
6480bb9ce544a2fc17a48bee,2009,,,1,JD Ryder,JH Kallis,58,51,7,1,1,21,17,3,0,32,34,4,1
6480bb98960cf9374ee9420d,2022,,,1,KL Rahul,MK Pandey,58,47,3,2,1,35,25,3,1,22,22,0,1
6480bb99773871f8e2ddc4b1,2022,,,1,R Shepherd,Washington Sundar,58,29,5,3,1,26,14,2,2,24,15,3,1
6480bb984a8abbb79a69e6ce,2022,,,1,JC Buttler,YBK Jaiswal,58,41,5,4,1,33,25,3,3,20,16,2,1
6480bba15f6842352b6338ae,2014,,,1,MK Pandey,Shakib Al Hasan,58,38,6,2,0,12,17,0,0,46,21,6,2
6480bba38ce35716815a1845,2016,,,1,AD Russell,Shakib Al Hasan,58,28,3,4,0,37,17,2,3,18,11,1,1
6480bb9fd26b695cee9d8761,2013,,,1,AJ Finch,RV Uthappa,58,30,5,4,1,23,14,2,2,32,16,3,2
6480bb9ded279701c84af803,2011,,,1,MS Dhoni,SK Raina,58,33,4,3,1,20,18,1,1,35,15,3,2
6480bba38060854b4fab1831,2016,,,2,AT Rayudu,RG Sharma,58,51,5,1,1,31,32,2,1,24,19,3,0
6480bb98825d8ceb716e3f3c,2022,,,2,Abhishek Sharma,KS Williamson,58,36,6,2,1,39,24,5,1,18,12,1,1
6480bb933fdc96ee7273400e,2017,,,1,AM Rahane,SPD Smith,58,42,4,2,1,33,20,2,2,25,22,2,0
6480bb9ab83a3072124dda22,2023,,,1,Abdul Samad,H Klaasen,58,40,2,5,1,30,20,1,3,27,20,1,2
6480bb9b1087ddfd207caa83,2009,,,1,G Gambhir,V Sehwag,58,29,6,3,0,15,13,2,0,38,16,4,3
6480bb94aad1a08ca4276b4e,2018,,,1,KK Nair,KL Rahul,58,43,4,2,1,26,21,3,0,31,22,1,2
6480bba0587190387a754733,2013,,,1,BJ Rohrer,UBT Chand,58,44,6,0,1,32,27,4,0,18,17,2,0
6480bb9e5ad1f3182858e7c9,2012,,,2,DJ Hussey,SE Marsh,58,38,5,1,1,21,19,2,0,36,19,3,1
6480bb949a2d28d1ad7d367f,2018,,,2,KL Rahul,MA Agarwal,58,20,6,5,1,51,15,6,4,7,5,0,1
6480bb96ed06a5693a66b9f0,2020/21,,,1,JC Buttler,SPD Smith,58,46,3,2,1,24,25,1,1,32,21,2,1
6480bba0b5eabeb0a150b93f,2013,,,2,MR Marsh,SPD Smith,58,47,6,1,1,15,16,0,1,41,31,6,0
6480bb963c729ccbcb9446f8,2020/21,,,1,EJG Morgan,KD Karthik,58,30,4,3,1,28,16,2,1,29,14,2,2
6480bba3d3dc891a3092643e,2016,,,1,MS Dhoni,NLTC Perera,58,29,4,3,1,32,15,2,2,23,14,2,1
6480bb93ec7e3351941d3b5b,2017,,,1,MC Henriques,Yuvraj Singh,58,29,5,3,1,17,12,1,1,40,17,4,2
6480bba373508e4f3f4be6c0,2016,,,1,MK Pandey,YK Pathan,58,27,5,3,0,12,9,1,0,37,18,4,3
6480bb949f5853dfe76c99d9,2017,,,1,MK Tiwary,MS Dhoni,58,23,7,2,0,17,8,3,0,40,15,4,2
6480bb9b2abb1e5479b853f5,2009,,,2,BB McCullum,MN van Wyk,58,42,4,3,1,35,29,1,3,20,13,3,0
6480bb963c729ccbcb9446f8,2020/21,,,2,JM Bairstow,KS Williamson,58,37,10,1,1,28,18,6,0,29,19,4,1
6480bba38056992b92414bab,2016,,,2,NV Ojha,S Dhawan,58,49,5,2,1,15,24,1,0,41,25,4,2
6480bba1017a98eead1ec861,2015,,,2,DA Miller,SE Marsh,58,35,1,4,1,26,19,1,1,31,16,0,3
6480bba3d3dc891a3092643e,2016,,,2,Gurkeerat Singh,M Vijay,58,43,3,2,1,27,22,2,0,31,21,1,2
6480bba0d4b2f9be71a5f230,2014,,,2,JP Duminy,KD Karthik,58,45,4,1,1,24,22,2,0,31,23,2,1
6480bb97ea8bfb43e3f7515f,2020/21,,,1,RR Pant,SS Iyer,58,40,5,0,1,30,18,4,0,26,22,1,0
6480bb9927b39ebcfd7820b0,2022,,,2,RK Singh,SP Narine,58,19,1,7,1,34,12,1,4,21,7,0,3
6480bba10e78f50f124b406a,2015,,,2,DR Smith,SK Raina,58,42,6,4,1,35,24,3,3,21,18,3,1
6480bba154ce29a67e4752df,2015,,,1,D Wiese,Iqbal Abdulla,58,30,8,2,1,34,15,4,2,20,15,4,0
6480bb9f1faffe780b407e67,2013,,,2,M Vohra,Mandeep Singh,58,44,8,0,1,32,22,5,0,26,22,3,0
6480bb931b06a170006b4713,2017,,,2,RA Jadeja,SK Raina,58,31,4,4,1,15,12,0,1,42,19,4,3
6480bb9dfb2e8e8c2002df86,2011,,,2,J Botha,LRPL Taylor,58,37,5,3,0,35,23,4,1,21,14,1,2
6480bb9db38208342bc57b96,2011,,,1,G Gambhir,JH Kallis,58,52,5,0,1,34,28,4,0,21,24,1,0
6480bb9cb881721acc1bab60,2009,,,2,BJ Hodge,SC Ganguly,58,62,4,0,1,29,30,2,0,28,32,2,0
6480bb964a4d5a1709db428e,2020/21,,,1,KH Pandya,Q de Kock,58,52,5,2,1,34,30,4,1,19,22,1,1
6480bb9341152e168005ccc9,2017,,,2,MS Dhoni,SPD Smith,58,46,6,1,1,28,25,3,1,25,21,3,0
6480bb96e29253678ca02869,2020/21,,,1,KL Rahul,N Pooran,58,31,4,4,1,25,14,3,1,33,17,1,3
6480bb97cca23939859c422e,2021,,,1,RR Pant,SPD Smith,58,42,6,1,1,36,23,4,1,21,19,2,0
6480bb9ab83a3072124dda22,2023,,,2,N Pooran,PN Mankad,58,23,4,5,0,44,13,3,4,14,10,1,1
6480bba3e9fa951efcfc8bfb,2016,,,1,MP Stoinis,WP Saha,58,41,3,2,1,34,23,1,2,24,18,2,0
6480bb9ee0795047740de5a7,2011,,,2,M Vijay,SK Raina,58,32,6,2,1,25,14,1,2,30,18,5,0
6480bb972a7d4e1071ea662e,2021,,,1,RG Sharma,SA Yadav,58,29,6,3,1,30,14,2,3,24,15,4,0
6480bb9ff2e0b1df0c3972c9,2012,,,1,DPMD Jayawardene,NV Ojha,58,50,6,2,1,23,21,3,0,34,29,3,2
6480bb9c442caaabe9eb2275,2009,,,2,AM Nayar,DJ Bravo,57,51,3,2,1,16,21,1,0,35,30,2,2
6480bb974e2f8e7f41c506dc,2021,,,1,S Dube,SV Samson,57,47,4,1,1,28,27,2,1,26,20,2,0
6480bba0d4b2f9be71a5f230,2014,,,1,RV Uthappa,Shakib Al Hasan,57,36,6,2,1,40,22,6,1,17,14,0,1
6480bb9a17692bfb5bd3894c,2007/08,,,1,MS Dhoni,S Vidyut,57,40,5,2,1,28,21,2,1,29,19,3,1
6480bba1603d86b7d278a366,2015,,,2,DJ Bravo,RA Jadeja,57,58,5,1,1,28,29,4,0,24,29,1,1
6480bb9d872bbb611f6266cb,2011,,,1,KD Karthik,PC Valthaty,57,30,8,1,0,21,11,2,1,36,19,6,0
6480bba0ffae8617ee64bd19,2013,,,1,MS Dhoni,RA Jadeja,57,38,3,2,1,31,21,1,2,24,17,2,0
6480bb97951f1bc43b462c46,2021,,,1,MM Ali,RD Gaikwad,57,36,3,3,1,21,17,1,1,34,19,2,2
6480bb9f895e5780080c8059,2012,,,1,Azhar Mahmood,SD Chitnis,57,50,7,1,1,18,24,2,0,37,26,5,1
6480bb9623a26d3fbfe59f25,2020/21,,,1,KL Rahul,MA Agarwal,57,42,9,0,1,29,22,5,0,26,20,4,0
6480bb95385ebb9bda58a643,2019,,,1,Q de Kock,RG Sharma,57,38,4,3,1,25,16,1,2,30,22,3,1
6480bba0587190387a754733,2013,,,2,MC Henriques,V Kohli,57,50,5,0,1,26,22,3,0,28,28,2,0
6480bb948a69b3d86293b12b,2017,,,2,KK Nair,SS Iyer,57,34,10,1,1,29,13,5,1,28,21,5,0
6480bb9623a26d3fbfe59f25,2020/21,,,1,KL Rahul,N Pooran,57,38,5,1,1,32,20,4,1,17,18,1,0
6480bb9b9dd7fe8c5cbdbab0,2009,,,1,ML Hayden,PA Patel,57,32,6,1,1,35,17,4,1,16,15,2,0
6480bba0cdc200ad3ab8fbf5,2014,,,1,BB McCullum,DR Smith,57,38,5,4,1,26,16,5,0,29,22,0,4
6480bb9e4bb50b724830b249,2011,,,2,Harbhajan Singh,SR Tendulkar,57,42,8,0,1,30,29,5,0,19,13,3,0
6480bb9429a15517bb46f3be,2018,,,1,Ishan Kishan,RG Sharma,57,32,7,2,1,43,21,5,2,13,11,2,0
6480bb978c66ea3d9c85132d,2020/21,,,2,Abdul Samad,KS Williamson,57,31,6,2,1,25,12,2,1,32,19,4,1
6480bb9b0b09749af4aa32dd,2009,,,2,BB McCullum,CH Gayle,57,33,3,5,1,21,16,1,2,32,17,2,3
6480bb98960cf9374ee9420d,2022,,,2,KA Pollard,Tilak Varma,57,39,2,3,1,17,17,0,1,34,22,2,2
6480bb95f2e3c32afe233820,2018,,,2,C de Grandhomme,Mandeep Singh,57,50,2,2,1,33,29,1,2,21,21,1,0
6480bb96c10dfe3d8c259db3,2020/21,,,1,D Padikkal,V Kohli,57,50,5,1,1,28,26,3,0,29,24,2,1
6480bba1af51ddc81185931d,2014,,,2,DR Smith,F du Plessis,57,26,6,3,1,34,17,4,1,22,9,2,2
6480bba0eb5a345386bdc825,2013,,,2,BJ Hodge,DH Yagnik,57,28,7,0,0,14,11,2,0,31,17,5,0
6480bb9cd6fe6fad0d6efbd9,2009/10,,,2,AB de Villiers,V Sehwag,57,38,3,4,1,10,17,0,0,45,21,3,4
6480bb985efffbcafdef9f19,2021,,,2,AK Markram,N Pooran,57,39,3,3,1,24,17,2,1,32,22,1,2
6480bb996c5ae75a32d978e8,2022,,,1,MM Ali,RD Gaikwad,57,39,3,3,1,21,17,0,2,33,22,3,1
6480bb970c637fd0c057dca9,2021,,,2,JM Bairstow,MK Pandey,57,37,6,3,1,24,17,3,1,31,20,3,2
6480bba119569fcc2d7859a4,2014,,,2,V Kohli,Yuvraj Singh,57,43,5,3,1,35,18,3,2,21,25,2,1
6480bb98af25209ef756aa2c,2021,,,2,Q de Kock,RG Sharma,57,41,9,0,1,24,23,4,0,30,18,5,0
6480bba2db1e2def1b597ed3,2015,,,2,AR Patel,DA Miller,57,50,3,2,1,22,26,0,1,29,24,3,1
6480bb9db0ecec8acdd30619,2011,,,1,CH Gayle,TM Dilshan,57,40,5,4,1,42,21,3,4,15,19,2,0
6480bb9a21e416835389fd53,2023,,,2,LS Livingstone,SM Curran,57,33,2,3,1,31,18,1,3,19,15,1,0
6480bba29fb420d92aef1d2a,2015,,,1,G Gambhir,RV Uthappa,57,38,8,0,1,31,23,5,0,21,15,3,0
6480bb9e4bb50b724830b249,2011,,,1,JH Kallis,YK Pathan,57,43,6,1,1,21,16,2,0,36,27,4,1
6480bb95ff5da0069bc5274e,2018,,,2,CH Gayle,KL Rahul,57,34,4,4,1,21,17,2,1,35,17,2,3
6480bb9797043717cd96890a,2021,,,2,JJ Roy,WP Saha,57,31,7,1,1,30,20,5,0,18,11,2,1
6480bb94834e2b780c4782b5,2017,,,2,RG Sharma,SS Tiwary,57,36,7,1,1,27,21,4,1,19,15,3,0
6480bb94988cb8c136ec7e46,2018,,,2,AT Rayudu,MS Dhoni,57,42,4,1,1,30,22,2,1,23,20,2,0
6480bb9836d24b9817a35f7d,2022,,,2,HH Pandya,MS Wade,57,48,8,1,1,33,28,5,1,22,20,3,0
6480bb9a7d91d721555835e5,2007/08,,,1,RA Jadeja,YK Pathan,57,34,4,2,1,33,19,3,1,20,15,1,1
6480bba08cc4182f0127f2e2,2013,,,1,Harbhajan Singh,RG Sharma,57,29,5,3,0,25,11,2,2,31,18,3,1
6480bb9797043717cd96890a,2021,,,2,JJ Roy,KS Williamson,57,41,4,2,1,30,22,3,1,25,19,1,1
6480bb937dc0a09df8f7aeee,2017,,,2,DA Miller,WP Saha,57,34,4,4,1,28,18,2,2,25,16,2,2
6480bb964a4d5a1709db428e,2020/21,,,1,KA Pollard,NM Coulter-Nile,57,21,5,4,0,33,9,1,4,24,12,4,0
6480bba1c67d2c9c1279a4c8,2014,,,1,AB de Villiers,MA Starc,57,28,4,5,1,51,20,4,5,5,8,0,0
6480bb9f3ca20834ecc7607a,2012,,,1,JH Kallis,MK Tiwary,57,50,7,1,1,28,25,3,1,27,25,4,0
6480bb9f8d3b0a3d1e28a4b7,2013,,,2,CL White,PA Patel,57,54,3,2,1,24,23,1,1,27,31,2,1
6480bb9c12f907c7b81b11a9,2009,,,1,AB Agarkar,LR Shukla,57,48,2,2,0,13,17,0,0,40,31,2,2
6480bb96fed7a7ee65076e4a,2020/21,,,1,BA Stokes,SV Samson,56,49,3,1,1,19,23,0,0,36,26,3,1
6480bb9a6935abf34d88ca97,2007/08,,,1,JR Hopes,K Goel,56,35,7,2,1,31,16,5,1,24,19,2,1
6480bb9b0e32875998e9bfdc,2009,,,1,AB de Villiers,DL Vettori,56,49,4,1,1,37,28,3,1,17,21,1,0
6480bba063bacaa2dfabf6fd,2014,,,1,AJ Finch,S Dhawan,56,38,8,1,1,19,16,3,0,33,22,5,1
6480bb966c197bad273f91f1,2020/21,,,2,JC Buttler,TK Curran,56,32,1,5,1,46,20,1,5,9,12,0,0
6480bb9d9f4551d7ec79c951,2009/10,,,1,KC Sangakkara,SE Marsh,56,47,8,0,1,33,24,5,0,23,23,3,0
6480bb98c0ad46409044aad2,2022,,,2,Abhishek Sharma,RA Tripathi,56,31,5,3,1,19,17,1,1,35,14,4,2
6480bb9b09e6c98206422ae5,2009,,,2,GC Smith,YK Pathan,56,35,7,2,1,13,16,1,0,41,19,6,2
6480bb95f45dffe4751efc46,2019,,,1,F du Plessis,SR Watson,56,44,5,3,1,29,20,2,2,26,24,3,1
6480bb9b0b09749af4aa32dd,2009,,,1,KC Sangakkara,Yuvraj Singh,56,45,3,1,1,25,23,2,0,24,22,1,1
6480bba2b99fcf06aaeac805,2015,,,2,SPD Smith,SV Samson,56,41,4,1,1,23,20,2,0,31,21,2,1
6480bb98cce4ab46512c2c03,2022,,,1,MM Ali,RV Uthappa,56,30,8,2,1,27,14,3,2,29,16,5,0
6480bb9574ca455ec008e942,2018,,,1,S Dhawan,WP Saha,56,43,6,1,1,34,24,4,1,20,19,2,0
6480bb94cf431881ac3e9cbf,2018,,,2,AB de Villiers,CJ Anderson,56,29,2,5,1,40,16,2,4,15,13,0,1
6480bb9c4934a2adde9d76ce,2009/10,,,1,SR Tendulkar,SS Tiwary,56,43,6,1,1,25,19,3,0,30,24,3,1
6480bb994aafcf67cd092a7d,2023,,,2,B Sai Sudharsan,DA Miller,56,29,3,3,0,22,13,1,1,31,16,2,2
6480bb9ddfb0f2f6f8e813e5,2011,,,2,V Sehwag,Y Nagar,56,50,2,3,1,30,20,1,3,22,30,1,0
6480bb97ce981c1918dce924,2021,,,2,MK Pandey,PK Garg,56,36,4,2,1,26,15,2,1,29,21,2,1
6480bb967d799ced7fe5d8e9,2020/21,,,2,DA Warner,JM Bairstow,56,38,7,2,1,35,20,3,2,19,18,4,0
6480bb9fa3a890f94f179477,2013,,,1,DJ Hussey,Gurkeerat Singh,56,43,4,1,1,26,21,2,1,25,22,2,0
6480bb9fc524f8142f0b3461,2012,,,2,AL Menaria,SR Watson,56,46,4,2,1,18,21,1,0,38,25,3,2
6480bb932f8447acd7840076,2017,,,2,DR Smith,KD Karthik,56,46,5,1,1,37,27,4,1,19,19,1,0
6480bba0c63a6317296391b7,2013,,,2,BJ Hodge,STR Binny,56,38,8,0,1,39,27,7,0,11,11,1,0
6480bba0a222eb875a07f5a3,2014,,,2,PA Patel,V Kohli,56,42,7,1,1,35,23,5,1,19,19,2,0
6480bba2aecb4103bab63c15,2016,,,1,AM Rahane,SPD Smith,56,50,4,0,1,25,22,2,0,31,28,2,0
6480bb9c3b082d71291a593c,2009,,,1,LRPL Taylor,V Kohli,56,58,4,2,1,18,23,0,0,38,35,4,2
6480bb9ce7891d47a7fe9c12,2009/10,,,2,DPMD Jayawardene,Yuvraj Singh,56,32,5,3,1,26,16,4,0,28,16,1,3
6480bba0a9f68a29bda72302,2013,,,2,AJ Finch,MK Pandey,56,43,0,4,1,32,19,0,3,24,24,0,1
6480bb9797043717cd96890a,2021,,,1,SV Samson,YBK Jaiswal,56,45,7,1,1,25,25,3,0,31,20,4,1
6480bba18a2fe828fa106f6c,2014,,,2,KA Pollard,RG Sharma,56,30,3,5,1,13,11,0,1,40,19,3,4
6480bb9435048f20502ba1e1,2018,,,2,HH Pandya,KH Pandya,56,39,4,1,1,24,20,3,0,23,19,1,1
6480bb99af95c6c90c4c3924,2023,,,1,C Green,Tilak Varma,56,28,5,4,1,18,11,3,0,37,17,2,4
6480bb958f77e7d3929d28e3,2018,,,2,DL Chahar,SK Raina,56,36,1,3,1,39,20,1,3,15,16,0,0
6480bb95d4da0397e79acffa,2019,,,2,DA Miller,Mandeep Singh,56,28,6,2,0,22,13,2,1,33,15,4,1
6480bb94f46306dbde97aa5c,2017,,,2,IR Jaggi,SA Yadav,56,47,5,1,1,27,26,3,0,27,21,2,1
6480bb9e83b8575f74b8e962,2012,,,1,F du Plessis,M Vijay,56,41,6,2,1,44,26,5,2,11,15,1,0
6480bba000b91f6c5cf57fdb,2013,,,1,BB Samantray,DJG Sammy,56,35,3,2,1,25,16,2,1,23,19,1,1
6480bb9541caaeddc9ddaac3,2019,,,1,DJ Bravo,MS Dhoni,56,30,5,2,1,27,16,3,1,26,14,2,1
6480bb9fd9db46138a9bb209,2013,,,1,S Badrinath,SK Raina,56,40,8,0,1,25,21,3,0,29,19,5,0
6480bb93ec7e3351941d3b5b,2017,,,2,KM Jadhav,TM Head,56,32,6,1,1,31,16,4,1,22,16,2,0
6480bb9fe3bc767415c60bfa,2012,,,2,LR Shukla,YK Pathan,56,24,6,3,0,24,11,3,1,31,13,3,2
6480bb954714437843ab3647,2019,,,1,RR Pant,SS Iyer,56,47,6,0,1,23,18,3,0,29,29,3,0
6480bb947b065b9dc0256f0d,2018,,,2,Mandeep Singh,Washington Sundar,56,28,4,3,1,18,9,3,0,35,19,1,3
6480bb95e25835586d412978,2018,,,2,KH Pandya,RG Sharma,56,21,5,4,0,31,12,4,2,20,9,1,2
6480bb9c7bc1dc527c14f1ac,2009/10,,,1,CH Gayle,SC Ganguly,56,45,8,1,1,17,14,3,0,36,31,5,1
6480bb952f20835ddd6e533f,2019,,,1,CH Gayle,MA Agarwal,56,49,3,3,1,27,25,2,1,22,24,1,2
6480bb96ee2a21f0d9b9f37f,2020/21,,,1,PP Shaw,S Dhawan,56,35,5,3,1,30,19,3,1,26,16,2,2
6480bb961ee814aee7b674ac,2020/21,,,2,CJ Jordan,MA Agarwal,56,26,5,3,1,5,5,0,0,51,21,5,3
6480bb96ec7d98e34055e8fc,2020/21,,,2,M Vijay,SR Watson,56,40,4,4,1,21,19,3,0,33,21,1,4
6480bb9d3ab782f83ce3e381,2011,,,1,DB Ravi Teja,S Dhawan,56,38,4,1,1,30,22,3,0,24,16,1,1
6480bba2256bfaaf14c57ead,2015,,,2,MK Pandey,YK Pathan,56,32,6,1,1,18,14,3,0,26,18,3,1
6480bb98323919fff9902666,2022,,,2,D Padikkal,YBK Jaiswal,56,37,7,0,1,16,17,1,0,36,20,6,0
6480bb97a4220e27710e38de,2021,,,1,AB de Villiers,KA Jamieson,56,18,6,4,0,43,14,5,3,11,4,1,1
6480bba2d324f0342e6af689,2016,,,1,BB McCullum,SK Raina,56,40,6,1,1,18,17,1,1,37,23,5,0
6480bb9ccfdcb55be258ec95,2009,,,2,BJ Hodge,WP Saha,56,28,4,3,0,31,15,2,2,25,13,2,1
6480bb9e1a26096ce68e9ca3,2012,,,1,AM Rahane,R Dravid,56,44,6,0,1,13,18,1,0,39,26,5,0
6480bba1e64915b9e7c849ca,2014,,,1,JP Duminy,KD Karthik,56,38,5,2,1,17,21,1,0,38,17,4,2
6480bb9c8f3ef1685cdf4017,2009,,,1,AB de Villiers,KD Karthik,56,49,5,0,0,35,27,5,0,17,22,0,0
6480bba2c3207713bd927ce5,2015,,,1,DA Warner,S Dhawan,56,37,7,2,1,30,19,3,2,24,18,4,0
6480bb9927b39ebcfd7820b0,2022,,,2,N Rana,SS Iyer,56,27,10,1,1,37,18,8,0,17,9,2,1
6480bb9827e9fb920cf62809,2021,,,2,N Rana,Shubman Gill,55,59,8,0,1,19,28,2,0,34,31,6,0
6480bb95481ab7c06b86419b,2018,,,1,HV Patel,RR Pant,55,38,5,2,1,24,17,0,2,30,21,5,0
6480bb98291bb8b3f3e8145d,2022,,,1,DA Warner,RR Pant,55,27,3,3,1,19,13,1,1,27,14,2,2
6480bb9f0f959bc6104820c3,2013,,,2,R Dravid,STR Binny,55,28,2,4,1,13,8,0,1,40,20,2,3
6480bb9e5ab10d1241d6509d,2012,,,1,CH Gayle,SS Tiwary,55,24,1,6,1,44,13,1,6,10,11,0,0
6480bb95c28e7980e1768064,2018,,,1,MS Dhoni,SW Billings,55,40,4,1,1,25,18,1,1,27,22,3,0
6480bba33dab752d79e587d2,2016,,,2,KK Nair,Q de Kock,55,37,6,2,1,20,17,3,0,34,20,3,2
6480bb9813fa79617f791851,2022,,,2,Anuj Rawat,F du Plessis,55,42,9,0,1,24,22,4,0,29,20,5,0
6480bb94738952e740c68749,2018,,,2,CH Gayle,KL Rahul,55,47,5,3,1,23,21,1,2,32,26,4,1
6480bb99f649ea7a6d79892f,2023,,,1,Mohit Rathee,S Dhawan,55,30,4,5,0,1,2,0,0,52,28,4,5
6480bba0bc196f7168b3d989,2013,,,1,MEK Hussey,SK Raina,55,44,5,1,1,26,24,2,0,27,20,3,1
6480bba0ca27548122e36880,2013,,,1,MEK Hussey,SK Raina,55,34,5,2,1,32,21,3,1,23,13,2,1
6480bb931b06a170006b4713,2017,,,1,MK Pandey,RV Uthappa,55,41,5,1,1,19,17,1,0,35,24,4,1
6480bba2256bfaaf14c57ead,2015,,,2,AD Russell,YK Pathan,55,31,6,2,1,37,20,4,2,15,11,2,0
6480bb9c2778066dafd78a71,2009/10,,,2,AC Gilchrist,VVS Laxman,55,28,6,3,1,38,17,4,3,12,11,2,0
6480bba38060854b4fab1831,2016,,,2,JC Buttler,KA Pollard,55,22,3,4,0,29,11,1,3,21,11,2,1
6480bb9c1e676472f4841aa9,2009/10,,,2,GJ Bailey,ML Hayden,55,50,7,0,1,16,25,2,0,31,25,5,0
6480bb9d1f9a3cf1fa86e11c,2011,,,1,B Chipli,JP Duminy,55,28,5,3,1,33,13,3,2,22,15,2,1
6480bb9a325c576efe386437,2023,,,1,MK Lomror,V Kohli,55,32,3,3,1,34,17,2,3,19,15,1,0
6480bba26c6e47258e0c7d24,2015,,,2,Q de Kock,SS Iyer,55,38,7,1,1,33,20,6,0,20,18,1,1
6480bba29f384ce360fa8131,2016,,,2,F du Plessis,KP Pietersen,55,35,8,0,1,32,20,6,0,15,15,2,0
6480bb9b69f390d624466843,2007/08,,,2,PA Patel,SP Fleming,55,48,8,0,0,19,28,2,0,32,20,6,0
6480bb937dc0a09df8f7aeee,2017,,,1,G Gambhir,MK Pandey,55,39,5,1,0,28,23,3,0,25,16,2,1
6480bb945f95e767a8a9cc10,2017,,,2,BB McCullum,Ishan Kishan,55,36,6,3,1,23,12,3,1,31,24,3,2
6480bb9a6935abf34d88ca97,2007/08,,,1,JR Hopes,KC Sangakkara,55,27,6,2,1,40,17,5,2,12,10,1,0
6480bba1551dc12c8f2a7038,2014,,,1,JP Duminy,KM Jadhav,55,25,3,4,0,25,10,0,3,26,15,3,1
6480bb95085c25712f29bd36,2019,,,2,AT Rayudu,MS Dhoni,55,44,5,2,1,26,22,2,1,26,22,3,1
6480bb9f7ff1377c4d13a645,2013,,,1,KD Karthik,RG Sharma,55,41,5,1,1,40,25,4,1,15,16,1,0
6480bb949f5853dfe76c99d9,2017,,,2,DA Warner,S Dhawan,55,49,7,0,1,21,20,2,0,30,29,5,0
6480bb9940bd3bf36dd4897f,2023,,,2,KL Rahul,KR Mayers,55,39,8,1,1,31,20,6,0,24,19,2,1
6480bb9cf1471ad233c7b0af,2009,,,2,J Botha,RA Jadeja,55,36,5,0,1,26,18,2,0,24,18,3,0
6480bb9e05571c1a4c163ef1,2012,,,1,F du Plessis,S Badrinath,55,45,7,1,1,40,23,6,1,15,22,1,0
6480bba1105add9a994c58a7,2014,,,1,KD Karthik,LR Shukla,55,44,1,3,1,35,26,1,2,17,18,0,1
6480bba2fc84811f520b04cf,2016,,,1,MP Stoinis,WP Saha,55,45,4,0,1,33,21,4,0,19,24,0,0
6480bb9516b0dbc1972e5c3c,2018,,,1,KD Karthik,Shubman Gill,55,38,4,2,1,27,21,1,1,28,17,3,1
6480bb9b7b8617115de9683b,2007/08,,,2,MS Dhoni,SK Raina,55,41,4,2,1,37,25,4,1,14,16,0,1
6480bba26c6e47258e0c7d24,2015,,,2,JP Duminy,Q de Kock,55,30,3,4,1,17,11,0,1,36,19,3,3
6480bb963d224b9be17f2c75,2019,,,2,SPD Smith,SV Samson,55,33,6,0,1,22,16,3,0,32,17,3,0
6480bb99358a21ba3487db81,2023,,,2,KH Pandya,KL Rahul,55,38,5,1,1,34,23,4,1,16,15,1,0
6480bb945460b25d997060fb,2018,,,1,CA Lynn,RV Uthappa,55,30,6,3,1,20,11,4,0,35,19,2,3
6480bb99af95c6c90c4c3924,2023,,,2,H Klaasen,MA Agarwal,55,29,6,2,1,36,16,4,2,17,13,2,0
6480bba069d61566bb63ac2b,2014,,,1,V Kohli,Yuvraj Singh,55,46,5,1,1,31,21,4,0,23,25,1,1
6480bb984a8abbb79a69e6ce,2022,,,2,AK Markram,Washington Sundar,55,19,6,3,1,13,5,1,1,40,14,5,2
6480bb9c13817091131f76e3,2009/10,,,1,A Symonds,HH Gibbs,55,41,5,2,1,33,20,3,2,22,21,2,0
6480bb9f58a3e7ea877fc9dc,2012,,,2,Mandeep Singh,SE Marsh,55,41,6,1,1,30,21,3,1,22,20,3,0
6480bba03ef1ed797291b091,2013,,,2,CL White,GH Vihari,55,34,5,2,1,35,19,3,2,20,15,2,0
6480bb9e9f1ef9ac02266570,2011,,,2,JD Ryder,MK Pandey,55,41,8,2,1,35,20,5,2,19,21,3,0
6480bb9a596c087c0396ec2e,2007/08,,,2,JH Kallis,MV Boucher,55,31,4,3,1,16,13,0,1,38,18,4,2
6480bb957ae1619e0d648dec,2019,,,1,DA Warner,MK Pandey,55,35,5,1,1,36,20,3,1,19,15,2,0
6480bba15f6842352b6338ae,2014,,,2,BB McCullum,SK Raina,55,55,3,3,1,28,22,1,2,26,33,2,1
6480bba0eb5a345386bdc825,2013,,,1,DR Smith,KD Karthik,55,30,4,2,1,28,13,1,2,22,17,3,0
6480bb97af05ebd5c4f575c4,2021,,,1,Q de Kock,RG Sharma,55,40,5,2,1,17,15,3,0,32,25,2,2
6480bb97951f1bc43b462c46,2021,,,1,RA Jadeja,RD Gaikwad,55,22,5,3,0,32,15,4,1,20,7,1,2
6480bb946efcc4cd9aa80399,2018,,,2,KD Karthik,N Rana,55,42,4,1,1,27,23,3,0,22,19,1,1
6480bb9c121ee402b7b2eda6,2009,,,1,MK Pandey,RE van der Merwe,55,44,7,1,1,31,26,4,0,23,18,3,1
6480bb9908b154f78b12b8fb,2023,,,2,MK Lomror,V Kohli,55,34,2,3,1,34,18,1,3,20,16,1,0
6480bb95816d3ad3bc382ab6,2018,,,2,AB de Villiers,PA Patel,55,34,9,0,1,37,21,6,0,18,13,3,0
6480bb9a8053274c083224d9,2023,,,1,N Wadhera,SA Yadav,55,46,7,0,1,26,24,4,0,26,22,3,0
6480bb9c7bc1dc527c14f1ac,2009/10,,,2,DPMD Jayawardene,Yuvraj Singh,55,28,5,3,0,21,12,3,0,33,16,2,3
6480bba1af51ddc81185931d,2014,,,1,V Kohli,Yuvraj Singh,55,50,2,2,1,29,26,0,2,25,24,2,0
6480bb9448fe25ec89c5fcff,2017,,,1,HH Pandya,KA Pollard,55,21,0,7,1,30,13,0,4,23,8,0,3
6480bb9c8cbb5dec60b7d50a,2009/10,,,1,MJ Lumb,NV Ojha,55,39,8,1,1,37,22,7,0,14,17,1,1
6480bb99e909d98c8193bac5,2023,,,1,SV Samson,YBK Jaiswal,54,40,5,2,1,30,16,2,2,24,24,3,0
6480bb9af1b34d6aa89e434e,2023,,,1,PP Shaw,RR Rossouw,54,28,4,4,1,8,7,1,0,45,21,3,4
6480bb95f37ebb69ffb216e0,2019,,,2,PP Shaw,RR Pant,54,35,8,0,1,42,20,7,0,11,15,1,0
6480bb97c92184fed1a879f3,2021,,,2,D Padikkal,GJ Maxwell,54,44,3,2,1,13,19,0,0,40,25,3,2
6480bb9aa64355ce98da1141,2007/08,,,1,R Dravid,V Kohli,54,52,7,0,1,30,29,4,0,22,23,3,0
6480bb97f56e9d700b27a098,2021,,,1,AB de Villiers,RM Patidar,54,38,1,3,1,28,22,1,1,26,16,0,2
6480bb94f46306dbde97aa5c,2017,,,1,KH Pandya,RG Sharma,54,40,7,1,1,34,24,6,0,20,16,1,1
6480bb9a7f7a862ba0b2c59e,2007/08,,,2,AC Gilchrist,SB Styris,54,36,6,2,1,41,21,5,2,11,15,1,0
6480bb9399a527d39bc17dad,2017,,,2,KM Jadhav,TM Head,54,25,7,2,0,38,16,5,2,16,9,2,0
6480bb9b6ded6d116cfe02ee,2009,,,1,BJ Hodge,SC Ganguly,54,44,6,1,1,23,20,3,0,30,24,3,1
6480bb9baccf501985a56d64,2007/08,,,2,MF Maharoof,TM Dilshan,54,22,3,5,1,39,16,2,4,14,6,1,1
6480bb9d3c4dfa9f054aa47f,2011,,,1,G Gambhir,MK Tiwary,54,43,6,1,0,18,17,2,0,30,26,4,1
6480bb95ea40317152ed9ca5,2018,,,1,RR Pant,SS Iyer,54,38,6,2,1,36,24,3,2,16,14,3,0
6480bb941ab79050c3c90ee5,2018,,,2,MS Dhoni,SW Billings,54,30,2,3,1,19,16,1,1,30,14,1,2
6480bb9aa64355ce98da1141,2007/08,,,2,RR Sarwan,SE Marsh,54,44,4,2,1,31,29,4,1,15,15,0,1
6480bb94b991069934e5c7d2,2018,,,1,AM Rahane,DJM Short,54,41,7,1,1,36,19,5,1,17,22,2,0
6480bb9552e25b3867e5c38a,2019,,,2,KM Jadhav,MS Dhoni,54,56,5,0,1,36,35,5,0,12,21,0,0
6480bb9d97cceb6330e84df0,2011,,,1,Y Nagar,Y Venugopal Rao,54,51,5,0,1,18,22,1,0,31,29,4,0
6480bb9ab99ef699d66ad5a0,2023,,,2,C Green,Ishan Kishan,54,33,6,2,1,23,18,4,0,26,15,2,2
6480bba0404171e13faa181e,2013,,,1,EJG Morgan,MK Tiwary,54,38,5,2,1,31,25,4,1,20,13,1,1
6480bb985efffbcafdef9f19,2021,,,1,E Lewis,YBK Jaiswal,54,33,10,1,1,36,21,7,1,16,12,3,0
6480bb942efd740a6ffc47df,2017,,,2,KM Jadhav,P Negi,54,36,2,3,1,18,13,1,0,35,23,1,3
6480bb97ea8bfb43e3f7515f,2020/21,,,2,F du Plessis,KM Jadhav,54,39,6,0,1,26,18,3,0,26,21,3,0
6480bb939b2499e9af6ee18c,2017,,,2,Ishan Kishan,KD Karthik,54,25,3,2,1,7,6,1,0,40,19,2,2
6480bb94b9d954a885cc531b,2017,,,2,AM Rahane,SPD Smith,54,57,5,0,1,34,32,4,0,18,25,1,0
6480bb9a1e358307d26cd50d,2023,,,1,Shubman Gill,WP Saha,54,38,6,1,1,34,22,3,1,18,16,3,0
6480bb95945c5e5dc4d8c7d6,2019,,,1,Q de Kock,RG Sharma,54,39,8,2,1,23,20,2,1,31,19,6,1
6480bb9b4fc6889967a3cd54,2007/08,,,2,AM Nayar,DJ Bravo,54,30,4,3,1,29,15,2,2,24,15,2,1
6480bb9e692eaa193a417426,2012,,,1,AB de Villiers,R Vinay Kumar,54,33,6,1,1,34,17,5,1,18,16,1,0
6480bb96e2809aa0bc35c7e9,2019,,,1,Q de Kock,SA Yadav,54,38,4,2,1,25,21,1,1,23,17,3,1
6480bba1568e0f3990191600,2014,,,2,AM Rahane,KK Nair,54,43,8,0,1,24,22,3,0,28,21,5,0
6480bba0b2a9d600114a43d7,2013,,,2,AT Rayudu,RG Sharma,54,52,4,1,1,26,23,2,1,27,29,2,0
6480bb9f7ff1377c4d13a645,2013,,,1,RT Ponting,SR Tendulkar,54,43,8,1,1,14,17,2,0,39,26,6,1
6480bb9a40966b9b90fcdf2e,2023,,,2,AD Russell,RK Singh,54,27,3,4,1,36,18,2,3,17,9,1,1
6480bb9ce544a2fc17a48bee,2009,,,1,LRPL Taylor,MV Boucher,54,23,4,4,0,39,13,4,3,13,10,0,1
6480bba04b49d2ff5f997e02,2013,,,2,CM Gautam,IK Pathan,54,42,4,1,1,30,23,2,1,20,19,2,0
6480bb958c7b985a2b586a02,2018,,,1,MS Dhoni,RA Jadeja,54,31,1,4,1,36,19,0,4,12,12,1,0
6480bb99350726d00af209bf,2022,,,1,F du Plessis,GJ Maxwell,54,37,5,2,1,18,13,2,0,33,24,3,2
6480bb9498a98d52f9285b52,2017,,,1,DA Warner,Yuvraj Singh,54,47,7,1,1,34,21,4,1,19,26,3,0
6480bb9da3dc1406b000cc98,2011,,,1,JD Ryder,M Manhas,54,28,5,3,1,30,10,4,2,20,18,1,1
6480bb9bee2e48d9c41b1e23,2009,,,1,MS Dhoni,SK Raina,54,35,3,2,1,22,16,2,0,32,19,1,2
6480bb9adb5d9ca80cb1c6a0,2023,,,1,JC Buttler,YBK Jaiswal,54,30,7,2,1,13,12,2,0,35,18,5,2
6480bb98adf21699eaa67796,2022,,,2,DP Conway,RD Gaikwad,54,40,6,2,1,26,17,3,1,28,23,3,1
6480bba0ad06ad631cf7665f,2014,,,1,DR Smith,SK Raina,54,46,3,1,1,16,18,1,0,35,28,2,1
6480bba10e78f50f124b406a,2015,,,2,MS Dhoni,SK Raina,54,24,3,5,1,12,10,2,0,41,14,1,5
6480bb9aa37f3b44678752d9,2023,,,1,C Green,SA Yadav,54,18,5,4,0,3,3,0,0,50,15,5,4
6480bba3bca9c998d5f3e3d0,2016,,,1,HM Amla,WP Saha,54,41,6,0,1,27,18,3,0,27,23,3,0
6480bb9ac9149c73fdf073b3,2023,,,1,DP Conway,S Dube,54,22,4,4,1,27,13,4,1,22,9,0,3
6480bba223f162806c0794ac,2015,,,1,MS Dhoni,P Negi,54,28,5,2,1,17,11,1,1,36,17,4,1
6480bb95e25835586d412978,2018,,,1,CH Gayle,KL Rahul,54,40,5,3,1,28,20,4,1,24,20,1,2
6480bba1d21281c7385d5ce4,2014,,,2,DA Miller,WP Saha,54,29,5,3,1,39,15,5,2,13,14,0,1
6480bb95a09b947e0837a38a,2019,,,2,AS Joseph,KA Pollard,54,23,4,5,1,12,10,2,0,41,13,2,5
6480bb94aad1a08ca4276b4e,2018,,,2,AB de Villiers,Q de Kock,54,39,6,2,1,19,17,1,1,34,22,5,1
6480bb95385ebb9bda58a643,2019,,,1,HH Pandya,KH Pandya,54,26,5,3,1,32,15,2,3,20,11,3,0
6480bb9a8053274c083224d9,2023,,,1,N Wadhera,T Stubbs,54,42,5,1,1,37,26,4,1,13,16,1,0
6480bb994aafcf67cd092a7d,2023,,,2,B Sai Sudharsan,V Shankar,53,44,4,0,1,22,21,1,0,29,23,3,0
6480bb97a4220e27710e38de,2021,,,1,AB de Villiers,GJ Maxwell,53,35,5,1,1,33,20,4,0,18,15,1,1
6480bb950c59218964b27cc0,2018,,,1,JC Buttler,SV Samson,53,48,3,1,1,30,30,2,0,22,18,1,1
6480bb9a40966b9b90fcdf2e,2023,,,1,JM Sharma,S Dhawan,53,42,5,2,1,21,18,0,2,26,24,5,0
6480bb9c94ef2c2e850189ff,2009/10,,,2,DPMD Jayawardene,RS Bopara,53,22,7,2,1,21,11,2,1,29,11,5,1
6480bb9c266a85f1960d87e9,2009,,,2,KC Sangakkara,Yuvraj Singh,53,64,6,0,1,33,38,5,0,18,26,1,0
6480bba280f09c38002cf14b,2015,,,1,AD Russell,YK Pathan,53,25,5,4,1,31,13,4,2,20,12,1,2
6480bba1dd2f8125fc8b203f,2014,,,1,CJ Anderson,RG Sharma,53,35,5,3,1,33,21,3,2,19,14,2,1
6480bb97752fcb9cd9f23692,2021,,,2,S Dube,SV Samson,53,31,4,2,1,23,15,3,0,28,16,1,2
6480bb9e1751fd9db64a2834,2011,,,1,KA Pollard,RG Sharma,53,39,4,1,1,20,18,2,0,30,21,2,1
6480bba20130c44ed20c9bcf,2016,,,2,AJ Finch,SK Raina,53,42,7,1,1,22,20,4,0,27,22,3,1
6480bb967c50ceac62ba0719,2020/21,,,2,Ishan Kishan,SA Yadav,53,31,5,2,1,16,10,1,1,35,21,4,1
6480bb97f2f0fabec8f94d86,2020/21,,,1,N Rana,Shubman Gill,53,44,8,1,1,27,27,4,1,26,17,4,0
6480bb9aef150645306cc170,2023,,,1,Abdul Samad,H Klaasen,53,33,1,4,1,28,21,1,2,22,12,0,2
6480bb9482dff502bff80bcf,2017,,,2,DA Warner,S Dhawan,53,32,7,2,1,30,21,4,1,23,11,3,1
6480bb9e83b8575f74b8e962,2012,,,2,CH Gayle,MA Agarwal,53,32,5,3,1,6,6,0,0,45,26,5,3
6480bb993e44f97eccb361fe,2023,,,1,KL Rahul,KR Mayers,53,46,4,3,1,23,23,3,0,29,23,1,3
6480bb9b72f6a46338302131,2009,,,2,JP Duminy,PR Shah,53,42,6,2,1,22,23,3,0,29,19,3,2
6480bb9c8f3ef1685cdf4017,2009,,,1,DA Warner,G Gambhir,53,40,7,1,1,27,16,4,1,18,24,3,0
6480bb9a1a3e8cef5633f4e6,2023,,,2,C Green,SA Yadav,53,30,7,1,0,27,14,3,1,25,16,4,0
6480bba1bd00c57fb3301f04,2014,,,1,G Gambhir,MK Pandey,53,33,6,0,1,22,16,3,0,29,17,3,0
6480bb93182304739a535742,2017,,,2,RR Pant,SV Samson,53,43,1,3,1,31,22,1,2,22,21,0,1
6480bb9eb14c6138aebfbf98,2012,,,2,BB McCullum,G Gambhir,53,35,7,1,1,15,18,3,0,36,17,4,1
6480bb9f777b7b1e89543a6e,2013,,,1,AM Rahane,BJ Hodge,53,29,4,2,0,24,14,4,0,27,15,0,2
6480bb97ce8cbd211049f957,2021,,,2,KL Rahul,MA Agarwal,53,45,6,2,1,27,25,2,1,25,20,4,1
6480bb98cbaaf700d226941a,2022,,,1,JC Buttler,SO Hetmyer,53,24,4,3,1,11,10,1,0,35,14,3,3
6480bb95833c06e6c5119173,2019,,,2,AD Russell,Shubman Gill,53,14,1,7,0,47,11,1,7,3,3,0,0
6480bb9eb14c6138aebfbf98,2012,,,2,G Gambhir,JH Kallis,53,40,4,1,0,22,17,2,0,30,23,2,1
6480bba19e29de4f208211ac,2014,,,2,CH Gayle,PA Patel,53,31,7,2,1,24,12,2,2,26,19,5,0
6480bb9f218f37b46bef4afb,2013,,,1,M Vohra,Mandeep Singh,53,33,7,0,1,22,13,3,0,30,20,4,0
6480bb950ced01a335bd7833,2019,,,1,MP Stoinis,PA Patel,53,44,3,2,1,18,21,0,1,34,23,3,1
6480bb937dc0a09df8f7aeee,2017,,,2,HM Amla,M Vohra,53,31,7,1,1,15,12,3,0,28,19,4,1
6480bb9c757dbd7f92b1130a,2009/10,,,2,Harbhajan Singh,R McLaren,53,22,8,2,0,49,18,8,2,2,4,0,0
6480bb966c9efd5bf35d10b9,2019,,,2,AM Rahane,SV Samson,53,32,5,3,1,34,21,5,1,19,11,0,2
6480bba264ad6b873d0d07d8,2016,,,1,KD Karthik,SK Raina,53,44,4,0,1,28,26,1,0,23,18,3,0
6480bb9a8cf29e28434bb1d5,2023,,,1,Aman Hakim Khan,RV Patel,53,27,4,3,1,30,16,2,2,22,11,2,1
6480bb972a7d4e1071ea662e,2021,,,2,S Dhawan,SPD Smith,53,47,5,0,1,16,18,1,0,33,29,4,0
6480bb9f4780a208e13bfb3d,2013,,,1,CH Gayle,TM Dilshan,53,40,8,0,1,21,18,3,0,25,22,5,0
6480bba179195d83fa7fbfbb,2014,,,1,KK Nair,SV Samson,53,42,3,1,1,24,18,1,1,27,24,2,0
6480bb9525c593ee45bb038c,2019,,,2,CH Gayle,KL Rahul,53,44,4,4,1,40,24,3,4,12,20,1,0
6480bba0cdc200ad3ab8fbf5,2014,,,1,BB McCullum,F du Plessis,53,50,2,2,1,32,25,2,2,20,25,0,0
6480bba2f39653e2f61baca2,2015,,,1,AT Rayudu,KA Pollard,53,25,3,4,0,25,11,3,1,26,14,0,3
6480bb9f8ab73cf7c77cef03,2012,,,1,SR Watson,STR Binny,53,36,5,3,1,21,19,2,1,30,17,3,2
6480bb9c71030f4c6f018f55,2009,,,2,KC Sangakkara,WA Mota,53,45,3,1,1,40,26,3,1,12,19,0,0
6480bb9a7194d8b20952afae,2007/08,,,1,G Gambhir,V Sehwag,53,30,8,1,1,26,18,5,0,24,12,3,1
6480bba2e8614b1263627c1b,2015,,,2,EJG Morgan,RS Bopara,53,20,4,4,1,46,16,3,4,6,4,1,0
6480bb9f777b7b1e89543a6e,2013,,,1,AM Rahane,DH Yagnik,53,40,5,1,1,13,16,1,0,34,24,4,1
6480bba25855b7a7195a9bc5,2016,,,2,AT Rayudu,RG Sharma,53,41,8,0,1,25,23,4,0,28,18,4,0
6480bb94b882fb725e3f98e5,2018,,,1,CH Gayle,KL Rahul,53,47,4,3,1,31,26,1,3,18,21,3,0
6480bba2eea6f31945e4c5e2,2016,,,2,PA Patel,RG Sharma,53,35,8,1,1,23,20,4,0,25,15,4,1
6480bb95ff5da0069bc5274e,2018,,,1,CA Lynn,SP Narine,53,32,5,3,1,27,17,2,2,26,15,3,1
6480bb9c7b7d7712bdc663de,2009/10,,,1,S Dhawan,SR Tendulkar,53,37,6,0,1,14,13,1,0,35,24,5,0
6480bb931e6d2b03141b586d,2017,,,1,SV Samson,SW Billings,53,37,8,0,1,32,20,6,0,21,17,2,0
6480bb9bd918d2e963f0218a,2009,,,1,R Dravid,V Kohli,53,31,5,2,1,28,13,2,2,24,18,3,0
6480bb9a7d91d721555835e5,2007/08,,,1,SA Asnodkar,YK Pathan,53,27,10,0,1,35,17,7,0,17,10,3,0
6480bb95ff5da0069bc5274e,2018,,,2,AJ Tye,R Ashwin,53,23,4,4,1,14,10,1,1,35,13,3,3
6480bb9834c7569d5fa64353,2022,,,1,DA Miller,HH Pandya,53,25,7,2,0,31,14,5,1,20,11,2,1
6480bb9c5d0fccb6a3a6d37d,2009,,,2,GC Smith,SA Asnodkar,53,50,5,1,1,24,25,2,0,26,25,3,1
6480bb9c0dec1a788da66d33,2009/10,,,1,FY Fazal,NV Ojha,53,42,3,2,1,17,18,1,0,36,24,2,2
6480bb9e30b7f3c09cfbdabb,2011,,,1,BJ Hodge,PA Patel,53,25,7,2,0,33,17,5,2,15,8,2,0
6480bb9a7577454a5220c94b,2007/08,,,2,SA Asnodkar,SR Watson,53,34,4,2,1,15,14,0,1,32,20,4,1
6480bb974086cbea889134af,2021,,,1,MM Ali,SK Raina,53,38,7,2,1,36,22,4,2,16,16,3,0
6480bb9371e90dbd44ee19a3,2017,,,1,SV Samson,SW Billings,53,42,8,1,1,19,18,2,1,32,24,6,0
6480bb99efa58b95852be382,2023,,,2,B Sai Sudharsan,Shubman Gill,53,35,6,1,1,22,17,3,0,29,18,3,1
6480bb96edb3270eba0af1d4,2020/21,,,1,D Padikkal,V Kohli,53,45,3,1,1,24,26,1,1,24,19,2,0
6480bb99b3179a9346d8883c,2022,,,1,D Padikkal,R Ashwin,53,36,3,3,1,29,17,2,2,24,19,1,1
6480bba38060854b4fab1831,2016,,,1,KL Rahul,Sachin Baby,53,27,2,4,0,22,14,0,2,25,13,2,2
6480bb96e18d7a1b3e62552d,2019,,,2,KL Rahul,P Simran Singh,53,32,1,5,1,40,20,1,4,11,12,0,1
6480bb975156c246a0ee40b1,2021,,,1,N Rana,Shubman Gill,53,42,9,1,1,38,29,8,0,15,13,1,1
6480bb9eae43aed76989151b,2011,,,2,MK Tiwary,YK Pathan,53,41,3,3,1,15,17,1,0,36,24,2,3
6480bb9d05f8e769574069fa,2009/10,,,2,CH Gayle,SC Ganguly,52,32,7,2,1,34,15,6,1,16,17,1,1
6480bb981f136a7564719d7f,2022,,,1,LS Livingstone,S Dhawan,52,32,3,3,1,36,14,3,3,15,18,0,0
6480bba3412663673a969a24,2016,,,1,TM Head,V Kohli,52,25,3,4,0,6,9,0,0,45,16,3,4
6480bb95cf9d446747bd74fe,2019,,,2,SK Raina,SR Watson,52,24,5,3,1,19,9,4,0,28,15,1,3
6480bb94738952e740c68749,2018,,,1,MK Pandey,Shakib Al Hasan,52,54,3,0,1,20,25,0,0,28,29,3,0
6480bb978c66ea3d9c85132d,2020/21,,,1,S Dhawan,SO Hetmyer,52,28,5,1,1,15,12,1,0,35,16,4,1
6480bb988b447f26d7a96c0c,2022,,,1,KL Rahul,Q de Kock,52,33,7,2,1,27,20,3,1,24,13,4,1
6480bb9dc8b09381d0f01a9d,2011,,,1,MEK Hussey,MS Dhoni,52,40,4,1,1,25,19,2,0,26,21,2,1
6480bb980cc3d01eab3a4748,2022,,,2,M Shahrukh Khan,OF Smith,52,25,2,5,0,21,17,1,2,25,8,1,3
6480bb990942cd416cf5f447,2022,,,1,DA Miller,Shubman Gill,52,41,3,1,1,26,24,1,1,24,17,2,0
6480bb9d69cb9046a72d8fbe,2009/10,,,1,MS Dhoni,S Badrinath,52,51,4,0,1,30,32,3,0,17,19,1,0
6480bb9da398a7c3c645732c,2011,,,1,AM Rahane,LRPL Taylor,52,32,4,2,0,15,9,2,0,33,23,2,2
6480bb9dfa7d0510ae3a7b40,2011,,,1,DA Warner,Y Venugopal Rao,52,40,4,1,1,22,17,1,1,21,23,3,0
6480bba18e95c84faca0bdb6,2015,,,2,AM Rahane,DJ Hooda,52,27,2,4,1,13,10,0,1,37,17,2,3
6480bb9b52b93b56f5a16e52,2007/08,,,2,M Kaif,SR Watson,52,29,2,4,1,12,11,0,1,38,18,2,3
6480bb9e95693a2c4c4531e8,2011,,,2,DA Warner,NV Ojha,52,48,3,3,1,15,20,1,1,28,28,2,2
6480bb9774dd8e44bbeeb5a4,2021,,,1,DJ Malan,MA Agarwal,52,47,3,1,1,26,26,1,1,25,21,2,0
6480bba19052ba503c5f7c27,2015,,,1,EJG Morgan,NV Ojha,52,55,5,1,1,24,23,2,1,25,32,3,0
6480bba1b85900d7d83de308,2014,,,2,DA Miller,GJ Bailey,52,33,3,3,0,16,14,1,0,35,19,2,3
6480bb9db38208342bc57b96,2011,,,2,CH Gayle,V Kohli,52,36,6,1,0,18,13,3,0,30,23,3,1
6480bb990b96e91d3fbf421b,2022,,,2,JC Buttler,SV Samson,52,39,6,2,1,29,18,5,0,23,21,1,2
6480bba09d6b23c8722fd208,2013,,,1,M Vijay,MEK Hussey,52,44,7,0,1,23,20,2,0,28,24,5,0
6480bb9d97cceb6330e84df0,2011,,,2,BJ Hodge,PA Patel,52,31,8,1,0,24,13,3,1,27,18,5,0
6480bb9d105fba311a23a588,2011,,,2,AB de Villiers,SS Tiwary,52,46,2,2,1,24,22,0,2,26,24,2,0
6480bb9be7cbbb90a12dc916,2009,,,1,A Flintoff,ML Hayden,52,42,5,1,1,24,23,2,1,20,19,3,0
6480bba0f401cc6b6bc6ed10,2013,,,2,CL White,S Dhawan,52,51,7,0,1,31,28,5,0,19,23,2,0
6480bb94704f6dfeb7f4d270,2017,,,2,CA Lynn,MK Pandey,52,44,2,2,1,32,21,1,2,18,23,1,0
6480bba1cef79f12933bbf27,2014,,,2,NV Ojha,S Dhawan,52,36,2,3,1,19,18,0,1,33,18,2,2
6480bb9dfb2e8e8c2002df86,2011,,,2,J Botha,R Dravid,52,43,5,0,1,32,24,4,0,20,19,1,0
6480bb9765a785922ad360fe,2021,,,2,S Dhawan,SS Iyer,52,48,4,2,1,33,28,4,1,19,20,0,1
6480bb9b2de4e62ee60b7e5c,2009,,,2,K Goel,RS Bopara,52,40,2,1,1,19,19,1,0,23,21,1,1
6480bb9e65a802582c071438,2012,,,2,JEC Franklin,SR Tendulkar,52,47,5,0,1,22,22,2,0,28,25,3,0
6480bba08ffdd4393211d261,2014,,,1,AJ Finch,KL Rahul,52,47,4,1,1,22,20,3,0,25,27,1,1
6480bb97752fcb9cd9f23692,2021,,,2,R Parag,SV Samson,52,22,3,5,1,25,11,1,3,26,11,2,2
6480bb9448fe25ec89c5fcff,2017,,,2,SE Marsh,WP Saha,52,27,1,4,1,25,16,0,2,24,11,1,2
6480bba179195d83fa7fbfbb,2014,,,1,AM Rahane,KK Nair,52,39,6,1,1,30,22,3,1,20,17,3,0
6480bb9737b1d7284b5297c1,2021,,,2,GJ Maxwell,V Kohli,52,40,3,2,1,37,23,3,2,13,17,0,0
6480bb9f70156528a31bb270,2013,,,2,RT Ponting,SR Tendulkar,52,45,5,1,1,27,26,1,1,23,19,4,0
6480bb9c1e676472f4841aa9,2009/10,,,1,MV Boucher,RV Uthappa,52,19,1,6,0,11,7,0,1,41,12,1,5
6480bb9f4bdcea2f81049fe9,2012,,,1,DPMD Jayawardene,LRPL Taylor,52,28,2,3,1,23,14,1,1,24,14,1,2
6480bb9a1032ce724214f6dd,2007/08,,,1,DJ Thornely,RV Uthappa,52,43,2,3,1,24,22,2,1,22,21,0,2
6480bb95fa6394e733c532a9,2018,,,2,CA Lynn,SP Narine,52,22,7,3,1,20,12,3,1,29,10,4,2
6480bba22349149c9ec92d49,2016,,,2,AT Rayudu,RG Sharma,52,46,3,2,1,22,19,1,1,30,27,2,1
6480bb961cdee4d82c395517,2020/21,,,1,JM Bairstow,KS Williamson,52,39,5,0,1,14,18,0,0,38,21,5,0
6480bb9ef18c54e7aafdd223,2012,,,2,DJ Hussey,Mandeep Singh,52,46,2,1,1,25,23,1,0,27,23,1,1
6480bb9a1e358307d26cd50d,2023,,,2,C Green,SA Yadav,52,33,4,2,1,26,17,1,2,24,16,3,0
6480bb996c324f07ab7f763c,2023,,,2,RK Singh,UT Yadav,52,21,1,6,0,45,15,1,6,5,6,0,0
6480bb93ec7e3351941d3b5b,2017,,,2,CH Gayle,Mandeep Singh,52,34,7,2,1,26,18,2,2,24,16,5,0
6480bba2bbd9d85769220a68,2015,,,1,AM Rahane,SR Watson,52,41,8,0,1,26,17,4,0,21,24,4,0
6480bb9d109617dfa089c2c6,2011,,,1,AL Menaria,R Dravid,52,42,4,1,1,27,20,2,1,23,22,2,0
6480bb94ca3c1b1eac5e8dd3,2018,,,1,HH Pandya,KH Pandya,52,32,5,2,0,9,10,0,0,41,22,5,2
6480bb9c12e6c723b248799b,2009,,,2,HH Gibbs,RG Sharma,52,45,2,2,1,25,22,1,1,24,23,1,1
6480bba141bcb000fa6fe2a4,2015,,,1,JP Faulkner,SPD Smith,52,28,6,1,0,6,6,0,0,44,22,6,1
6480bb9a325c576efe386437,2023,,,2,PD Salt,RR Rossouw,52,31,2,4,1,23,13,1,2,27,18,1,2
6480bba2a94dd2c01769b3ae,2016,,,1,KD Karthik,RA Jadeja,52,39,7,0,1,27,20,3,0,24,19,4,0
6480bb9b8cc888fe3f01f2a4,2009,,,2,BJ Hodge,SC Ganguly,51,33,4,2,1,26,16,3,1,22,17,1,1
6480bba20559f15c3489f637,2015,,,1,LMP Simmons,RG Sharma,51,33,5,2,1,29,21,3,1,22,12,2,1
6480bb9e5ad1f3182858e7c9,2012,,,1,JEC Franklin,SR Tendulkar,51,49,7,0,1,26,26,4,0,23,23,3,0
6480bb951354c40599b60208,2018,,,1,KS Williamson,S Dhawan,51,40,3,3,1,29,22,2,2,19,18,1,1
6480bba35038a60ea566794a,2016,,,1,AJ Finch,RA Jadeja,51,29,7,1,1,35,17,6,1,16,12,1,0
6480bb99efa58b95852be382,2023,,,1,AT Rayudu,RD Gaikwad,51,31,1,6,1,12,12,0,1,39,19,1,5
6480bb96fb897a6ff486ffe4,2020/21,,,1,MS Dhoni,RA Jadeja,51,46,4,0,1,26,23,2,0,22,23,2,0
6480bba32e54551792a9e915,2016,,,1,DR Smith,RA Jadeja,51,33,8,1,0,28,18,4,1,21,15,4,0
6480bb9df57ec21d17310ad2,2011,,,1,JH Kallis,MS Bisla,51,50,8,0,1,30,29,5,0,19,21,3,0
6480bb9404b444be6724e41e,2017,,,2,BA Stokes,MK Tiwary,51,39,5,2,1,33,25,3,2,17,14,2,0
6480bb9bef0d1fffea8bfd11,2009,,,2,K Goel,SM Katich,51,36,3,3,1,14,20,1,0,35,16,2,3
6480bb9a596c087c0396ec2e,2007/08,,,1,PR Shah,RV Uthappa,51,47,5,1,1,19,23,2,0,30,24,3,1
6480bb9e9f1ef9ac02266570,2011,,,1,DB Ravi Teja,S Dhawan,51,40,5,2,1,26,23,4,0,24,17,1,2
6480bb9c7bc1dc527c14f1ac,2009/10,,,2,DPMD Jayawardene,MS Bisla,51,29,7,1,1,31,16,4,1,18,13,3,0
6480bb9c7b7d7712bdc663de,2009/10,,,1,AT Rayudu,KA Pollard,51,20,7,1,1,29,10,4,1,21,10,3,0
6480bb99fa79383bdc7df827,2022,,,1,LS Livingstone,MA Agarwal,51,35,5,2,1,31,19,2,2,19,16,3,0
6480bb9a43249ece8e841e56,2023,,,2,Ishan Kishan,RG Sharma,51,28,5,4,1,42,21,4,4,7,7,1,0
6480bb95b84f125c6212267a,2019,,,2,C de Grandhomme,P Ray Barman,51,46,5,2,1,31,22,3,2,19,24,2,0
6480bb9a5d25d853e1cbfe3e,2007/08,,,1,DS Lehmann,SR Watson,51,39,5,3,1,17,16,3,0,32,23,2,3
6480bba18a431be2cc738de0,2014,,,2,KK Nair,SV Samson,51,43,4,2,1,15,15,2,0,34,28,2,2
6480bb9f210b6e50fb2072ae,2013,,,2,G Gambhir,JH Kallis,51,44,8,0,1,34,25,6,0,16,19,2,0
6480bba097818bcc0db9555d,2014,,,1,CA Pujara,V Sehwag,51,40,6,3,1,20,18,4,0,30,22,2,3
6480bb9d05f8e769574069fa,2009/10,,,2,BB McCullum,SC Ganguly,51,39,4,2,1,27,24,3,1,17,15,1,1
6480bb9d86effd7e5e6a5261,2011,,,1,MEK Hussey,MS Dhoni,51,34,4,2,1,27,18,3,1,22,16,1,1
6480bb995f3db9699a1f794d,2022,,,2,SV Samson,YBK Jaiswal,51,41,7,0,1,15,20,2,0,26,21,5,0
6480bba133267f04941acf7d,2014,,,2,MK Pandey,RV Uthappa,51,47,6,1,1,12,16,1,0,38,31,5,1
6480bb99433f6e11060ba714,2022,,,1,MR Marsh,SN Khan,51,28,5,3,1,19,12,0,2,32,16,5,1
6480bb9c89e2e8ecb04f94cb,2009/10,,,2,AB de Villiers,DA Warner,51,38,2,2,1,25,21,2,0,26,17,0,2
6480bba278153a5979e31ec9,2016,,,2,KD Karthik,SK Raina,51,33,5,0,1,33,20,4,0,17,13,1,0
6480bb9affabe4960a987464,2007/08,,,2,BB McCullum,RT Ponting,51,41,1,3,1,27,21,0,2,20,20,1,1
6480bba1743abcb135a6a4c7,2015,,,2,DJ Hooda,JP Faulkner,51,36,2,3,1,30,15,1,3,17,21,1,0
6480bba01893b0faadb9c761,2013,,,2,R Rampaul,R Vinay Kumar,51,38,7,0,0,23,18,3,0,26,20,4,0
6480bb9940bd3bf36dd4897f,2023,,,2,KH Pandya,KL Rahul,51,48,4,1,1,23,23,2,1,27,25,2,0
6480bb9b2ca4a7b325526f1f,2009,,,2,LA Carseldine,RA Jadeja,51,44,6,1,1,36,27,6,0,12,17,0,1
6480bba2aecb4103bab63c15,2016,,,2,SA Yadav,YK Pathan,51,47,2,2,1,14,20,0,0,36,27,2,2
6480bb9a9514379c05d59c38,2023,,,2,SA Yadav,Tilak Varma,51,31,6,2,1,33,19,5,1,14,12,1,1
6480bb9d54ae15d3d0ed9e5e,2011,,,1,DPMD Jayawardene,M Klinger,51,40,4,1,1,28,22,1,1,22,18,3,0
6480bb9538916411f52016bf,2019,,,1,CA Lynn,RK Singh,51,43,2,2,1,18,18,1,0,30,25,1,2
6480bb9c454e9eefca545bde,2009/10,,,2,FY Fazal,YK Pathan,51,34,2,2,1,18,15,1,1,28,19,1,1
6480bb9d02d996f85dd5e945,2011,,,1,BB McCullum,PA Patel,51,36,6,1,1,25,17,2,1,25,19,4,0
6480bba30373b229e0090b67,2016,,,1,M Vijay,MP Stoinis,51,36,7,0,1,42,25,7,0,8,11,0,0
6480bb97af44a48533f08540,2020/21,,,2,RV Uthappa,SV Samson,51,32,3,3,1,21,16,1,1,29,16,2,2
6480bba01893b0faadb9c761,2013,,,1,KA Pollard,KD Karthik,51,27,4,3,1,34,14,2,3,15,13,2,0
6480bba1ff89cb428182daa6,2014,,,2,BB McCullum,SK Raina,51,41,4,1,1,15,14,1,0,35,27,3,1
6480bba3e9fa951efcfc8bfb,2016,,,2,KK Nair,SV Samson,51,35,3,1,1,15,17,0,0,34,18,3,1
6480bb98b00f767943bb8415,2022,,,2,PP Shaw,RR Pant,51,30,4,1,1,18,13,1,1,24,17,3,0
6480bb9f3700dfaa08e18c43,2012,,,1,AC Gilchrist,Mandeep Singh,51,41,10,0,1,23,20,5,0,24,21,5,0
6480bb9525c593ee45bb038c,2019,,,1,Q de Kock,RG Sharma,51,32,7,0,1,19,14,2,0,32,18,5,0
6480bb96b7b695186bbb6a3e,2019,,,2,DJ Bravo,SR Watson,51,34,3,4,1,15,15,0,1,35,19,3,3
6480bb974086cbea889134af,2021,,,1,RA Jadeja,SM Curran,51,27,5,2,1,16,12,1,0,34,15,4,2
6480bba2a94dd2c01769b3ae,2016,,,1,KD Karthik,SK Raina,51,42,3,1,1,26,23,2,0,23,19,1,1
6480bb99409885bcc7b67109,2023,,,2,MM Ali,S Dube,51,25,2,5,1,23,12,2,2,27,13,0,3
6480bb995f3db9699a1f794d,2022,,,1,MM Ali,MS Dhoni,51,52,3,1,1,22,24,2,0,26,28,1,1
6480bb980d1be75574871dcc,2022,,,2,Shubman Gill,WP Saha,51,45,6,0,1,20,23,2,0,29,22,4,0
6480bba2557febf92f9f79ab,2015,,,2,MK Pandey,RV Uthappa,51,29,8,1,1,12,13,2,0,38,16,6,1
6480bba2fc84811f520b04cf,2016,,,2,AJ Finch,SK Raina,51,27,6,2,1,29,18,5,0,20,9,1,2
6480bb99e520ec7a66b73adb,2022,,,2,D Brevis,Ishan Kishan,51,37,2,4,1,25,21,1,2,26,16,1,2
6480bba2ab35be3ffcfa932a,2016,,,2,DA Warner,MC Henriques,51,33,3,4,1,36,15,2,4,14,18,1,0
6480bb9adb5d9ca80cb1c6a0,2023,,,2,Abhishek Sharma,Anmolpreet Singh,51,35,7,1,1,18,10,3,0,33,25,4,1
6480bb996c324f07ab7f763c,2023,,,1,DA Miller,V Shankar,51,16,3,5,0,2,3,0,0,46,13,3,5
6480bb97372fc5d5ef4c436a,2021,,,1,Lalit Yadav,RR Pant,51,35,8,0,1,14,15,2,0,35,20,6,0
6480bb95b1f28cf5bcf5e167,2018,,,1,B Kumar,CR Brathwaite,51,30,1,4,1,7,11,0,0,39,19,1,4
6480bb9a1e358307d26cd50d,2023,,,2,SA Yadav,Tilak Varma,51,22,6,3,1,8,8,1,0,43,14,5,3
6480bb9a87f64c1a12f62ece,2007/08,,,1,ML Hayden,MS Dhoni,51,25,9,0,1,25,12,5,0,24,13,4,0
6480bb9a40966b9b90fcdf2e,2023,,,2,N Rana,VR Iyer,51,38,5,1,1,39,25,5,1,11,13,0,0
6480bb9d86effd7e5e6a5261,2011,,,1,M Vijay,MEK Hussey,51,39,6,2,1,31,21,3,2,19,18,3,0
6480bb9a87f64c1a12f62ece,2007/08,,,2,RV Uthappa,SM Pollock,51,37,6,1,1,41,28,6,1,8,9,0,0
6480bb9c0dec1a788da66d33,2009/10,,,2,M Vijay,SK Raina,51,30,5,2,1,37,20,4,2,13,10,1,0
6480bb9619eaed447b2a05d4,2020/21,,,2,HH Pandya,SA Yadav,51,30,4,3,1,17,15,0,2,30,15,4,1
6480bba264ad6b873d0d07d8,2016,,,2,AB de Villiers,V Kohli,51,36,7,0,1,20,16,2,0,31,20,5,0
6480bba048fb3d33ea0711e7,2013,,,1,LA Pomersbach,R Sathish,51,43,2,2,1,20,25,1,0,25,18,1,2
6480bb98af25209ef756aa2c,2021,,,1,GJ Maxwell,V Kohli,51,43,3,2,1,34,26,3,2,13,17,0,0
6480bb93894ff5c944493650,2017,,,1,BB McCullum,SK Raina,50,30,6,2,1,28,17,3,2,21,13,3,0
6480bb956b439141409fd739,2018,,,2,KK Nair,KL Rahul,50,37,4,2,1,31,23,2,2,19,14,2,0
6480bb9fa1611443840261b7,2012,,,2,SS Tiwary,V Kohli,50,43,2,3,1,23,21,1,1,26,22,1,2
6480bb9802d8f5ec4413766d,2022,,,1,A Manohar,HH Pandya,50,32,5,1,1,35,21,5,1,11,11,0,0
6480bb9873e53eace3a69dc7,2022,,,1,DA Miller,HH Pandya,50,35,2,2,1,27,20,1,2,20,15,1,0
6480bb945901306d3cb2b759,2018,,,1,AT Rayudu,SR Watson,50,28,5,3,1,12,8,2,0,37,20,3,3
6480bb980095555db76d49cb,2022,,,1,Ishan Kishan,RG Sharma,50,38,7,1,1,23,23,3,0,26,15,4,1
6480bb9efe3f9991539e7f6c,2012,,,1,AC Gilchrist,SE Marsh,50,47,8,0,1,21,17,3,0,29,30,5,0
6480bb94d8aa9021808a4760,2017,,,1,DA Warner,KS Williamson,50,46,2,3,1,24,20,0,2,24,26,2,1
6480bba1448ab5c40ac64696,2014,,,1,G Gambhir,RV Uthappa,50,44,6,1,1,14,18,1,0,33,26,5,1
6480bb9d867c041656e9a75f,2009/10,,,2,A Symonds,MR Marsh,50,33,2,4,1,41,19,2,4,9,14,0,0
6480bba0404171e13faa181e,2013,,,2,KA Pollard,RG Sharma,50,36,3,2,1,23,17,2,0,27,19,1,2
6480bb9ce93a7b4315d8fa30,2009,,,2,G Gambhir,TM Dilshan,50,30,7,2,1,10,12,0,1,37,18,7,1
6480bb99f816e64203e3c687,2023,,,2,AD Russell,VR Iyer,50,30,3,3,1,35,19,3,2,12,11,0,1
6480bb9b283b30d0503656f7,2007/08,,,2,HH Gibbs,Shahid Afridi,50,24,3,4,1,21,14,1,2,28,10,2,2
6480bb969d80bbba2884b855,2020/21,,,2,MK Pandey,WP Saha,50,32,5,2,1,26,19,3,1,21,13,2,1
6480bb9fe7d0f611ba6ad229,2012,,,1,AP Majumdar,RV Uthappa,50,28,7,1,1,16,12,2,0,33,16,5,1
6480bb94988cb8c136ec7e46,2018,,,2,MS Dhoni,RA Jadeja,50,28,3,3,1,28,15,2,2,19,13,1,1
6480bb950ced01a335bd7833,2019,,,2,RA Tripathi,SPD Smith,50,38,4,1,1,25,20,3,0,23,18,1,1
6480bb9df46e9f48932124df,2009/10,,,1,JP Duminy,KA Pollard,50,18,2,5,0,5,5,0,0,45,13,2,5
6480bb9a8cf29e28434bb1d5,2023,,,1,AR Patel,Aman Hakim Khan,50,54,3,2,1,26,26,2,1,21,28,1,1
6480bb9f231505ffc493730f,2012,,,2,CL White,DT Christian,50,39,2,3,1,32,20,2,2,16,19,0,1
6480bb933fdc96ee7273400e,2017,,,1,BA Stokes,SPD Smith,50,31,6,1,1,21,14,3,0,27,17,3,1
6480bb94ca96a1c1f17d1294,2017,,,1,MK Tiwary,SPD Smith,50,33,5,2,1,19,15,1,1,31,18,4,1
6480bb99f2a793884331579e,2023,,,1,SN Thakur,VR Iyer,50,28,2,4,1,13,11,1,0,37,17,1,4
6480bb980cc3d01eab3a4748,2022,,,1,Anuj Rawat,F du Plessis,50,42,3,1,1,21,20,2,1,13,22,1,0
6480bb97f2f0fabec8f94d86,2020/21,,,2,RD Gaikwad,SR Watson,50,45,4,2,1,31,26,3,1,14,19,1,1
6480bb98bd3ca4df44cf9d8f,2022,,,2,DA Warner,PP Shaw,50,28,3,4,1,32,15,2,3,16,13,1,1
6480bba07e219ed95b7b06df,2013,,,2,LJ Wright,Yuvraj Singh,50,39,7,0,1,19,18,3,0,29,21,4,0
6480bb9de80788b3c3ebe4e1,2009/10,,,1,AP Dole,AS Raut,50,34,2,3,1,30,18,2,1,19,16,0,2
6480bb9a9dc58f49d783faa9,2023,,,1,F du Plessis,V Kohli,50,42,4,1,1,30,23,3,1,18,19,1,0
6480bb9e2c96ab2b87d9466a,2011,,,1,AC Blizzard,SR Tendulkar,50,32,11,0,1,34,18,8,0,14,14,3,0
6480bb9a21e416835389fd53,2023,,,2,P Simran Singh,S Dhawan,50,26,6,2,1,20,11,2,1,28,15,4,1
6480bb960d9d6af315534958,2019,,,2,AD Russell,Shubman Gill,50,26,3,4,1,24,14,2,2,22,12,1,2
6480bba286cca051953c976a,2015,,,1,BB McCullum,DR Smith,50,28,6,3,1,24,15,3,1,26,13,3,2
6480bb980095555db76d49cb,2022,,,2,Anuj Rawat,F du Plessis,50,49,1,3,1,29,25,0,3,16,24,1,0
6480bb96ed06a5693a66b9f0,2020/21,,,1,BA Stokes,RV Uthappa,50,34,7,1,1,15,19,2,0,31,15,5,1
6480bb9affabe4960a987464,2007/08,,,2,BB McCullum,Mohammad Hafeez,50,17,3,5,0,45,14,2,5,5,3,1,0
6480bba0b07a395235841955,2013,,,2,AT Rayudu,KA Pollard,50,44,5,0,0,34,27,4,0,13,17,1,0
6480bb99350726d00af209bf,2022,,,2,AK Markram,RA Tripathi,50,45,4,2,1,21,27,1,1,29,18,3,1
6480bb9c266a85f1960d87e9,2009,,,1,KD Karthik,M Manhas,50,39,2,1,1,23,20,0,1,23,19,2,0
6480bb98323919fff9902666,2022,,,1,JM Sharma,LS Livingstone,50,26,3,3,1,22,12,2,1,22,14,1,2
6480bb9a9801c2dda3fe88e9,2007/08,,,1,SM Katich,Yuvraj Singh,50,38,4,2,1,30,24,3,1,17,14,1,1
6480bb9c21492b9a562c6f46,2009/10,,,2,BJ Hodge,CA Pujara,50,46,5,0,1,21,21,1,0,29,25,4,0
6480bb9de80788b3c3ebe4e1,2009/10,,,2,KA Pollard,SR Tendulkar,50,33,5,1,1,25,13,3,1,22,20,2,0
6480bb96a43476c5d9a56c4e,2020/21,,,1,AT Rayudu,RA Jadeja,50,21,1,5,0,15,8,1,1,33,13,0,4
6480bb975ea60ce128803d60,2021,,,1,F du Plessis,MM Ali,50,25,5,2,1,19,13,3,0,25,12,2,2
6480bba2f3ed8323f852acfa,2016,,,2,AR Patel,NS Naik,50,35,1,3,1,35,15,1,3,13,20,0,0
6480bba11c977a5d11c1aa38,2015,,,1,DA Warner,S Dhawan,50,37,7,0,1,28,19,4,0,18,18,3,0
6480bb9af1b34d6aa89e434e,2023,,,2,Atharva Taide,P Simran Singh,50,33,6,2,1,25,20,2,2,22,13,4,0
6480bb9c8cbb5dec60b7d50a,2009/10,,,1,FY Fazal,YK Pathan,50,26,1,5,0,8,11,1,0,37,15,0,5
6480bb98b8bb5b0d2c2f0848,2022,,,2,AT Rayudu,RV Uthappa,50,39,3,4,1,21,19,1,2,27,20,2,2
6480bb99b4febfb641fddd39,2023,,,1,N Wadhera,Tilak Varma,50,30,4,3,1,21,13,1,2,28,17,3,1
6480bb99e520ec7a66b73adb,2022,,,2,TH David,Tilak Varma,50,20,3,5,1,34,11,2,4,14,9,1,1
6480bb9f02801d2090cdba0d,2012,,,2,JEC Franklin,SR Tendulkar,50,47,6,1,1,25,23,3,1,23,24,3,0
6480bba03a099a1a2e9c3dc5,2013,,,2,BJ Rohrer,DPMD Jayawardene,50,34,6,1,1,21,18,3,0,26,16,3,1
6480bb9c9e328ac30bcaf6b0,2009/10,,,1,ML Hayden,MS Dhoni,50,30,5,0,1,17,12,1,0,31,18,4,0
6480bb9429a15517bb46f3be,2018,,,2,G Gambhir,JJ Roy,50,31,5,3,1,15,16,2,0,35,15,3,3
6480bb9d1f9a3cf1fa86e11c,2011,,,1,KC Sangakkara,S Sohal,50,38,6,1,1,15,10,2,0,32,28,4,1
6480bb9d5cca30c933d4baf4,2011,,,2,AL Menaria,STR Binny,50,30,4,2,1,27,17,2,1,23,13,2,1
6480bb94b9d954a885cc531b,2017,,,1,KH Pandya,MG Johnson,50,35,2,3,1,32,21,2,2,13,14,0,1
6480bb99cbb648c5c0ecb205,2023,,,2,HH Pandya,Shubman Gill,50,39,4,1,1,26,20,2,1,20,19,2,0
6480bb9deba74e341b44c765,2009/10,,,1,KP Pietersen,R Dravid,50,39,4,2,0,29,21,1,2,20,18,3,0
6480bb953aab41e7ed166b9d,2019,,,2,KA Pollard,Yuvraj Singh,50,30,6,2,1,21,13,2,1,28,17,4,1
6480bb98291bb8b3f3e8145d,2022,,,1,AR Patel,SN Thakur,49,20,3,4,0,19,9,2,1,29,11,1,3
6480bb9623a26d3fbfe59f25,2020/21,,,2,AB de Villiers,AJ Finch,49,31,6,1,1,24,16,3,1,19,15,3,0
6480bb9a51ee1ef33a5b2dbb,2007/08,,,1,IK Pathan,KC Sangakkara,49,31,5,0,1,22,20,2,0,18,11,3,0
6480bb94dcc956fa4ca06b92,2018,,,2,CA Lynn,RV Uthappa,49,31,4,3,1,11,10,1,0,36,21,3,3
6480bb96e76ccde6082d7564,2020/21,,,1,EJG Morgan,Shubman Gill,49,43,3,1,1,24,23,2,1,22,20,1,0
6480bba326249b668a4713d6,2016,,,2,KD Karthik,SK Raina,49,36,6,1,1,41,23,6,1,8,13,0,0
6480bb99a620a7afdb3217fe,2023,,,1,JC Buttler,SO Hetmyer,49,29,5,2,1,24,14,4,0,23,15,1,2
6480bba358370ecde0231113,2016,,,1,GJ Bailey,R Ashwin,49,48,4,1,1,27,27,2,1,22,21,2,0
6480bba11eff9b230a172302,2014,,,1,SA Yadav,Shakib Al Hasan,49,28,5,1,1,30,17,3,1,17,11,2,0
6480bb96267b63eb2c6747b0,2019,,,2,Gurkeerat Singh,MP Stoinis,49,34,3,2,1,24,16,2,1,23,18,1,1
6480bb9d80e97e178e5f68de,2011,,,1,MS Dhoni,S Anirudha,49,41,2,2,1,29,21,1,1,20,20,1,1
6480bb9ab99ef699d66ad5a0,2023,,,1,MW Short,S Dhawan,49,35,6,1,1,20,17,2,1,26,18,4,0
6480bb947b065b9dc0256f0d,2018,,,1,AM Rahane,DJM Short,49,34,7,1,1,36,20,6,1,10,14,1,0
6480bb97dee20878b0c4246c,2021,,,2,AB de Villiers,KS Bharat,49,44,3,2,1,26,26,2,1,22,18,1,1
6480bb946efcc4cd9aa80399,2018,,,2,RV Uthappa,SP Narine,49,21,3,5,1,9,5,0,1,39,16,3,4
6480bb96e2809aa0bc35c7e9,2019,,,2,MK Pandey,Mohammad Nabi,49,31,5,2,1,17,11,3,0,31,20,2,2
6480bb94ca96a1c1f17d1294,2017,,,1,MK Tiwary,MS Dhoni,49,37,4,1,0,25,20,3,0,21,17,1,1
6480bb9bcc2f6123673672d0,2007/08,,,1,KD Karthik,MF Maharoof,49,29,6,2,0,29,16,2,2,20,13,4,0
6480bba06e8cb70fb4bdc83e,2013,,,1,AB de Villiers,V Kohli,49,35,3,3,1,15,15,0,1,33,20,3,2
6480bb95385ebb9bda58a643,2019,,,2,PP Shaw,S Dhawan,49,39,7,1,1,14,17,2,0,35,22,5,1
6480bb9cff4ec2f71cdf18d1,2009/10,,,2,DPMD Jayawardene,SE Marsh,49,36,2,1,1,20,18,2,0,22,18,0,1
6480bb954714437843ab3647,2019,,,1,C Munro,SS Iyer,49,28,4,3,1,32,17,2,3,16,11,2,0
6480bb956b439141409fd739,2018,,,1,JC Buttler,SV Samson,49,43,3,1,1,19,20,1,0,28,23,2,1
6480bb9e41b781523bd5aafe,2012,,,2,AJ Finch,V Sehwag,49,38,5,1,1,30,27,5,0,16,11,0,1
6480bb9bdde9db92f880e40d,2007/08,,,1,SC Ganguly,Umar Gul,49,18,2,5,1,21,7,1,2,24,11,1,3
6480bba296f606ef91305124,2016,,,2,G Gambhir,MK Pandey,49,28,6,1,0,37,17,6,1,11,11,0,0
6480bb9b2abb1e5479b853f5,2009,,,2,MC Henriques,MN van Wyk,49,38,4,1,1,24,21,1,1,25,17,3,0
6480bba1ff89cb428182daa6,2014,,,1,GJ Bailey,MG Johnson,49,16,8,2,0,38,10,6,2,11,6,2,0
6480bb96d1b3bea0aa2127e4,2020/21,,,1,RG Sharma,SS Tiwary,49,26,2,3,1,24,13,1,2,21,13,1,1
6480bba163bd0c619365a16b,2015,,,2,AT Rayudu,RG Sharma,49,34,2,3,1,26,20,2,1,22,14,0,2
6480bb98960cf9374ee9420d,2022,,,2,Ishan Kishan,RG Sharma,49,43,5,1,1,8,20,0,0,35,23,5,1
6480bba1d3370c13ea1f79f3,2014,,,1,AB de Villiers,PA Patel,49,26,5,1,1,29,13,3,1,17,13,2,0
6480bb966c197bad273f91f1,2020/21,,,1,Q de Kock,RG Sharma,49,29,5,3,1,23,15,3,1,25,14,2,2
6480bb9c8c6c106c6ffbeae4,2009/10,,,2,AB McDonald,KM Jadhav,49,23,4,2,0,18,12,1,1,26,11,3,1
6480bb9740aaba2132c0eb0e,2021,,,1,MS Dhoni,RA Jadeja,49,16,2,5,0,2,3,0,0,45,13,2,5
6480bb9e335bec070f88430f,2011,,,1,CH Gayle,SS Tiwary,49,49,3,2,0,31,23,2,2,13,26,1,0
6480bb9d0f6794fbf429449b,2011,,,2,BB McCullum,DPMD Jayawardene,49,42,7,1,1,23,19,2,1,24,23,5,0
6480bb980b5b26e8c4335a4b,2022,,,2,AT Rayudu,RD Gaikwad,49,33,5,2,1,32,19,3,2,17,14,2,0
6480bb950ced01a335bd7833,2019,,,1,PA Patel,V Kohli,49,39,7,0,1,23,14,4,0,23,25,3,0
6480bb95945c5e5dc4d8c7d6,2019,,,2,AB de Villiers,V Kohli,49,41,1,2,1,25,21,0,2,23,20,1,0
6480bb947b065b9dc0256f0d,2018,,,1,BA Stokes,SV Samson,49,33,2,3,1,27,21,2,1,20,12,0,2
6480bb94566b0cf89fca84f9,2018,,,2,KS Williamson,Shakib Al Hasan,49,37,3,2,1,25,18,1,1,24,19,2,1
6480bb94738952e740c68749,2018,,,1,MK Pandey,YK Pathan,49,36,3,2,1,25,17,2,1,21,19,1,1
6480bb9b9614f21d90333e15,2007/08,,,2,NK Patel,SR Watson,49,37,5,1,1,33,22,5,0,15,15,0,1
6480bb957ae1619e0d648dec,2019,,,1,DA Warner,V Shankar,49,54,3,0,1,20,27,1,0,26,27,2,0
6480bba1c0aa361f3c6e454c,2015,,,1,AT Rayudu,KA Pollard,49,28,3,3,1,29,16,1,3,19,12,2,0
6480bba1d21281c7385d5ce4,2014,,,1,AB de Villiers,MA Starc,49,28,2,4,1,34,16,0,4,13,12,2,0
6480bba03a099a1a2e9c3dc5,2013,,,2,DPMD Jayawardene,V Sehwag,49,40,6,0,1,9,18,0,0,30,22,6,0
6480bb9ee779ef1e445d0506,2012,,,1,JEC Franklin,KD Karthik,49,53,5,1,1,15,21,1,0,32,32,4,1
6480bb9ef7c6084992b7cdf8,2012,,,1,IK Pathan,KP Pietersen,49,30,2,4,1,5,11,0,0,42,19,2,4
6480bb9809c62ba77e5df472,2021,,,1,D Padikkal,V Kohli,49,32,6,0,1,21,18,2,0,22,14,4,0
6480bb96acacf3be646d300a,2020/21,,,1,KS Williamson,MK Pandey,49,33,5,1,0,11,10,1,0,33,23,4,1
6480bb9d91920239b62f48ad,2009/10,,,2,AM Nayar,JP Duminy,49,23,4,3,0,9,7,1,0,40,16,3,3
6480bba1a6882d256a926a8b,2014,,,1,AM Rahane,KK Cooper,49,29,3,3,1,11,13,1,0,32,16,2,3
6480bba3b818a7cff6fe4f89,2016,,,1,DJ Hooda,Yuvraj Singh,49,36,4,3,1,21,13,0,2,28,23,4,1
6480bb9866dd8ba9b48863c2,2022,,,1,F du Plessis,KD Karthik,49,27,4,1,1,35,19,4,0,13,8,0,1
6480bba16e510ff78ef635a1,2014,,,2,BJ Hodge,JP Faulkner,49,26,1,4,1,24,14,1,1,23,12,0,3
6480bb974e2f8e7f41c506dc,2021,,,2,Q de Kock,RG Sharma,49,36,2,3,1,29,19,2,2,14,17,0,1
6480bb9ac9149c73fdf073b3,2023,,,2,DA Warner,YV Dhull,49,36,3,2,1,35,21,2,2,13,15,1,0
6480bb96902b7c96b94f406a,2019,,,1,CA Lynn,Shubman Gill,49,38,2,4,1,38,22,2,4,9,16,0,0
6480bba16796f9a72374865f,2015,,,1,SA Yadav,YK Pathan,49,25,2,5,0,34,13,1,4,14,12,1,1
6480bb942fc9529eb2869c17,2018,,,1,C de Grandhomme,Mandeep Singh,49,24,2,3,1,11,7,1,0,32,17,1,3
6480bb9ba9d43057d652a5fe,2009,,,2,AM Nayar,JP Duminy,49,47,3,0,1,15,15,1,0,29,32,2,0
6480bb945f95e767a8a9cc10,2017,,,1,BA Stokes,DT Christian,49,22,3,3,0,31,14,2,2,17,8,1,1
6480bb9b09e6c98206422ae5,2009,,,1,SC Ganguly,Yashpal Singh,49,30,4,2,1,27,12,1,2,20,18,3,0
6480bb9774dd8e44bbeeb5a4,2021,,,2,S Dhawan,SPD Smith,48,41,1,1,1,23,19,0,1,24,22,1,0
6480bb9718a9b89de407178b,2021,,,2,S Dhawan,SPD Smith,48,33,4,1,1,38,21,4,1,9,12,0,0
6480bb9f2305d07e3c65be11,2013,,,1,GH Vihari,PA Reddy,48,43,5,0,1,29,26,3,0,19,17,2,0
6480bba1f5d65d6146678a7f,2015,,,2,G Gambhir,SA Yadav,48,32,5,1,1,22,16,3,0,24,16,2,1
6480bb993e44f97eccb361fe,2023,,,1,KH Pandya,KL Rahul,48,35,5,0,1,18,17,2,0,24,18,3,0
6480bb9b166300b6298fc71a,2009,,,1,IK Pathan,Yuvraj Singh,48,35,4,1,1,19,17,2,0,21,18,2,1
6480bb987b6845947f7ca137,2022,,,1,JC Buttler,SV Samson,48,39,6,1,1,17,17,2,0,28,22,4,1
6480bb981b01a21305fd65d5,2022,,,2,LS Livingstone,S Dhawan,48,24,3,3,0,30,10,2,3,11,14,1,0
6480bb9ce7891d47a7fe9c12,2009/10,,,1,NV Ojha,YK Pathan,48,34,2,3,0,23,21,2,1,21,13,0,2
6480bb95f214d4f82ab97ee5,2018,,,2,CA Lynn,KD Karthik,48,42,6,0,1,23,22,3,0,25,20,3,0
6480bb9fe3bc767415c60bfa,2012,,,2,BB McCullum,G Gambhir,48,35,5,2,1,14,19,2,0,32,16,3,2
6480bb9d867c041656e9a75f,2009/10,,,1,A Nehra,PD Collingwood,48,30,2,3,0,22,16,2,1,23,14,0,2
6480bba26bb69626041c4ba1,2015,,,1,CH Gayle,V Kohli,48,23,2,5,1,21,9,0,3,24,14,2,2
6480bba2e8614b1263627c1b,2015,,,2,DA Warner,S Dhawan,48,27,8,0,1,24,18,5,0,15,9,3,0
6480bb9ce544a2fc17a48bee,2009,,,1,LRPL Taylor,R Dravid,48,28,4,2,1,35,16,3,2,12,12,1,0
6480bba1670ace74604a420f,2015,,,2,JA Morkel,KM Jadhav,48,49,5,0,1,27,29,3,0,20,20,2,0
6480bb9808d6857eeb335d94,2022,,,1,N Rana,SS Iyer,48,34,4,1,1,21,14,1,1,25,20,3,0
6480bb99d2bd76016d47896d,2023,,,1,KH Pandya,N Pooran,48,26,2,4,1,9,5,0,1,36,21,2,3
6480bb9871b0ff7264721cbc,2022,,,1,DA Warner,RR Pant,48,29,3,4,1,20,13,2,1,26,16,1,3
6480bb9442c4889bcbb4a784,2017,,,2,RA Tripathi,SPD Smith,48,20,5,3,1,33,11,5,2,9,9,0,1
6480bb99409885bcc7b67109,2023,,,1,D Padikkal,Dhruv Jurel,48,20,6,2,1,20,11,4,0,26,9,2,2
6480bb985efffbcafdef9f19,2021,,,1,LS Livingstone,YBK Jaiswal,48,28,4,2,1,25,17,2,1,19,11,2,1
6480bb9d76ba2d9dd45c74a8,2011,,,2,PA Patel,RA Jadeja,48,47,3,0,1,26,24,1,0,22,23,2,0
6480bb958c7b985a2b586a02,2018,,,1,F du Plessis,SR Watson,48,31,7,2,1,27,15,4,1,21,16,3,1
6480bb963c729ccbcb9446f8,2020/21,,,1,RA Tripathi,Shubman Gill,48,36,6,1,1,23,16,2,1,25,20,4,0
6480bba28257fe87dd859e3e,2015,,,1,DA Miller,M Vijay,48,44,1,2,1,24,23,1,1,21,21,0,1
6480bb9442c4889bcbb4a784,2017,,,1,C de Grandhomme,MK Pandey,48,30,5,2,1,23,10,1,2,25,20,4,0
6480bb97668d35800fa74139,2021,,,2,JM Bairstow,KS Williamson,48,51,1,1,0,31,32,1,1,16,19,0,0
6480bb9f9eae77e599a46300,2012,,,2,CH Gayle,TM Dilshan,48,51,6,1,1,27,26,3,1,19,25,3,0
6480bb9c6f1c8ea3dc73226f,2009/10,,,2,SR Tendulkar,SS Tiwary,48,26,4,1,1,18,13,2,0,23,13,2,1
6480bb94a0422f6d0abe276b,2017,,,2,KK Nair,SV Samson,48,29,7,1,1,15,17,3,0,27,12,4,1
6480bb97aa725a640d0f8e2f,2021,,,2,D Padikkal,V Kohli,48,32,8,0,1,22,17,4,0,20,15,4,0
6480bb9edbd8851db7e06741,2012,,,1,AL Menaria,AM Rahane,48,37,3,2,1,22,20,1,1,26,17,2,1
6480bb95fa6394e733c532a9,2018,,,1,KS Williamson,S Dhawan,48,25,1,3,1,36,17,1,3,12,8,0,0
6480bb9f54d17f50da495682,2012,,,2,Y Nagar,Y Venugopal Rao,48,48,0,2,1,19,24,0,0,27,24,0,2
6480bba07e219ed95b7b06df,2013,,,1,UBT Chand,V Sehwag,48,35,4,2,1,17,17,2,0,26,18,2,2
6480bb9a87f64c1a12f62ece,2007/08,,,2,AM Nayar,Harbhajan Singh,48,20,4,4,1,20,6,3,1,28,14,1,3
6480bba18e95c84faca0bdb6,2015,,,1,JP Duminy,SS Iyer,48,38,2,3,1,12,15,0,0,33,23,2,3
6480bb9e5ad1f3182858e7c9,2012,,,2,Mandeep Singh,N Saini,48,38,8,0,1,18,13,3,0,30,25,5,0
6480bb9a36f2ab9a44baa0f8,2023,,,2,HH Pandya,WP Saha,48,25,3,3,0,39,15,3,3,9,10,0,0
6480bb94ee669473878c11c2,2017,,,1,G Gambhir,SP Narine,48,22,6,2,1,14,11,1,1,28,11,5,1
6480bb9797043717cd96890a,2021,,,2,Abhishek Sharma,KS Williamson,48,33,4,1,0,21,16,1,1,21,17,3,0
6480bba27b4786f36f706f8e,2016,,,2,AM Rahane,KP Pietersen,48,30,1,4,0,26,16,1,2,21,14,0,2
6480bb9ef7c6084992b7cdf8,2012,,,1,KP Pietersen,Y Nagar,48,27,3,3,0,25,12,0,3,23,15,3,0
6480bb99b4febfb641fddd39,2023,,,1,Arshad Khan,Tilak Varma,48,18,4,2,0,15,9,0,1,25,9,4,1
6480bb99537b54b870dc74d1,2023,,,2,Shubman Gill,WP Saha,48,28,8,0,1,17,9,3,0,30,19,5,0
6480bb9e1751fd9db64a2834,2011,,,1,RG Sharma,SR Tendulkar,48,45,5,0,1,25,20,3,0,23,25,2,0
6480bb9cf1471ad233c7b0af,2009,,,1,AB de Villiers,KD Karthik,48,21,3,2,0,24,10,2,1,23,11,1,1
6480bb9698a1d9136a13faf6,2020/21,,,1,KL Rahul,MA Agarwal,48,32,7,1,1,22,17,2,1,26,15,5,0
6480bb987c52e15a2cac0697,2022,,,2,Abhishek Sharma,RA Tripathi,48,31,5,1,1,9,9,1,0,34,22,4,1
6480bb9ec90f99c5ea40b014,2012,,,1,JH Kallis,MS Bisla,48,41,5,0,1,21,25,2,0,20,16,3,0
6480bb9c13817091131f76e3,2009/10,,,2,Bipul Sharma,IK Pathan,48,18,4,3,1,8,6,1,0,36,12,3,3
6480bb951354c40599b60208,2018,,,2,AT Rayudu,SR Watson,48,30,6,2,0,16,19,1,1,30,11,5,1
6480bb9ec0a4e3f137edb047,2011,,,1,LA Pomersbach,V Kohli,48,29,3,3,1,29,18,2,2,18,11,1,1
6480bb984f6c41cd28aa0353,2022,,,2,N Pooran,Washington Sundar,48,26,4,2,1,31,15,3,2,16,11,1,0
6480bb953aab41e7ed166b9d,2019,,,1,R Tewatia,RR Pant,48,16,2,5,0,9,4,0,1,37,12,2,4
6480bb9932735ca83d38f6e7,2022,,,1,AM Rahane,N Rana,48,33,1,5,1,21,17,0,2,26,16,1,3
6480bb970d7cbd85b6ada680,2021,,,2,HV Patel,KA Jamieson,48,23,4,3,1,31,13,3,2,15,10,1,1
6480bb9c968c81bdfcc6df5b,2009,,,1,AB de Villiers,TM Dilshan,48,39,1,2,1,26,21,0,2,21,18,1,0
6480bb95f282ca61c07afe9b,2018,,,2,DJ Bravo,MS Dhoni,48,35,1,4,0,14,17,0,1,31,18,1,3
6480bb97372fc5d5ef4c436a,2021,,,2,DA Miller,R Tewatia,48,33,7,0,1,28,16,5,0,19,17,2,0
6480bb973e3a3dbbb7ae3707,2020/21,,,1,S Dhawan,SS Iyer,48,31,6,1,1,34,19,6,0,14,12,0,1
6480bb9b8860198955e581d8,2007/08,,,2,IK Pathan,PP Chawla,48,27,2,4,1,30,13,1,3,17,14,1,1
6480bb9e156723e64d6bd26b,2012,,,2,AT Rayudu,RG Sharma,48,44,4,1,1,19,24,1,0,27,20,3,1
6480bb95cf9d446747bd74fe,2019,,,2,KM Jadhav,MS Dhoni,48,54,2,1,1,13,19,0,0,32,35,2,1
6480bb9a2b33e06f46eed54f,2023,,,1,N Rana,VR Iyer,48,37,2,2,1,22,17,2,0,24,20,0,2
6480bba0d2cdb40c68c4739c,2013,,,2,AT Rayudu,KA Pollard,48,34,5,1,1,15,15,1,0,32,19,4,1
6480bba286cca051953c976a,2015,,,1,MS Dhoni,RA Jadeja,48,28,4,1,0,29,17,2,1,18,11,2,0
6480bb996c5ae75a32d978e8,2022,,,1,N Jagadeesan,RD Gaikwad,48,44,4,1,1,30,22,3,1,18,22,1,0
6480bb95816d3ad3bc382ab6,2018,,,1,H Klaasen,RA Tripathi,48,34,3,2,1,32,21,3,1,15,13,0,1
6480bb95c28e7980e1768064,2018,,,2,BA Stokes,JC Buttler,48,24,8,2,1,11,7,1,1,37,17,7,1
6480bb9cafc843037dc1e863,2009,,,2,AM Rahane,ST Jayasuriya,48,39,3,1,1,18,18,0,1,25,21,3,0
6480bb9b8cc888fe3f01f2a4,2009,,,2,BJ Hodge,MN van Wyk,48,24,6,1,0,28,12,5,0,18,12,1,1
6480bb966539f85263cb6429,2019,,,2,S Dhawan,SS Iyer,48,28,4,2,1,19,13,1,1,29,15,3,1
6480bb99695e001cdaca81e0,2022,,,2,HR Shokeen,Tilak Varma,48,47,6,0,1,18,23,2,0,27,24,4,0
6480bb9d02d996f85dd5e945,2011,,,2,S Badrinath,SK Raina,48,36,4,0,1,19,17,1,0,29,19,3,0
6480bba048fb3d33ea0711e7,2013,,,2,NLTC Perera,PA Patel,48,25,3,3,1,27,16,1,2,21,9,2,1
6480bb9ade063258af41163b,2007/08,,,1,DJ Hussey,SC Ganguly,47,53,1,1,1,14,26,0,1,13,27,1,0
6480bb98d8f59b81335f4a3d,2021,,,2,AT Rayudu,MM Ali,47,30,1,3,1,22,16,1,1,23,14,0,2
6480bb9fc28e897b3c53f359,2012,,,2,DR Smith,SR Tendulkar,47,30,6,2,1,33,19,4,2,11,11,2,0
6480bb9ab49fc97bbb30576f,2023,,,1,MG Bracewell,V Kohli,47,29,7,0,1,26,16,5,0,18,13,2,0
6480bba1dd2f8125fc8b203f,2014,,,1,CM Gautam,RG Sharma,47,41,3,3,1,25,21,1,2,20,20,2,1
6480bb961570df6942a00888,2019,,,1,MK Pandey,V Shankar,47,33,2,2,1,20,13,0,1,26,20,2,1
6480bb9359a2cade3b5213d3,2017,,,1,AB de Villiers,V Kohli,47,37,2,2,1,18,19,0,1,25,18,2,1
6480bb980cc3d01eab3a4748,2022,,,2,PBB Rajapaksa,S Dhawan,47,25,2,4,1,33,15,2,3,14,10,0,1
6480bb9a77f349a0fd8d96d6,2023,,,2,SO Hetmyer,YBK Jaiswal,47,22,4,3,1,28,14,1,3,15,8,3,0
6480bba234aac105851964b1,2015,,,1,MEK Hussey,MS Dhoni,47,41,2,2,1,36,24,2,2,11,17,0,0
6480bb99d43295fa2d82c9dc,2023,,,1,MK Lomror,V Kohli,47,33,3,2,1,15,11,0,1,31,22,3,1
6480bb9d918bd358d046889d,2011,,,1,JR Hopes,Y Venugopal Rao,47,35,4,1,1,19,14,2,0,24,21,2,1
6480bba2e680f2464af841ae,2015,,,1,JP Duminy,Q de Kock,47,34,6,1,1,9,12,0,0,37,22,6,1
6480bb9ca181f55cb21526f5,2009/10,,,1,KA Pollard,R Sathish,47,37,4,1,1,21,19,1,1,23,18,3,0
6480bba03a099a1a2e9c3dc5,2013,,,1,DA Miller,R Sathish,47,21,3,4,1,25,8,1,3,22,13,2,1
6480bb95085c25712f29bd36,2019,,,1,AB de Villiers,PA Patel,47,26,3,4,1,25,19,3,1,21,7,0,3
6480bb98960cf9374ee9420d,2022,,,1,A Badoni,KL Rahul,47,25,5,2,1,14,11,0,1,32,14,5,1
6480bb98b00f767943bb8415,2022,,,1,JC Buttler,SV Samson,47,23,4,3,1,17,9,1,1,29,14,3,2
6480bb97951f1bc43b462c46,2021,,,1,F du Plessis,RD Gaikwad,47,41,5,1,1,25,19,2,1,22,22,3,0
6480bb965f597c872396f67c,2020/21,,,2,KL Rahul,Mandeep Singh,47,48,5,1,1,28,25,4,0,19,23,1,1
6480bb9f90a251567178de39,2012,,,2,PA Patel,S Dhawan,47,36,4,1,1,18,16,2,0,26,20,2,1
6480bb9f7bae5ad85c4473ba,2012,,,2,F du Plessis,M Vijay,47,32,3,3,1,9,11,0,0,36,21,3,3
6480bb9f23c17ccb47aa9e58,2013,,,1,AM Rahane,SV Samson,47,39,5,0,0,20,16,2,0,27,23,3,0
6480bb97746881ab34c38bf8,2020/21,,,1,AB de Villiers,S Dube,47,17,2,5,0,19,7,1,2,27,10,1,3
6480bb9a6e44b0c8da00ca72,2007/08,,,2,DJ Bravo,RV Uthappa,47,37,6,1,1,23,21,4,0,21,16,2,1
6480bb9574ca455ec008e942,2018,,,2,CA Lynn,N Rana,47,31,4,3,1,25,15,3,1,22,16,1,2
6480bb9c757dbd7f92b1130a,2009/10,,,1,HH Gibbs,MD Mishra,47,27,4,3,1,27,16,3,2,13,11,1,1
6480bb98323919fff9902666,2022,,,1,JM Bairstow,S Dhawan,47,31,7,1,1,31,15,5,1,12,16,2,0
6480bb9439fcd1191cf17a90,2017,,,2,GJ Maxwell,HM Amla,47,28,3,3,1,27,16,0,3,20,12,3,0
6480bb94605dacb25c83dc35,2018,,,2,R Tewatia,SS Iyer,47,36,2,1,1,24,21,1,1,18,15,1,0
6480bb993e61058e682e2ff4,2023,,,2,Dhruv Jurel,SO Hetmyer,47,20,3,4,1,18,10,2,1,28,10,1,3
6480bba154ce29a67e4752df,2015,,,2,LMP Simmons,PA Patel,47,35,8,0,1,27,22,6,0,12,13,2,0
6480bb947a7076697fc0b339,2017,,,1,AM Rahane,SPD Smith,47,34,6,0,1,22,17,3,0,25,17,3,0
6480bb9516b0dbc1972e5c3c,2018,,,2,AM Rahane,RA Tripathi,47,31,4,3,1,26,18,3,1,20,13,1,2
6480bb93f866249511c76dbc,2017,,,2,Ankit Sharma,MK Tiwary,47,29,3,2,1,25,15,2,1,20,14,1,1
6480bb9f02801d2090cdba0d,2012,,,1,M Manhas,SC Ganguly,47,43,5,0,1,31,26,4,0,13,17,1,0
6480bb97fb920d483d0da2af,2020/21,,,2,GJ Maxwell,N Pooran,47,26,2,4,1,7,12,0,0,39,14,2,4
6480bb9ea75f51e7a33e90ed,2012,,,1,F du Plessis,S Badrinath,47,33,6,2,1,29,20,3,2,18,13,3,0
6480bb9baccf501985a56d64,2007/08,,,2,G Gambhir,V Sehwag,47,36,6,0,1,26,16,4,0,17,20,2,0
6480bb979e91d1ff9b54c737,2020/21,,,2,Ishan Kishan,RG Sharma,47,33,5,1,1,26,15,2,1,21,18,3,0
6480bb99349f00f851e8d2fd,2023,,,1,Atharva Taide,P Simran Singh,47,25,3,3,1,24,13,2,1,21,12,1,2
6480bb9c1e676472f4841aa9,2009/10,,,1,RV Uthappa,V Kohli,47,36,4,1,1,19,20,2,0,24,16,2,1
6480bb95b98d000799e11963,2018,,,2,AD Hales,S Dhawan,47,31,1,5,1,29,16,1,3,18,15,0,2
6480bb9faf20f0bc714af2ea,2013,,,1,G Gambhir,JH Kallis,47,34,8,1,1,23,14,3,1,23,20,5,0
6480bb9d9f4551d7ec79c951,2009/10,,,2,JA Morkel,MS Dhoni,47,19,5,2,0,14,8,2,0,32,11,3,2
6480bb99433f6e11060ba714,2022,,,1,Lalit Yadav,MR Marsh,47,38,2,2,1,24,21,1,1,22,17,1,1
6480bb9936b7698da2c2030c,2023,,,1,JC Buttler,R Ashwin,47,37,1,2,1,14,15,0,0,30,22,1,2
6480bba09d1874eb9ded0204,2013,,,1,AM Rahane,SR Watson,47,25,4,2,0,19,11,1,1,28,14,3,1
6480bb9e5ab10d1241d6509d,2012,,,2,MN Samuels,SPD Smith,47,29,1,3,1,30,15,1,2,16,14,0,1
6480bba16e510ff78ef635a1,2014,,,1,CJ Anderson,RG Sharma,47,26,3,3,1,28,15,2,2,16,11,1,1
6480bb9da3dc1406b000cc98,2011,,,2,AJ Finch,Y Venugopal Rao,47,25,1,4,1,25,12,1,2,20,13,0,2
6480bb9c0dec1a788da66d33,2009/10,,,1,MJ Lumb,NV Ojha,47,24,6,2,1,30,16,3,2,14,8,3,0
6480bb99cbb648c5c0ecb205,2023,,,1,RK Singh,Rahmanullah Gurbaz,47,28,1,4,1,17,17,0,1,29,11,1,3
6480bb9db9ed29ce1ee8764f,2011,,,1,NV Ojha,Y Venugopal Rao,47,18,4,3,0,19,8,1,2,23,10,3,1
6480bba264ad6b873d0d07d8,2016,,,1,BB McCullum,DR Smith,47,33,5,2,1,13,12,2,0,32,21,3,2
6480bb9448fe25ec89c5fcff,2017,,,2,AR Patel,WP Saha,47,28,2,2,0,19,13,0,1,26,15,2,1
6480bb96902b7c96b94f406a,2019,,,1,N Rana,RV Uthappa,47,27,1,5,1,26,13,0,3,20,14,1,2
6480bb95c8ecc2185a67f4fd,2019,,,2,KS Williamson,V Shankar,47,22,3,3,1,13,9,2,0,34,13,1,3
6480bba2e3610f863b52b887,2016,,,1,NV Ojha,S Dhawan,47,51,1,1,1,18,21,0,1,28,30,1,0
6480bb949f5853dfe76c99d9,2017,,,2,DJ Hooda,MC Henriques,47,21,6,2,0,19,10,2,1,27,11,4,1
6480bb9a7f7a862ba0b2c59e,2007/08,,,2,RG Sharma,SB Styris,47,38,4,2,1,23,17,2,1,23,21,2,1
6480bb99773871f8e2ddc4b1,2022,,,1,Abhishek Sharma,RA Tripathi,47,35,4,2,1,26,17,3,1,20,18,1,1
6480bb9d038ed22e46cbeccb,2011,,,2,DJ Jacobs,SR Tendulkar,47,31,7,1,1,32,20,5,1,15,11,2,0
6480bb99b35dc0981e512451,2022,,,2,DA Miller,Shubman Gill,47,29,3,2,0,32,19,3,1,14,10,0,1
6480bb9c9e328ac30bcaf6b0,2009/10,,,2,S Dhawan,SR Tendulkar,46,37,7,0,1,16,18,2,0,28,19,5,0
6480bba265483f7db002ec7c,2015,,,2,DA Warner,GH Vihari,46,25,9,1,1,36,17,7,1,9,8,2,0
6480bba1448ab5c40ac64696,2014,,,1,MK Pandey,RV Uthappa,46,41,4,0,1,14,21,0,0,31,20,4,0
6480bb96267b63eb2c6747b0,2019,,,1,AR Patel,SE Rutherford,46,19,4,3,0,16,9,3,0,26,10,1,3
6480bb9a1032ce724214f6dd,2007/08,,,1,ST Jayasuriya,YV Takawale,46,34,7,1,1,30,14,5,1,14,20,2,0
6480bb9bd918d2e963f0218a,2009,,,2,AC Gilchrist,HH Gibbs,46,23,6,2,1,27,16,5,1,13,7,1,1
6480bba17bce347084729c56,2015,,,2,DA Miller,GJ Bailey,46,31,4,1,1,16,13,2,0,30,18,2,1
6480bb98323919fff9902666,2022,,,2,JC Buttler,YBK Jaiswal,46,24,7,2,1,30,16,5,1,16,8,2,1
6480bb931ee18ac840f40603,2017,,,1,HM Amla,SE Marsh,46,35,6,1,1,19,14,1,1,26,21,5,0
6480bb96ebf33df82879ad4c,2020/21,,,1,DA Warner,MK Pandey,46,39,6,0,1,14,18,1,0,29,21,5,0
6480bb96d1b3bea0aa2127e4,2020/21,,,2,KD Karthik,N Rana,46,32,5,1,1,21,15,3,0,24,17,2,1
6480bb9f68a0a232d83c338c,2012,,,1,MA Agarwal,TM Dilshan,46,36,4,1,1,28,20,3,1,12,16,1,0
6480bba0fbf5f1671e1e557e,2013,,,2,AB de Villiers,MC Henriques,46,19,5,3,0,30,12,3,2,16,7,2,1
6480bb9be7cbbb90a12dc916,2009,,,2,AM Nayar,SR Tendulkar,46,22,3,3,1,35,14,2,3,10,8,1,0
6480bb99409885bcc7b67109,2023,,,2,RA Jadeja,S Dube,46,31,5,1,1,23,15,3,0,23,16,2,1
6480bb9523e6dc3c988ce398,2019,,,2,N Rana,RV Uthappa,46,41,7,0,1,31,22,6,0,8,19,1,0
6480bb9e8dfd9ba30b93cbd8,2012,,,2,DJ Bravo,JA Morkel,46,17,0,5,0,39,14,0,5,2,3,0,0
6480bba0c3cc8c51bc6c1c3a,2013,,,1,BJ Hodge,SR Watson,46,25,1,3,1,29,15,1,2,16,10,0,1
6480bb9f00ef088221497043,2013,,,1,G Gambhir,YK Pathan,46,35,8,0,1,25,19,5,0,18,16,3,0
6480bb9f9a70ecf3467829df,2013,,,2,SR Watson,STR Binny,46,26,2,2,1,22,13,0,2,20,13,2,0
6480bb961ee814aee7b674ac,2020/21,,,2,K Gowtham,MA Agarwal,46,33,3,2,1,20,14,1,1,25,19,2,1
6480bba2f05e90a9005771d2,2015,,,2,F du Plessis,MS Dhoni,46,30,5,0,1,24,15,3,0,20,15,2,0
6480bb958e752648ab95362b,2019,,,2,AT Rayudu,F du Plessis,46,59,3,0,1,21,31,2,0,24,28,1,0
6480bb9eb35365cccf73d55c,2011,,,2,G Gambhir,MK Tiwary,46,41,4,1,1,20,17,3,0,24,24,1,1
6480bb9fd26b695cee9d8761,2013,,,1,AJ Finch,LRPL Taylor,46,43,3,2,1,27,23,3,1,17,20,0,1
6480bba31cc11024436836b5,2016,,,1,MJ Guptill,RG Sharma,46,39,1,4,1,15,18,0,1,31,21,1,3
6480bb97372fc5d5ef4c436a,2021,,,2,CH Morris,JD Unadkat,46,23,0,5,0,35,16,0,4,11,7,0,1
6480bb9772f78629131db057,2021,,,2,KL Rahul,MA Agarwal,46,27,6,2,1,33,15,4,2,12,12,2,0
6480bb9553f3fc8903579544,2018,,,1,E Lewis,SA Yadav,46,34,7,1,1,18,13,3,0,28,21,4,1
6480bb965aa0867bce4e79b3,2019,,,2,Mandeep Singh,N Pooran,46,24,2,3,1,8,6,0,0,33,18,2,3
6480bb939c56810fd88e895b,2017,,,2,AB de Villiers,Mandeep Singh,46,49,2,1,1,17,15,1,0,28,34,1,1
6480bb94283e3f5a1a95839f,2018,,,1,MS Dhoni,SK Raina,46,35,5,1,1,26,21,3,1,16,14,2,0
6480bb9a8053274c083224d9,2023,,,2,DP Conway,RD Gaikwad,46,26,7,2,1,14,10,3,0,30,16,4,2
6480bba18a431be2cc738de0,2014,,,1,JP Duminy,KM Jadhav,46,25,5,2,1,28,14,4,1,17,11,1,1
6480bb9d03ce4b87b32b91f5,2009/10,,,1,A Symonds,TL Suman,46,32,2,3,1,10,12,0,1,34,20,2,2
6480bb99f2a793884331579e,2023,,,1,Rahmanullah Gurbaz,VR Iyer,46,22,2,4,1,3,6,0,0,39,16,2,4
6480bb964c4bea88164f168d,2020/21,,,1,N Rana,Shubman Gill,46,31,5,1,1,22,17,2,1,23,14,3,0
6480bb9618b5973b98c0ba18,2019,,,1,MJ Guptill,WP Saha,46,27,5,2,1,25,16,1,2,20,11,4,0
6480bb9c9f9d5376b4227724,2009/10,,,2,HH Gibbs,MD Mishra,46,35,7,0,1,15,19,1,0,29,16,6,0
6480bba3412663673a969a24,2016,,,1,SR Watson,V Kohli,46,21,6,2,1,36,13,5,2,9,8,1,0
6480bb954da239b357833c8a,2018,,,2,KS Williamson,MK Pandey,46,37,2,1,1,24,20,0,1,21,17,2,0
6480bba19e29de4f208211ac,2014,,,1,AT Rayudu,CM Gautam,46,29,2,3,1,9,9,1,0,24,20,1,3
6480bb9ec0a4e3f137edb047,2011,,,2,JA Morkel,SK Raina,46,18,1,5,0,28,10,1,3,17,8,0,2
6480bb987c720def5fbaf218,2022,,,1,JM Sharma,M Shahrukh Khan,46,16,2,4,1,27,10,2,2,15,6,0,2
6480bb99af95c6c90c4c3924,2023,,,1,C Green,Ishan Kishan,46,39,2,2,1,20,18,0,1,26,21,2,1
6480bb9da398a7c3c645732c,2011,,,2,MK Pandey,RV Uthappa,46,32,8,0,1,11,11,1,0,35,21,7,0
6480bb95a09b947e0837a38a,2019,,,1,KL Rahul,Mandeep Singh,46,15,3,4,0,36,12,2,4,7,3,1,0
6480bb991a4f7e5f59dd1afc,2023,,,1,HC Brook,MA Agarwal,46,25,4,2,1,32,12,4,2,9,13,0,0
6480bb9a81d7fd0ac0307b4d,2023,,,2,KH Pandya,MP Stoinis,46,30,6,1,1,8,10,1,0,36,20,5,1
6480bb9c9e328ac30bcaf6b0,2009/10,,,1,MEK Hussey,S Badrinath,46,37,4,0,0,14,15,0,0,30,22,4,0
6480bb95c28e7980e1768064,2018,,,2,JC Buttler,SV Samson,46,40,4,0,1,23,18,2,0,21,22,2,0
6480bb971ffe5345804e7f32,2020/21,,,2,BA Stokes,SV Samson,46,38,3,2,1,24,24,3,0,22,14,0,2
6480bb97d5e3b0911408f222,2020/21,,,2,F du Plessis,RD Gaikwad,46,31,3,3,1,25,13,2,2,21,18,1,1
6480bb947a7c9fe868fc901a,2017,,,1,RR Pant,SS Iyer,46,39,3,1,1,23,17,1,1,22,22,2,0
6480bb94f06c6048c8088194,2018,,,1,AM Rahane,SV Samson,46,35,6,0,1,12,11,2,0,31,24,4,0
6480bba26c6e47258e0c7d24,2015,,,2,JP Duminy,SS Tiwary,46,28,4,1,0,32,19,4,0,13,9,0,1
6480bba2ab35be3ffcfa932a,2016,,,2,A Ashish Reddy,EJG Morgan,46,27,4,3,1,32,18,2,3,14,9,2,0
6480bb96b56e8d513b451da1,2020/21,,,2,AJ Finch,D Padikkal,46,38,5,0,1,16,21,2,0,25,17,3,0
6480bb9f5867d07199aa832a,2013,,,1,RA Jadeja,S Badrinath,46,38,4,0,1,19,18,1,0,27,20,3,0
6480bba3de527604cd2f96f3,2016,,,2,DA Warner,S Dhawan,46,36,8,0,1,36,28,6,0,10,8,2,0
6480bb9772f78629131db057,2021,,,2,AK Markram,KL Rahul,46,19,0,4,1,13,8,0,1,29,11,0,3
6480bb96ed06a5693a66b9f0,2020/21,,,1,R Tewatia,SPD Smith,46,25,5,1,1,18,10,1,1,25,15,4,0
6480bb950c59218964b27cc0,2018,,,2,KL Rahul,MP Stoinis,46,34,5,0,1,35,18,5,0,11,16,0,0
6480bb96902b7c96b94f406a,2019,,,2,Q de Kock,RG Sharma,46,38,3,3,1,30,23,1,3,14,15,2,0
6480bba250b404cdcbff22c8,2015,,,1,F du Plessis,MEK Hussey,46,27,5,2,1,28,16,4,1,16,11,1,1
6480bb96c95abb10156a6055,2020/21,,,1,Q de Kock,RG Sharma,46,28,7,0,1,32,18,5,0,12,10,2,0
6480bb9c8cbb5dec60b7d50a,2009/10,,,1,MJ Lumb,YK Pathan,46,29,2,3,1,8,10,0,0,36,19,2,3
6480bb95fbd4f1b7f3d8dfc0,2019,,,2,AB de Villiers,MP Stoinis,46,23,4,2,0,18,7,0,2,28,16,4,0
6480bba35038a60ea566794a,2016,,,2,Bipul Sharma,DA Warner,46,21,3,3,0,27,11,0,3,19,10,3,0
6480bb978c66ea3d9c85132d,2020/21,,,2,JO Holder,KS Williamson,46,40,2,3,1,11,15,1,0,34,25,1,3
6480bb99af95c6c90c4c3924,2023,,,2,AK Markram,MA Agarwal,46,30,3,2,1,22,17,1,1,23,13,2,1
6480bb9ce93a7b4315d8fa30,2009,,,1,AC Gilchrist,DB Ravi Teja,46,39,0,4,1,35,21,0,4,9,18,0,0
6480bb9b2a5f2fd5053534dc,2007/08,,,1,AM Nayar,SR Tendulkar,46,28,4,2,1,27,18,1,2,18,10,3,0
6480bb99f816e64203e3c687,2023,,,2,N Rana,VR Iyer,46,30,6,1,1,24,17,3,1,19,13,3,0
6480bba18e95c84faca0bdb6,2015,,,1,AD Mathews,JP Duminy,46,21,3,3,0,27,14,3,1,17,7,0,2
6480bb9dc4ec5a52f8bcc465,2009/10,,,1,AB Barath,KC Sangakkara,46,34,7,0,1,24,18,4,0,21,16,3,0
6480bb9efe3f9991539e7f6c,2012,,,1,PP Chawla,SE Marsh,46,36,4,1,0,21,24,3,0,25,12,1,1
6480bba3b818a7cff6fe4f89,2016,,,2,MK Pandey,SA Yadav,46,30,2,2,1,23,15,1,1,23,15,1,1
6480bb9fcbbfd8053f253537,2012,,,1,DPMD Jayawardene,LRPL Taylor,46,42,3,1,1,27,21,3,1,13,21,0,0
6480bb95ea40317152ed9ca5,2018,,,2,AT Rayudu,SR Watson,46,41,2,4,1,31,18,2,3,14,23,0,1
6480bba3e9fa951efcfc8bfb,2016,,,1,GJ Maxwell,WP Saha,46,25,5,1,1,16,11,0,1,28,14,5,0
6480bb938ed49c6d5c211429,2017,,,2,DA Warner,S Dhawan,46,40,8,0,1,21,18,4,0,23,22,4,0
6480bb967c50ceac62ba0719,2020/21,,,2,Q de Kock,SA Yadav,46,29,4,2,1,28,18,2,2,18,11,2,0
6480bba358370ecde0231113,2016,,,2,KS Williamson,S Dhawan,46,42,2,2,1,15,21,1,0,27,21,1,2
6480bba3ebbd8e4867dfa673,2016,,,2,AM Rahane,SS Tiwary,45,32,3,1,1,20,14,2,0,21,18,1,1
6480bb99bbae76f3f761d060,2023,,,2,N Rana,VR Iyer,45,35,5,2,1,22,17,3,1,20,18,2,1
6480bb9718a9b89de407178b,2021,,,2,RR Pant,S Dhawan,45,23,4,2,1,11,11,0,1,28,12,4,1
6480bba20559f15c3489f637,2015,,,2,DA Warner,S Dhawan,45,30,8,1,1,9,7,2,0,36,23,6,1
6480bb9a1032ce724214f6dd,2007/08,,,2,Shoaib Malik,V Sehwag,45,26,3,2,1,18,14,1,0,26,12,2,2
6480bb9b8cc888fe3f01f2a4,2009,,,1,DPMD Jayawardene,IK Pathan,45,35,6,0,0,25,19,4,0,19,16,2,0
6480bb979e91d1ff9b54c737,2020/21,,,2,RG Sharma,SA Yadav,45,40,2,3,1,26,20,1,2,19,20,1,1
6480bb9c3b082d71291a593c,2009,,,2,ML Hayden,MS Dhoni,45,39,2,1,1,24,19,1,1,18,20,1,0
6480bb97752fcb9cd9f23692,2021,,,2,JC Buttler,SV Samson,45,26,8,0,1,25,13,5,0,17,13,3,0
6480bb9b82dc3ec84c520466,2009,,,2,BJ Hodge,CH Gayle,45,34,6,1,1,17,15,2,1,22,19,4,0
6480bba265483f7db002ec7c,2015,,,2,MC Henriques,NV Ojha,45,41,4,0,1,17,15,1,0,28,26,3,0
6480bb9ec90f99c5ea40b014,2012,,,2,AM Rahane,R Dravid,45,37,8,0,1,19,16,3,0,26,21,5,0
6480bb9a3d3f26063faa9f71,2007/08,,,2,CL White,MV Boucher,45,31,4,1,1,30,16,3,1,14,15,1,0
6480bba18e95c84faca0bdb6,2015,,,1,JP Duminy,Yuvraj Singh,45,33,0,3,1,15,16,0,1,27,17,0,2
6480bb95960e393c939ab44c,2018,,,2,E Lewis,Ishan Kishan,45,33,3,3,1,38,20,3,3,5,13,0,0
6480bba18e95c84faca0bdb6,2015,,,1,MA Agarwal,SS Iyer,45,28,7,1,1,37,21,6,1,7,7,1,0
6480bb9f90a251567178de39,2012,,,1,DJ Hussey,Gurkeerat Singh,45,20,4,2,0,12,8,0,1,29,12,4,1
6480bb9a61edc0c77bc4bc86,2007/08,,,1,G Gambhir,V Sehwag,45,32,6,0,1,19,14,3,0,23,18,3,0
6480bb9bdde9db92f880e40d,2007/08,,,1,SC Ganguly,Salman Butt,45,32,8,1,1,19,13,3,1,24,19,5,0
6480bba0adee98d459585bed,2014,,,1,JP Duminy,M Vijay,45,33,3,1,1,14,16,0,0,30,17,3,1
6480bba133267f04941acf7d,2014,,,2,MK Pandey,YK Pathan,45,33,4,2,1,23,16,2,1,22,17,2,1
6480bba34d78f594b07da1bc,2016,,,1,KL Rahul,V Kohli,45,15,7,1,1,5,2,1,0,37,13,6,1
6480bba063bacaa2dfabf6fd,2014,,,2,JP Duminy,MK Tiwary,45,20,3,3,0,20,7,1,2,23,13,2,1
6480bba280f09c38002cf14b,2015,,,2,M Vijay,M Vohra,45,35,5,2,1,28,21,4,1,17,14,1,1
6480bb9ea49fe0f895bf242a,2012,,,2,AL Menaria,OA Shah,45,18,3,4,1,13,6,1,1,32,12,2,3
6480bb9f36ad55c3c7fd6548,2012,,,2,MK Tiwary,Shakib Al Hasan,45,29,3,2,1,27,17,2,2,13,12,1,0
6480bba15b304732a6212cdf,2015,,,2,DA Warner,NV Ojha,45,33,0,2,1,23,22,0,1,15,11,0,1
6480bba03b6f98689b851317,2013,,,2,AC Gilchrist,Mandeep Singh,45,37,8,0,1,19,17,3,0,25,20,5,0
6480bba140ee53a14fe06e0d,2014,,,1,AT Rayudu,RG Sharma,45,34,2,1,1,24,15,1,1,19,19,1,0
6480bba37e4fcb8af147f79b,2016,,,1,AM Rahane,GJ Bailey,45,45,5,1,0,33,27,4,1,8,18,1,0
6480bb993e61058e682e2ff4,2023,,,1,A Manohar,DA Miller,45,22,1,4,1,27,13,0,3,18,9,1,1
6480bb9873e53eace3a69dc7,2022,,,2,RK Singh,VR Iyer,45,36,6,0,1,27,22,4,0,16,14,2,0
6480bb945901306d3cb2b759,2018,,,2,BA Stokes,JC Buttler,45,34,3,1,1,20,17,2,0,22,17,1,1
6480bb94b882fb725e3f98e5,2018,,,2,MK Pandey,Shakib Al Hasan,45,21,1,3,0,16,9,0,1,24,12,1,2
6480bba1551dc12c8f2a7038,2014,,,2,G Gambhir,MK Pandey,45,33,3,1,1,22,19,1,1,23,14,2,0
6480bb9e65a802582c071438,2012,,,2,AT Rayudu,RG Sharma,45,23,3,2,1,15,11,1,0,26,12,2,2
6480bb94c5d20726ee59d3d6,2017,,,2,C de Grandhomme,G Gambhir,45,35,1,2,1,30,22,1,2,12,13,0,0
6480bb9618b5973b98c0ba18,2019,,,1,KS Williamson,V Shankar,45,36,2,3,1,18,18,2,0,27,18,0,3
6480bba28724848c0f3ef034,2015,,,2,G Gambhir,RV Uthappa,45,33,6,1,1,18,13,3,0,25,20,3,1
6480bb97f56e9d700b27a098,2021,,,2,MP Stoinis,RR Pant,45,32,5,0,1,22,17,3,0,21,15,2,0
6480bb931b06a170006b4713,2017,,,1,G Gambhir,SP Narine,45,20,9,1,1,3,3,0,0,42,17,9,1
6480bba2679194b06d4834db,2016,,,1,DA Warner,DJ Hooda,45,19,3,3,0,27,10,1,3,17,9,2,0
6480bb979e91d1ff9b54c737,2020/21,,,2,Q de Kock,RG Sharma,45,25,4,3,1,20,12,3,1,21,13,1,2
6480bb9506d56930505d45ae,2019,,,1,CH Gayle,Mandeep Singh,45,31,0,4,1,29,17,0,3,16,14,0,1
6480bb933fdc96ee7273400e,2017,,,2,JC Buttler,PA Patel,45,26,6,2,1,25,12,2,2,19,14,4,0
6480bba3e9fa951efcfc8bfb,2016,,,1,M Vijay,MP Stoinis,45,34,6,0,1,25,16,4,0,16,18,2,0
6480bb9938b659481e3ab6dc,2022,,,1,JC Buttler,SO Hetmyer,45,26,8,0,1,40,19,8,0,4,7,0,0
6480bb93575636076d81e4c5,2017,,,2,M Vohra,MM Sharma,45,16,3,4,1,34,11,3,3,10,5,0,1
6480bba0a4e7c61a5656729e,2014,,,1,DA Miller,V Sehwag,45,31,5,0,1,26,20,4,0,10,11,1,0
6480bb9fc524f8142f0b3461,2012,,,2,R Dravid,SR Watson,45,27,5,2,1,10,10,1,0,35,17,4,2
6480bb946efcc4cd9aa80399,2018,,,1,BB McCullum,V Kohli,45,40,4,1,1,29,21,4,1,11,19,0,0
6480bba0f401cc6b6bc6ed10,2013,,,1,BJ Hodge,SV Samson,45,35,2,3,1,36,19,2,3,9,16,0,0
6480bba3caa5150f2db7a1dc,2016,,,2,AJ Finch,DJ Bravo,45,39,4,0,1,24,19,3,0,18,20,1,0
6480bba1d3370c13ea1f79f3,2014,,,2,JP Duminy,KM Jadhav,45,29,4,2,1,25,17,3,1,18,12,1,1
6480bb942efd740a6ffc47df,2017,,,2,AB de Villiers,TM Head,45,32,4,2,1,33,21,3,2,10,11,1,0
6480bb9fd9db46138a9bb209,2013,,,2,MA Agarwal,V Kohli,45,41,4,1,1,23,20,2,1,21,21,2,0
6480bb96b7b695186bbb6a3e,2019,,,1,Q de Kock,RG Sharma,45,29,1,5,1,29,17,0,4,15,12,1,1
6480bb9d6919e7181371271f,2011,,,1,RV Uthappa,Yuvraj Singh,45,28,3,3,0,22,13,1,2,21,15,2,1
6480bb9ff2e0b1df0c3972c9,2012,,,1,DPMD Jayawardene,IK Pathan,45,30,7,0,0,26,20,4,0,19,10,3,0
6480bba1c0aa361f3c6e454c,2015,,,1,Harbhajan Singh,RG Sharma,45,35,5,1,1,24,21,2,1,20,14,3,0
6480bb973da000031d26fbba,2021,,,2,Q de Kock,SS Tiwary,45,37,4,1,1,20,18,2,0,25,19,2,1
6480bb9c121ee402b7b2eda6,2009,,,1,MK Pandey,R Dravid,45,30,2,2,1,39,21,2,2,6,9,0,0
6480bba1448ab5c40ac64696,2014,,,2,CJ Anderson,RG Sharma,45,25,3,3,1,18,12,1,1,26,13,2,2
6480bba0fee4ae82492a666f,2013,,,2,M Vijay,MEK Hussey,45,32,5,3,1,29,20,2,3,15,12,3,0
6480bb9aa37f3b44678752d9,2023,,,2,DA Miller,R Tewatia,45,29,3,2,1,31,17,2,2,14,12,1,0
6480bb9c963968000dfd00d1,2009/10,,,2,M Kaif,Yuvraj Singh,45,32,2,2,1,14,16,0,0,29,16,2,2
6480bba0dcd1149b9b0b501f,2013,,,2,G Gambhir,MS Bisla,45,32,7,0,1,31,19,5,0,12,13,2,0
6480bb9e5ab10d1241d6509d,2012,,,2,RV Uthappa,SC Ganguly,45,29,5,1,1,37,21,5,1,6,8,0,0
6480bba30373b229e0090b67,2016,,,1,HM Amla,M Vijay,45,33,5,0,1,21,20,2,0,20,13,3,0
6480bb9754755bb7a7427d52,2021,,,2,S Dube,SV Samson,45,37,2,2,1,22,18,2,1,20,19,0,1
6480bb973d64aa91e60b4088,2021,,,1,AT Rayudu,SK Raina,45,24,1,4,1,27,17,0,3,16,7,1,1
6480bb9371e90dbd44ee19a3,2017,,,2,AR Patel,MM Sharma,45,31,2,2,1,32,17,1,2,13,14,1,0
6480bb981b01a21305fd65d5,2022,,,1,B Sai Sudharsan,R Tewatia,45,30,4,0,1,30,17,4,0,11,13,0,0
6480bb9552e25b3867e5c38a,2019,,,1,HH Pandya,KA Pollard,45,13,1,5,0,24,6,1,3,17,7,0,2
6480bb99f47261f111a6cc1a,2023,,,2,N Wadhera,PP Chawla,45,25,3,3,1,27,13,2,2,18,12,1,1
6480bba3ebbd8e4867dfa673,2016,,,1,JP Duminy,SW Billings,45,30,1,2,1,17,15,0,0,24,15,1,2
6480bb973da000031d26fbba,2021,,,2,HH Pandya,KA Pollard,45,23,4,3,0,29,16,3,2,15,7,1,1
6480bb983ad1bab18d1d8774,2022,,,2,DJ Willey,SE Rutherford,45,53,3,1,1,18,28,3,0,16,25,0,1
6480bb9f3700dfaa08e18c43,2012,,,1,AC Gilchrist,SD Chitnis,45,29,4,2,1,34,17,3,2,11,12,1,0
6480bb949f5853dfe76c99d9,2017,,,2,DA Warner,MC Henriques,45,25,3,2,1,14,8,1,1,28,17,2,1
6480bb9774a44376e3b5eb6f,2021,,,2,AK Markram,KL Rahul,45,29,0,3,1,18,16,0,1,24,13,0,2
6480bb9e4bb50b724830b249,2011,,,1,JH Kallis,MK Tiwary,45,33,5,1,1,10,11,0,0,35,22,5,1
6480bb977453ebef15f59e25,2021,,,1,AD Russell,PJ Cummins,45,22,3,3,0,29,9,2,3,11,13,1,0
6480bb9b2a5f2fd5053534dc,2007/08,,,1,DR Smith,SR Tendulkar,45,35,7,1,1,20,16,2,1,23,19,5,0
6480bb9ddcbb8fbbad6614c8,2009/10,,,2,KC Sangakkara,Yuvraj Singh,45,41,5,1,1,21,16,3,0,21,25,2,1
6480bb9651b51fdcda05e4c8,2020/21,,,1,AD Russell,EJG Morgan,45,18,3,5,1,25,11,1,3,20,7,2,2
6480bb9d109617dfa089c2c6,2011,,,1,LRPL Taylor,SR Watson,45,29,0,4,1,21,17,0,2,21,12,0,2
6480bb99c26e725b7b6f1637,2023,,,1,MP Stoinis,N Pooran,45,34,3,1,1,16,14,1,0,29,20,2,1
6480bb9f895e5780080c8059,2012,,,1,Azhar Mahmood,Gurkeerat Singh,45,24,6,2,1,18,14,2,1,26,10,4,1
6480bb958f77e7d3929d28e3,2018,,,2,MS Dhoni,SK Raina,45,18,3,3,0,16,7,1,1,28,11,2,2
6480bb9d86effd7e5e6a5261,2011,,,1,MEK Hussey,SK Raina,45,26,5,1,1,15,10,2,0,29,16,3,1
6480bb9e1d754facf4fad618,2012,,,2,AD Mathews,SPD Smith,44,31,1,0,1,25,19,1,0,13,12,0,0
6480bb9a21e416835389fd53,2023,,,1,DP Conway,S Dube,44,26,3,2,1,14,9,2,0,28,17,1,2
6480bb9740aaba2132c0eb0e,2021,,,2,D Padikkal,V Kohli,44,19,5,2,1,32,12,4,2,8,7,1,0
6480bb9f60d58ee39ba047b9,2013,,,2,KC Sangakkara,PA Patel,44,38,8,0,1,25,19,4,0,19,19,4,0
6480bb984a8abbb79a69e6ce,2022,,,1,R Parag,SO Hetmyer,44,19,4,3,1,11,7,2,0,30,12,2,3
6480bb9a0474602f26069e45,2007/08,,,2,JA Morkel,SK Raina,44,39,4,1,1,34,25,4,1,10,14,0,0
6480bb9faf20f0bc714af2ea,2013,,,2,DA Warner,DPMD Jayawardene,44,34,7,0,1,21,19,4,0,20,15,3,0
6480bba0587190387a754733,2013,,,1,IK Pathan,M Morkel,44,21,5,2,1,23,11,2,2,19,10,3,0
6480bb96c95abb10156a6055,2020/21,,,1,SA Yadav,SS Tiwary,44,35,3,1,1,16,15,2,0,26,20,1,1
6480bb950ced01a335bd7833,2019,,,2,JC Buttler,SPD Smith,44,30,4,1,1,27,17,3,1,15,13,1,0
6480bba0b5eabeb0a150b93f,2013,,,1,AB de Villiers,CH Gayle,44,15,5,3,1,31,8,3,3,12,7,2,0
6480bb966c9efd5bf35d10b9,2019,,,1,KD Karthik,RK Singh,44,16,3,4,0,40,13,3,4,3,3,0,0
6480bb9c454e9eefca545bde,2009/10,,,1,MS Bisla,RS Bopara,44,23,5,2,1,35,18,4,2,7,5,1,0
6480bb9ee779ef1e445d0506,2012,,,2,RV Uthappa,SPD Smith,44,38,3,0,1,21,18,2,0,21,20,1,0
6480bb98f98edd45b1ccb406,2022,,,2,AD Russell,RK Singh,44,26,3,4,1,39,17,3,4,5,9,0,0
6480bb9541caaeddc9ddaac3,2019,,,2,BA Stokes,JC Archer,44,18,2,4,1,21,9,1,2,22,9,1,2
6480bb9dc4ec5a52f8bcc465,2009/10,,,2,AT Rayudu,SR Tendulkar,44,29,8,0,1,33,18,7,0,11,11,1,0
6480bba1a6882d256a926a8b,2014,,,1,AM Rahane,KK Nair,44,33,5,1,1,21,19,4,0,19,14,1,1
6480bb9f022f0e8cd6e9cdeb,2012,,,1,LRPL Taylor,NV Ojha,44,25,5,1,1,28,13,4,1,13,12,1,0
6480bba0eb5a345386bdc825,2013,,,2,AM Rahane,R Dravid,44,39,8,0,1,21,18,3,0,22,21,5,0
6480bb95f45dffe4751efc46,2019,,,1,F du Plessis,SK Raina,44,37,1,2,1,25,18,0,2,17,19,1,0
6480bb9f90a251567178de39,2012,,,2,CL White,DT Christian,44,17,3,3,1,19,7,2,1,24,10,1,2
6480bb93c1cc671d66c471ba,2017,,,2,CA Lynn,G Gambhir,44,28,5,1,1,21,15,2,1,19,13,3,0
6480bb9ee0795047740de5a7,2011,,,2,MS Dhoni,SK Raina,44,23,4,2,1,31,14,3,2,13,9,1,0
6480bb9c9f9d5376b4227724,2009/10,,,2,A Symonds,HH Gibbs,44,35,5,0,1,28,20,4,0,15,15,1,0
6480bba2e8614b1263627c1b,2015,,,1,JP Faulkner,SPD Smith,44,20,2,4,1,18,9,0,2,24,11,2,2
6480bb9eda28fb340ed37b49,2012,,,1,PA Patel,S Dhawan,44,35,3,0,1,23,19,2,0,19,16,1,0
6480bb933fdc96ee7273400e,2017,,,1,MS Dhoni,SPD Smith,44,27,3,2,0,12,12,1,0,32,15,2,2
6480bb9db0ecec8acdd30619,2011,,,2,JD Ryder,MK Pandey,44,38,3,1,1,28,20,2,1,14,18,1,0
6480bb9c7ac2dca34620d56e,2009/10,,,2,CL White,KP Pietersen,44,27,4,2,0,21,13,2,1,23,14,2,1
6480bb984f6c41cd28aa0353,2022,,,2,AK Markram,RA Tripathi,44,31,4,1,1,12,14,0,0,31,17,4,1
6480bba234aac105851964b1,2015,,,2,CH Gayle,KD Karthik,44,38,2,2,1,22,19,0,2,18,19,2,0
6480bba000b91f6c5cf57fdb,2013,,,1,BB Samantray,GH Vihari,44,47,3,0,1,23,25,3,0,18,22,0,0
6480bb95f282ca61c07afe9b,2018,,,2,AT Rayudu,SK Raina,44,34,4,2,1,19,13,2,1,25,21,2,1
6480bb9b8860198955e581d8,2007/08,,,1,S Badrinath,SK Raina,44,28,5,1,1,20,17,2,1,18,11,3,0
6480bba0c7bf2b92ac8d836a,2013,,,2,SR Watson,SV Samson,44,39,2,1,1,17,22,1,0,23,17,1,1
6480bb9db38208342bc57b96,2011,,,1,BJ Haddin,JH Kallis,44,29,5,1,1,18,11,2,1,19,18,3,0
6480bb9f7bae5ad85c4473ba,2012,,,2,DJ Bravo,MS Dhoni,44,22,4,2,1,19,9,2,1,24,13,2,1
6480bba21bbf76a62abea528,2016,,,1,NLTC Perera,R Bhatia,44,16,4,3,1,26,9,3,2,16,7,1,1
6480bb97fcc6fccd233157f9,2021,,,2,R Tewatia,SV Samson,44,33,5,0,1,9,15,0,0,32,18,5,0
6480bb98adf21699eaa67796,2022,,,1,MK Lomror,RM Patidar,44,32,2,2,1,20,17,1,1,21,15,1,1
6480bba0c3cc8c51bc6c1c3a,2013,,,2,A Mukund,CH Gayle,44,25,7,1,1,8,9,1,0,34,16,6,1
6480bb99ed38bcb4025b8d86,2023,,,2,F du Plessis,V Kohli,44,29,5,2,1,23,11,2,2,21,18,3,0
6480bb9c8c6c106c6ffbeae4,2009/10,,,2,DA Warner,V Sehwag,44,20,5,2,1,33,14,3,2,10,6,2,0
6480bb9be88c31fc563da86f,2009,,,1,RE van der Merwe,V Kohli,44,27,4,3,1,35,19,3,3,9,8,1,0
6480bb9d22388e966342dba8,2009/10,,,1,M Vijay,ML Hayden,44,44,2,3,1,26,19,1,2,16,25,1,1
6480bb97f2f0fabec8f94d86,2020/21,,,1,EJG Morgan,N Rana,44,26,3,3,1,5,7,0,0,38,19,3,3
6480bb9c0dec1a788da66d33,2009/10,,,2,MS Dhoni,S Badrinath,44,36,4,0,1,18,15,2,0,23,21,2,0
6480bb9f90a251567178de39,2012,,,1,Azhar Mahmood,DJ Hussey,44,30,5,1,1,20,13,2,0,24,17,3,1
6480bba2fbc243afec641844,2015,,,1,AR Patel,R Dhawan,44,31,3,2,1,23,15,2,1,18,16,1,1
6480bb93c1cc671d66c471ba,2017,,,2,MK Pandey,SA Yadav,44,27,4,2,1,27,12,2,2,17,15,2,0
6480bb977453ebef15f59e25,2021,,,1,RA Tripathi,Shubman Gill,44,35,4,1,1,19,17,2,0,24,18,2,1
6480bb966c9efd5bf35d10b9,2019,,,2,JC Archer,R Parag,44,21,3,3,1,17,10,1,1,26,11,2,2
6480bba2ab35be3ffcfa932a,2016,,,1,KM Jadhav,SN Khan,44,16,6,2,0,8,6,1,0,35,10,5,2
6480bb9bc8bcea920f081be8,2009,,,2,M Manhas,TM Dilshan,44,22,4,1,0,23,13,3,0,20,9,1,1
6480bba2c5a614e0fd10cd19,2016,,,2,G Gambhir,SA Yadav,44,30,4,1,1,25,16,2,1,19,14,2,0
6480bb9edd901481f13ce9ba,2012,,,1,Azhar Mahmood,Mandeep Singh,44,25,3,1,1,26,12,3,1,17,13,0,0
6480bb9f70156528a31bb270,2013,,,1,CH Gayle,DT Christian,44,33,4,2,1,35,20,4,2,4,13,0,0
6480bba071a7a0cbb02d505a,2013,,,2,LA Pomersbach,Mandeep Singh,44,25,8,0,1,18,10,3,0,24,15,5,0
6480bba273adb498d96b27a9,2016,,,2,AD Russell,RV Uthappa,44,21,4,3,1,17,12,2,1,24,9,2,2
6480bba1f2392e6761d39d66,2014,,,2,LMP Simmons,RG Sharma,44,27,3,3,1,29,14,1,3,15,13,2,0
6480bb9eae43aed76989151b,2011,,,1,CH Gayle,LA Pomersbach,44,16,7,2,1,38,12,6,2,6,4,1,0
6480bba1105add9a994c58a7,2014,,,1,KP Pietersen,MA Agarwal,44,23,6,2,1,33,15,4,2,10,8,2,0
6480bba1dd2f8125fc8b203f,2014,,,1,AP Tare,KA Pollard,44,15,3,3,0,16,6,1,1,27,9,2,2
6480bba265483f7db002ec7c,2015,,,1,AR Patel,WP Saha,44,29,1,2,1,17,13,0,1,27,16,1,1
6480bba223f162806c0794ac,2015,,,1,BB McCullum,DR Smith,44,29,6,1,1,23,11,3,1,16,18,3,0
6480bb98bd3ca4df44cf9d8f,2022,,,2,DA Warner,MR Marsh,44,41,2,2,1,34,23,2,2,10,18,0,0
6480bb9f9eae77e599a46300,2012,,,1,AT Rayudu,KD Karthik,44,33,3,1,1,22,17,2,0,22,16,1,1
6480bba35038a60ea566794a,2016,,,1,BB McCullum,KD Karthik,44,33,7,1,1,17,14,3,0,26,19,4,1
6480bba048fb3d33ea0711e7,2013,,,1,AC Gilchrist,SE Marsh,44,38,7,0,1,25,18,4,0,18,20,3,0
6480bba18a431be2cc738de0,2014,,,2,KK Nair,R Bhatia,44,30,2,2,1,26,17,2,1,17,13,0,1
6480bb97b97c36ac8be3582f,2021,,,1,GJ Maxwell,V Kohli,44,36,3,2,1,27,21,2,2,14,15,1,0
6480bb9f7258f976eb8fe943,2012,,,2,JA Morkel,S Anirudha,43,12,2,4,0,18,6,1,2,18,6,1,2
6480bb982fc21d541267f7b9,2022,,,2,AM Rahane,VR Iyer,43,38,6,1,1,27,22,4,1,16,16,2,0
6480bb9fe7d0f611ba6ad229,2012,,,2,SS Tiwary,TM Dilshan,43,35,5,1,1,11,18,1,0,30,17,4,1
6480bb9c13817091131f76e3,2009/10,,,1,AC Gilchrist,VVS Laxman,43,18,5,2,1,33,12,4,2,9,6,1,0
6480bb9df57ec21d17310ad2,2011,,,1,G Gambhir,MK Tiwary,43,26,4,2,1,17,9,3,0,23,17,1,2
6480bb9fcb2b412c0ebd4afa,2013,,,2,MC Henriques,V Kohli,43,41,3,1,1,17,20,1,0,26,21,2,1
6480bb95cf9d446747bd74fe,2019,,,1,S Dhawan,SS Iyer,43,43,3,1,1,24,23,3,0,18,20,0,1
6480bb931e6d2b03141b586d,2017,,,1,KK Nair,SS Iyer,43,33,5,0,1,17,16,1,0,26,17,4,0
6480bb9edb0554f003f5428a,2012,,,2,CH Gayle,SS Tiwary,43,45,2,2,1,20,23,1,1,19,22,1,1
6480bb9993e6e474a4e37366,2023,,,2,RD Gaikwad,S Dube,43,38,4,1,1,15,12,2,0,28,26,2,1
6480bb970d7cbd85b6ada680,2021,,,2,RM Patidar,V Kohli,43,46,2,1,1,15,21,1,0,23,25,1,1
6480bb9c07d77f83fb139c41,2009,,,2,KC Sangakkara,Yuvraj Singh,43,29,2,2,1,24,17,1,1,18,12,1,1
6480bba2f39653e2f61baca2,2015,,,2,JP Duminy,SS Iyer,43,30,5,2,1,23,12,2,2,19,18,3,0
6480bba19cc161a3fb8a8795,2014,,,2,AT Rayudu,LMP Simmons,43,29,3,1,1,17,14,0,0,26,15,3,1
6480bb9b8cc888fe3f01f2a4,2009,,,1,S Sohal,SM Katich,43,26,1,4,1,24,14,0,3,17,12,1,1
6480bb966539f85263cb6429,2019,,,1,MS Dhoni,RA Jadeja,43,22,5,2,1,18,12,3,0,25,10,2,2
6480bba30373b229e0090b67,2016,,,1,M Vijay,WP Saha,43,32,3,1,1,27,19,2,1,16,13,1,0
6480bb9ef18c54e7aafdd223,2012,,,1,MK Tiwary,MS Bisla,43,46,2,0,1,20,27,1,0,19,19,1,0
6480bb9c58b62383739c022e,2009,,,2,GC Smith,RJ Quiney,43,39,6,0,1,19,19,3,0,22,20,3,0
6480bba38060854b4fab1831,2016,,,1,AB de Villiers,KL Rahul,43,39,2,2,1,20,18,1,1,23,21,1,1
6480bb98b00f767943bb8415,2022,,,2,DA Warner,PP Shaw,43,27,8,1,1,28,14,5,1,15,13,3,0
6480bba177ab201442a0e3c8,2015,,,1,CH Gayle,V Kohli,43,33,5,2,1,21,16,3,1,17,17,2,1
6480bb9442c4889bcbb4a784,2017,,,2,BA Stokes,RA Tripathi,43,31,2,3,1,14,15,1,0,29,16,1,3
6480bb9dd89d4266d59a4592,2011,,,1,CH Gayle,TM Dilshan,43,29,6,2,1,24,20,2,2,16,9,4,0
6480bb9f58a3e7ea877fc9dc,2012,,,1,AA Jhunjhunwala,PA Reddy,43,31,2,2,1,18,18,0,1,24,13,2,1
6480bb9a4de9fe3e7319ce39,2007/08,,,1,JH Kallis,LRPL Taylor,43,25,8,1,1,11,10,2,0,32,15,6,1
6480bb988b447f26d7a96c0c,2022,,,1,DJ Hooda,KL Rahul,43,21,4,1,1,15,8,1,1,22,13,3,0
6480bb95960e393c939ab44c,2018,,,2,HH Pandya,RG Sharma,43,25,3,1,1,27,14,2,1,13,11,1,0
6480bb969d80bbba2884b855,2020/21,,,1,AB de Villiers,JR Philippe,43,38,3,1,1,24,24,1,1,18,14,2,0
6480bb9c8c6c106c6ffbeae4,2009/10,,,2,AB de Villiers,KD Karthik,43,39,3,0,1,25,20,2,0,17,19,1,0
6480bb9480627b50308b7903,2017,,,2,JC Buttler,PA Patel,43,24,7,1,1,9,7,2,0,34,17,5,1
6480bba1603d86b7d278a366,2015,,,2,BB McCullum,SK Raina,43,20,4,3,1,28,10,2,3,8,10,2,0
6480bb9f23c17ccb47aa9e58,2013,,,1,AM Rahane,SR Watson,43,28,7,0,1,3,9,0,0,32,19,7,0
6480bb9be7cbbb90a12dc916,2009,,,2,S Dhawan,SR Tendulkar,43,35,5,0,1,22,21,2,0,20,14,3,0
6480bb9d1f9a3cf1fa86e11c,2011,,,1,B Chipli,KC Sangakkara,43,34,2,2,1,21,19,1,1,21,15,1,1
6480bb9f8d3b0a3d1e28a4b7,2013,,,1,G Gambhir,JH Kallis,43,36,4,1,1,25,23,2,1,17,13,2,0
6480bb9a81d7fd0ac0307b4d,2023,,,1,TH David,Tilak Varma,43,33,1,2,1,13,13,1,0,25,20,0,2
6480bba1587a54176a9badf4,2014,,,1,G Gambhir,RV Uthappa,43,30,6,1,1,28,18,4,1,13,12,2,0
6480bba2b99fcf06aaeac805,2015,,,1,LMP Simmons,PA Patel,43,29,7,0,1,17,15,2,0,23,14,5,0
6480bb9651b51fdcda05e4c8,2020/21,,,2,JC Buttler,R Tewatia,43,34,4,1,1,30,20,3,1,12,14,1,0
6480bb9eb559e2934b31c47c,2012,,,2,AT Rayudu,JEC Franklin,43,47,2,1,0,17,17,0,1,25,30,2,0
6480bba0ddcc30675d83403c,2013,,,2,A Ashish Reddy,S Dhawan,43,16,6,2,0,24,9,2,2,19,7,4,0
6480bb9d3ab782f83ce3e381,2011,,,2,G Gambhir,JH Kallis,43,32,2,1,1,31,20,2,1,11,12,0,0
6480bb9e41b781523bd5aafe,2012,,,2,GJ Maxwell,IK Pathan,43,23,2,3,0,3,7,0,0,38,16,2,3
6480bb95a65bb0f3394a62b5,2018,,,2,AT Rayudu,MS Dhoni,43,29,2,2,0,22,15,1,1,20,14,1,1
6480bb9c7ac2dca34620d56e,2009/10,,,1,M Vijay,SK Raina,43,24,2,3,1,31,12,1,3,12,12,1,0
6480bb99b3179a9346d8883c,2022,,,1,R Ashwin,YBK Jaiswal,43,32,4,2,1,26,19,3,1,17,13,1,1
6480bb9e5de755887230bb00,2012,,,2,F du Plessis,M Vijay,43,37,4,2,1,35,26,4,2,8,11,0,0
6480bb9c13fa57328b17e4e2,2009/10,,,2,ML Hayden,S Badrinath,43,29,7,1,1,27,14,4,1,14,15,3,0
6480bb966f48b8ee03e6dff5,2020/21,,,1,Imran Tahir,SM Curran,43,31,6,0,1,13,10,2,0,25,21,4,0
6480bb9a1a3ab2ab8297871d,2007/08,,,1,A Symonds,VVS Laxman,43,33,5,1,1,35,22,4,1,7,11,1,0
6480bb993e61058e682e2ff4,2023,,,2,D Padikkal,SV Samson,43,34,4,3,1,25,20,2,2,18,14,2,1
6480bb9480627b50308b7903,2017,,,1,AJ Tye,JP Faulkner,43,21,4,2,1,25,12,2,2,15,9,2,0
6480bb9ce544a2fc17a48bee,2009,,,2,AD Mathews,BB McCullum,43,25,3,2,1,16,13,2,0,26,12,1,2
6480bb9f59fd8000010baf09,2013,,,2,DA Warner,V Sehwag,43,35,7,0,1,15,13,3,0,25,22,4,0
6480bba28257fe87dd859e3e,2015,,,2,LMP Simmons,RG Sharma,43,34,3,1,1,15,14,1,1,26,20,2,0
6480bb9e713e850d3dd0cba9,2012,,,1,R Dravid,SP Goswami,43,31,4,2,1,25,19,2,2,17,12,2,0
6480bb9bcf9df9e7ae0416ba,2009,,,2,NV Ojha,YK Pathan,43,31,2,2,1,19,12,0,2,22,19,2,0
6480bb95fbd4f1b7f3d8dfc0,2019,,,2,PA Patel,V Kohli,43,23,8,0,1,19,9,4,0,24,14,4,0
6480bb9f79be50f1621abcc6,2012,,,2,BJ Hodge,J Botha,43,23,4,2,1,28,16,2,2,13,7,2,0
6480bba18a289cc4b8d173a4,2014,,,2,KP Pietersen,M Vijay,43,32,5,1,1,34,20,5,1,8,12,0,0
6480bb9ef8d4c23c6e5be4c7,2011,,,2,BB McCullum,M Klinger,43,33,6,0,1,22,16,3,0,20,17,3,0
6480bba2e30bef1d7b3bb753,2015,,,2,CH Gayle,V Kohli,43,15,5,3,1,35,10,4,3,7,5,1,0
6480bb96ebf33df82879ad4c,2020/21,,,2,MS Dhoni,SM Curran,43,14,2,3,0,23,9,2,1,15,5,0,2
6480bb9f0f959bc6104820c3,2013,,,1,DA Warner,DPMD Jayawardene,43,32,3,0,1,21,16,2,0,19,16,1,0
6480bb9deba74e341b44c765,2009/10,,,2,Anirudh Singh,Y Venugopal Rao,43,41,3,2,1,19,16,1,1,23,25,2,1
6480bb96e8ba017befb2bc8a,2020/21,,,2,Ishan Kishan,SA Yadav,43,24,2,3,0,31,13,1,3,12,11,1,0
6480bb9aa030c8ebcbcc19c9,2007/08,,,1,AM Nayar,DJ Bravo,43,19,2,3,1,29,12,1,3,12,7,1,0
6480bb96a43476c5d9a56c4e,2020/21,,,2,MP Stoinis,S Dhawan,43,25,3,2,1,24,14,1,2,19,11,2,0
6480bb9ca668b7b36823fb21,2009,,,2,AM Rahane,PR Shah,43,25,3,2,1,29,14,2,2,12,11,1,0
6480bba2eea6f31945e4c5e2,2016,,,1,AD Russell,G Gambhir,43,22,1,4,1,36,17,1,4,5,5,0,0
6480bba0e52e9733fc6d9937,2013,,,1,DR Smith,RG Sharma,43,28,5,1,1,26,15,3,1,16,13,2,0
6480bb9f8ab73cf7c77cef03,2012,,,1,AL Menaria,OA Shah,43,31,2,2,1,21,20,1,1,17,11,1,1
6480bb998454ba791a8fdbf8,2023,,,1,DA Warner,MK Pandey,43,30,6,0,1,11,12,1,0,26,18,5,0
6480bb989bf19eb260a04f0e,2022,,,2,AK Markram,N Pooran,43,21,2,3,0,33,13,2,3,5,8,0,0
6480bb958c7b985a2b586a02,2018,,,1,SK Raina,SR Watson,43,31,5,1,1,27,22,4,0,15,9,1,1
6480bb9eee740f701b0ee154,2011,,,2,IK Pathan,Y Venugopal Rao,43,33,2,2,1,6,13,0,0,30,20,2,2
6480bb9a6a7169d0e413bcfa,2023,,,1,DA Miller,Shubman Gill,43,24,3,2,0,21,12,2,1,21,12,1,1
6480bb961cdee4d82c395517,2020/21,,,2,RR Pant,SO Hetmyer,42,22,0,4,1,15,10,0,2,21,12,0,2
6480bba28724848c0f3ef034,2015,,,2,G Gambhir,YK Pathan,42,31,4,1,1,20,15,2,0,20,16,2,1
6480bb99409885bcc7b67109,2023,,,2,DP Conway,RD Gaikwad,42,36,4,1,1,8,16,1,0,34,20,3,1
6480bb9cff4ec2f71cdf18d1,2009/10,,,1,S Dhawan,SR Tendulkar,42,32,6,0,1,24,17,4,0,11,15,2,0
6480bb981dc3f7250f93bc92,2022,,,1,KL Rahul,Q de Kock,42,26,4,2,1,16,13,1,1,23,13,3,1
6480bba2557febf92f9f79ab,2015,,,1,BB McCullum,DR Smith,42,28,6,2,1,19,14,3,1,20,14,3,1
6480bb9c9e328ac30bcaf6b0,2009/10,,,1,ML Hayden,SK Raina,42,29,2,2,1,12,11,0,1,23,18,2,1
6480bb9e21655ee16a96b2c3,2012,,,1,CH Gayle,MA Agarwal,42,28,3,4,1,8,7,0,1,34,21,3,3
6480bb9bed3e2a1a008f93a6,2007/08,,,1,RV Uthappa,ST Jayasuriya,42,17,6,2,1,9,8,2,0,31,9,4,2
6480bb9d85a6220ec9bc7dcb,2011,,,1,RV Uthappa,Yuvraj Singh,42,36,3,2,1,31,22,2,2,10,14,1,0
6480bba33195e5ebac1da82a,2016,,,1,KA Pollard,KH Pandya,42,19,1,4,1,23,7,0,3,19,12,1,1
6480bb9df60a79ae5f20b748,2011,,,1,NV Ojha,Y Venugopal Rao,42,44,3,0,1,18,21,1,0,22,23,2,0
6480bb9c89f35f11aae1f2d0,2009/10,,,1,AB McDonald,KD Karthik,42,20,5,1,1,14,9,2,0,22,11,3,1
6480bb95a8153d4daac6e4f7,2019,,,1,CA Lynn,KD Karthik,42,21,1,4,1,30,13,0,4,9,8,1,0
6480bba3bca9c998d5f3e3d0,2016,,,2,DJ Hooda,Yuvraj Singh,42,23,4,2,1,20,10,2,1,22,13,2,1
6480bb9d7aa8d2c4c947d164,2009/10,,,1,JH Kallis,R Dravid,42,37,4,1,1,14,12,2,0,26,25,2,1
6480bba133267f04941acf7d,2014,,,2,RN ten Doeschate,YK Pathan,42,26,2,2,0,25,15,2,1,17,11,0,1
6480bb9a7d91d721555835e5,2007/08,,,1,M Kaif,SA Asnodkar,42,30,4,2,1,21,18,3,1,16,12,1,1
6480bba1af51ddc81185931d,2014,,,1,AB de Villiers,V Kohli,42,22,4,1,1,10,6,2,0,29,16,2,1
6480bb970c637fd0c057dca9,2021,,,1,JC Buttler,R Parag,42,15,2,4,1,29,10,2,3,11,5,0,1
6480bb9c7ac2dca34620d56e,2009/10,,,2,JH Kallis,RV Uthappa,42,24,4,2,1,17,11,3,0,21,13,1,2
6480bb9cd6fe6fad0d6efbd9,2009/10,,,2,G Gambhir,V Sehwag,42,21,6,1,1,9,8,1,0,30,13,5,1
6480bb9ccba48a6bb44ccc21,2009,,,2,JP Duminy,ST Jayasuriya,42,24,5,2,1,12,12,2,0,28,12,3,2
6480bb9be88c31fc563da86f,2009,,,1,JH Kallis,RV Uthappa,42,34,5,0,1,20,17,3,0,19,17,2,0
6480bb9692a7f0d52bd43127,2019,,,2,CH Gayle,KL Rahul,42,20,8,1,1,23,10,4,1,17,10,4,0
6480bba26ca6ec72ba377236,2016,,,2,KL Rahul,V Kohli,42,32,5,0,1,27,15,4,0,14,17,1,0
6480bb9a17692bfb5bd3894c,2007/08,,,1,PA Patel,S Vidyut,42,29,6,0,1,14,11,2,0,25,18,4,0
6480bb9538916411f52016bf,2019,,,1,CA Lynn,SP Narine,42,16,5,3,1,16,8,2,1,25,8,3,2
6480bb96e834e1c16b33f325,2020/21,,,2,R Tewatia,RV Uthappa,42,12,2,5,1,33,8,0,5,9,4,2,0
6480bb960d5042aa46b7776b,2020/21,,,1,Ishan Kishan,SA Yadav,42,39,3,1,1,15,18,0,1,26,21,3,0
6480bb9bc8bcea920f081be8,2009,,,2,AB de Villiers,TM Dilshan,42,45,2,0,1,21,23,0,0,21,22,2,0
6480bb9f54d17f50da495682,2012,,,2,IK Pathan,Y Nagar,42,40,1,1,0,13,17,0,0,25,23,1,1
6480bb9b724406459cd357c9,2007/08,,,1,JR Hopes,SE Marsh,42,38,1,3,1,27,19,0,3,13,19,1,0
6480bb94283e3f5a1a95839f,2018,,,2,HH Pandya,RG Sharma,42,21,5,1,0,13,8,0,1,28,13,5,0
6480bb9d80536875f41bc605,2011,,,1,MK Pandey,RV Uthappa,42,33,1,2,1,25,14,1,2,14,19,0,0
6480bb98f01e4672b988c112,2022,,,1,D Padikkal,JC Buttler,42,31,5,1,1,25,20,4,0,13,11,1,1
6480bba0b07a395235841955,2013,,,2,DR Smith,RG Sharma,42,44,3,1,1,20,22,1,1,22,22,2,0
6480bb98323919fff9902666,2022,,,1,JM Bairstow,PBB Rajapaksa,42,31,4,2,1,14,13,2,0,27,18,2,2
6480bb964a4d5a1709db428e,2020/21,,,2,CH Gayle,KL Rahul,42,34,2,3,1,24,21,1,2,16,13,1,1
6480bb9a6a7169d0e413bcfa,2023,,,1,HH Pandya,Shubman Gill,42,23,2,3,1,25,15,1,2,16,8,1,1
6480bb9763013a01eae041f2,2020/21,,,1,Q de Kock,SA Yadav,42,30,8,0,1,13,12,2,0,27,18,6,0
6480bb973d64aa91e60b4088,2021,,,2,JC Buttler,S Dube,42,33,4,1,1,21,16,2,1,16,17,2,0
6480bb99d43295fa2d82c9dc,2023,,,1,F du Plessis,V Kohli,42,28,6,1,1,22,16,3,1,19,12,3,0
6480bb94351a8b10e20d14d9,2017,,,2,KD Karthik,SK Raina,42,35,1,1,1,16,16,0,0,25,19,1,1
6480bba3ebbd8e4867dfa673,2016,,,2,AM Rahane,MS Dhoni,42,29,1,2,1,9,9,0,0,27,20,1,2
6480bb9b2de4e62ee60b7e5c,2009,,,1,JD Ryder,JH Kallis,42,25,6,1,1,26,15,5,0,15,10,1,1
6480bb9e173228d1b18e376b,2012,,,2,AM Rahane,BJ Hodge,42,31,6,0,1,20,13,3,0,22,18,3,0
6480bb949a2d28d1ad7d367f,2018,,,1,G Gambhir,SS Iyer,42,26,4,2,1,29,15,4,1,11,11,0,1
6480bb98aae066234fd8f11e,2022,,,1,Shubman Gill,V Shankar,42,35,3,1,1,25,15,2,1,13,20,1,0
6480bb931b06a170006b4713,2017,,,2,AJ Finch,BB McCullum,42,22,6,2,1,31,15,4,2,9,7,2,0
6480bba2c3207713bd927ce5,2015,,,2,M Vijay,M Vohra,42,29,6,2,1,24,18,4,1,17,11,2,1
6480bb9d86effd7e5e6a5261,2011,,,2,AB de Villiers,V Kohli,42,36,4,1,1,16,18,1,0,26,18,3,1
6480bb99d43295fa2d82c9dc,2023,,,1,Anuj Rawat,Shahbaz Ahmed,42,34,4,0,0,15,22,1,0,20,12,3,0
6480bb9ef7c6084992b7cdf8,2012,,,1,KP Pietersen,LRPL Taylor,42,31,4,2,1,28,20,3,2,13,11,1,0
6480bb9fe489b0d429e97599,2012,,,1,AB de Villiers,J Syed Mohammad,42,11,5,3,0,38,10,4,3,4,1,1,0
6480bb9e335bec070f88430f,2011,,,2,MS Dhoni,WP Saha,42,47,1,2,1,19,19,1,1,17,28,0,1
6480bb9ec0a4e3f137edb047,2011,,,1,SS Tiwary,V Kohli,42,20,3,2,0,9,6,1,0,31,14,2,2
6480bba326249b668a4713d6,2016,,,2,BB McCullum,DR Smith,42,33,6,1,1,10,15,2,0,27,18,4,1
6480bb942fc9529eb2869c17,2018,,,2,AT Rayudu,SK Raina,42,25,4,3,1,30,16,2,3,11,9,2,0
6480bb9c21492b9a562c6f46,2009/10,,,1,FY Fazal,NV Ojha,42,29,7,0,1,31,23,6,0,8,6,1,0
6480bba20559f15c3489f637,2015,,,1,LMP Simmons,PA Patel,42,34,6,0,1,20,17,3,0,17,17,3,0
6480bb9e692eaa193a417426,2012,,,2,AJ Finch,NV Ojha,42,40,4,1,1,8,14,0,0,33,26,4,1
6480bb947b065b9dc0256f0d,2018,,,1,RA Tripathi,SV Samson,42,11,3,4,0,14,5,1,1,27,6,2,3
6480bba048fb3d33ea0711e7,2013,,,2,KV Sharma,PA Patel,42,37,3,1,1,22,18,2,1,20,19,1,0
6480bb9a6935abf34d88ca97,2007/08,,,1,KC Sangakkara,Yuvraj Singh,42,24,2,3,1,15,11,1,1,23,13,1,2
6480bb99ed38bcb4025b8d86,2023,,,1,RK Singh,Rahmanullah Gurbaz,42,31,3,2,1,12,12,1,0,30,19,2,2
6480bb9c442caaabe9eb2275,2009,,,1,DA Warner,G Gambhir,42,50,2,1,1,21,30,0,1,17,20,2,0
6480bb973d64aa91e60b4088,2021,,,2,JD Unadkat,R Tewatia,42,27,1,3,1,20,15,1,1,19,12,0,2
6480bb9ee4565d108b29626f,2012,,,1,DJ Bravo,SK Raina,42,31,4,1,1,12,12,0,1,28,19,4,0
6480bb9fc524f8142f0b3461,2012,,,1,AP Majumdar,RV Uthappa,42,32,1,2,1,30,20,1,2,11,12,0,0
6480bb9ab83a3072124dda22,2023,,,2,PN Mankad,Q de Kock,42,30,5,1,1,21,17,3,0,21,13,2,1
6480bb95e25835586d412978,2018,,,2,Ishan Kishan,SA Yadav,42,36,4,2,1,12,15,0,1,29,21,4,1
6480bb9db6a011b38afed5dc,2011,,,1,MD Mishra,RV Uthappa,42,20,3,2,1,15,10,1,0,25,10,2,2
6480bb99537b54b870dc74d1,2023,,,2,DA Miller,Shubman Gill,42,30,3,1,1,16,17,1,0,23,13,2,1
6480bb9b7b8617115de9683b,2007/08,,,1,SB Styris,Y Venugopal Rao,42,40,4,0,1,19,17,3,0,16,23,1,0
6480bb9f9a70ecf3467829df,2013,,,1,MEK Hussey,MS Dhoni,42,21,6,0,1,33,15,6,0,6,6,0,0
6480bba20130c44ed20c9bcf,2016,,,1,KH Pandya,TG Southee,42,18,3,2,1,13,7,2,0,25,11,1,2
6480bb93182304739a535742,2017,,,2,CJ Anderson,SV Samson,42,18,2,4,1,1,3,0,0,40,15,2,4
6480bba0c1c8569f19cc70f0,2013,,,2,AD Mathews,MR Marsh,41,26,3,2,1,18,15,2,0,22,11,1,2
6480bba1d3b4ddc36050e3f3,2014,,,2,Shakib Al Hasan,YK Pathan,41,33,4,1,1,18,16,2,0,20,17,2,1
6480bb95a8153d4daac6e4f7,2019,,,1,CA Lynn,N Rana,41,33,4,1,1,19,15,1,1,21,18,3,0
6480bb9ca21b98f1be8254e2,2009/10,,,1,DA Warner,V Sehwag,41,26,6,2,1,6,4,1,0,35,22,5,2
6480bb990942cd416cf5f447,2022,,,1,R Tewatia,Shubman Gill,41,24,6,0,0,22,16,4,0,14,8,2,0
6480bba2e8614b1263627c1b,2015,,,2,MC Henriques,S Dhawan,41,36,5,1,1,20,21,3,0,20,15,2,1
6480bb9da3dc1406b000cc98,2011,,,1,WD Parnell,Yuvraj Singh,41,16,3,3,0,10,9,1,0,29,7,2,3
6480bb95085c25712f29bd36,2019,,,1,AD Nath,PA Patel,41,35,1,2,1,24,20,1,1,17,15,0,1
6480bba2bbd9d85769220a68,2015,,,2,AD Mathews,JP Duminy,41,28,3,2,1,16,17,2,0,22,11,1,2
6480bb9d105fba311a23a588,2011,,,2,MA Agarwal,V Kohli,41,25,5,1,1,15,7,1,1,23,18,4,0
6480bb9bcc2f6123673672d0,2007/08,,,1,KD Karthik,MK Tiwary,41,25,3,1,1,27,16,2,1,12,9,1,0
6480bba19e29de4f208211ac,2014,,,2,CH Gayle,V Kohli,41,28,1,3,1,14,12,1,1,21,16,0,2
6480bb97b945155c90dccd3d,2021,,,1,KD Karthik,N Rana,41,18,5,1,1,26,11,3,1,13,7,2,0
6480bb962fbc99d08dc59f56,2020/21,,,1,S Dube,V Kohli,41,33,0,2,1,23,19,0,2,13,14,0,0
6480bba328f7475f4b87d3ff,2016,,,2,SA Yadav,YK Pathan,41,32,3,2,1,17,14,1,1,24,18,2,1
6480bba2b341a081c069198d,2015,,,1,CH Gayle,V Kohli,41,36,4,1,1,27,26,4,1,8,10,0,0
6480bb94834e2b780c4782b5,2017,,,1,C de Grandhomme,MK Pandey,41,31,4,1,1,29,16,4,1,12,15,0,0
6480bb96c880c7df4e055f14,2020/21,,,2,GJ Maxwell,N Pooran,41,31,2,1,1,9,13,0,0,30,18,2,1
6480bba2b99fcf06aaeac805,2015,,,2,SR Watson,SV Samson,41,30,5,1,1,18,16,2,1,19,14,3,0
6480bb95a09b947e0837a38a,2019,,,2,HH Pandya,KA Pollard,41,19,2,2,1,19,13,2,0,16,6,0,2
6480bb9f90a251567178de39,2012,,,1,DJ Hussey,SD Chitnis,41,23,2,3,1,29,10,1,3,11,13,1,0
6480bba2965d1d15aa6f723e,2016,,,1,JP Duminy,RR Pant,41,40,3,0,1,20,23,1,0,20,17,2,0
6480bb9e156723e64d6bd26b,2012,,,1,CL White,DT Christian,41,33,0,3,1,23,18,0,2,16,15,0,1
6480bba0a9f68a29bda72302,2013,,,2,AJ Finch,RV Uthappa,41,34,3,2,1,16,13,2,0,25,21,1,2
6480bb99d2bd76016d47896d,2023,,,2,DA Warner,PP Shaw,41,27,7,0,1,26,18,5,0,12,9,2,0
6480bb968211e65fcbffa192,2019,,,2,LS Livingstone,SV Samson,41,20,3,4,1,11,7,1,1,28,13,2,3
6480bb9ddfb0f2f6f8e813e5,2011,,,2,TR Birt,V Sehwag,41,20,5,2,1,14,11,2,0,25,9,3,2
6480bb9824c4678d005d7aeb,2022,,,2,N Rana,SS Iyer,41,24,1,3,1,18,11,1,1,22,13,0,2
6480bb9df46e9f48932124df,2009/10,,,1,C Madan,SR Tendulkar,41,35,5,0,1,15,19,3,0,18,16,2,0
6480bb9f79be50f1621abcc6,2012,,,2,AL Menaria,R Dravid,41,33,3,2,1,26,18,1,2,14,15,2,0
6480bb9371e90dbd44ee19a3,2017,,,1,SS Iyer,SW Billings,41,27,5,0,1,22,17,3,0,15,10,2,0
6480bb99f649ea7a6d79892f,2023,,,1,S Dhawan,SM Curran,41,30,6,1,1,19,15,3,0,22,15,3,1
6480bb97af44a48533f08540,2020/21,,,1,CH Gayle,N Pooran,41,21,1,4,1,15,11,1,1,22,10,0,3
6480bb9adb5d9ca80cb1c6a0,2023,,,2,H Klaasen,RA Tripathi,41,19,3,3,1,26,12,2,2,15,7,1,1
6480bb99af95c6c90c4c3924,2023,,,1,C Green,TH David,41,21,5,1,1,25,10,3,1,16,11,2,0
6480bb945901306d3cb2b759,2018,,,1,DJ Bravo,SR Watson,41,28,5,0,1,24,16,4,0,15,12,1,0
6480bb981dc3f7250f93bc92,2022,,,2,AR Patel,Kuldeep Yadav,41,20,2,3,0,24,12,1,2,16,8,1,1
6480bb9e591b94e62772e66a,2012,,,1,KP Pietersen,LRPL Taylor,41,16,3,4,1,26,9,3,2,15,7,0,2
6480bb949a2d28d1ad7d367f,2018,,,2,DA Miller,KK Nair,41,38,2,1,1,18,18,1,0,23,20,1,1
6480bba0a4e7c61a5656729e,2014,,,2,AB de Villiers,Yuvraj Singh,41,33,4,1,1,17,15,2,0,24,18,2,1
6480bb9c89e2e8ecb04f94cb,2009/10,,,1,AC Gilchrist,HH Gibbs,41,25,6,2,1,24,13,4,1,17,12,2,1
6480bb9e713e850d3dd0cba9,2012,,,2,MK Tiwary,YK Pathan,41,28,3,1,1,23,14,3,0,15,14,0,1
6480bb9a4de9fe3e7319ce39,2007/08,,,1,P Kumar,Z Khan,41,32,4,2,1,25,18,2,2,15,14,2,0
6480bb9e4bb50b724830b249,2011,,,2,JEC Franklin,KA Pollard,41,30,3,1,1,24,14,1,1,15,16,2,0
6480bb9e4bb50b724830b249,2011,,,2,AT Rayudu,JEC Franklin,41,15,4,2,0,17,6,0,2,21,9,4,0
6480bb93c1cc671d66c471ba,2017,,,1,HH Pandya,N Rana,41,14,4,3,1,12,4,1,1,27,10,3,2
6480bb98d2cd0fa3ed0ffc21,2022,,,1,PBB Rajapaksa,S Dhawan,41,17,3,4,1,31,9,3,3,9,8,0,1
6480bb9f218f37b46bef4afb,2013,,,2,AJ Finch,Yuvraj Singh,41,28,4,2,1,20,12,2,1,19,16,2,1
6480bb9d03ce4b87b32b91f5,2009/10,,,2,M Vijay,ML Hayden,41,28,4,1,1,20,10,1,1,19,18,3,0
6480bba18a431be2cc738de0,2014,,,2,KK Nair,SR Watson,41,21,3,3,0,25,11,3,1,16,10,0,2
6480bb98323919fff9902666,2022,,,2,D Padikkal,SO Hetmyer,41,27,5,1,1,15,15,2,0,24,12,3,1
6480bba373508e4f3f4be6c0,2016,,,2,GJ Bailey,SS Tiwary,41,31,4,1,1,28,19,3,1,13,12,1,0
6480bb9faf20f0bc714af2ea,2013,,,1,G Gambhir,MK Tiwary,41,35,4,0,1,17,14,2,0,23,21,2,0
6480bb9996eb97dd08b62f78,2023,,,2,Harpreet Brar,JM Sharma,41,28,2,2,1,13,13,1,0,27,15,1,2
6480bb949a2d28d1ad7d367f,2018,,,1,CH Morris,DT Christian,41,28,1,2,1,26,15,1,1,13,13,0,1
6480bb9af968df9497d2b9c4,2007/08,,,1,LR Shukla,M Kartik,41,24,2,2,1,26,13,1,2,10,11,1,0
6480bb94834e2b780c4782b5,2017,,,1,CA Lynn,G Gambhir,41,23,4,3,1,16,7,1,2,21,16,3,1
6480bb9774dd8e44bbeeb5a4,2021,,,1,M Shahrukh Khan,MA Agarwal,41,23,3,2,1,4,5,0,0,37,18,3,2
6480bba0d2cdb40c68c4739c,2013,,,1,MS Dhoni,R Ashwin,41,37,1,3,1,31,19,1,3,9,18,0,0
6480bb9f210b6e50fb2072ae,2013,,,2,G Gambhir,YK Pathan,41,28,4,1,1,12,11,1,0,27,17,3,1
6480bb9a7577454a5220c94b,2007/08,,,1,ST Jayasuriya,YV Takawale,41,45,1,2,1,18,20,1,1,19,25,0,1
6480bb9814efd9a91e8c911f,2021,,,1,RA Tripathi,Shubman Gill,41,23,6,0,1,19,10,3,0,20,13,3,0
6480bb9dd4e6757f7ded95e9,2009/10,,,2,MD Mishra,TL Suman,41,30,5,1,1,16,17,3,0,17,13,2,1
6480bb99433f6e11060ba714,2022,,,2,JM Sharma,RD Chahar,41,30,2,3,1,23,15,1,2,17,15,1,1
6480bb9c454e9eefca545bde,2009/10,,,1,KC Sangakkara,RS Bopara,41,24,6,0,1,29,13,6,0,11,11,0,0
6480bb97af44a48533f08540,2020/21,,,2,JC Buttler,SPD Smith,41,19,4,2,0,22,11,1,2,16,8,3,0
6480bb9d3ab782f83ce3e381,2011,,,1,S Dhawan,S Sohal,41,33,5,0,1,15,13,2,0,26,20,3,0
6480bb97c48a16e84b55a325,2020/21,,,2,DA Warner,MK Pandey,41,31,6,1,1,16,16,3,0,22,15,3,1
6480bb9e34659755628e7471,2012,,,2,AM Nayar,Mandeep Singh,41,39,3,0,1,11,20,0,0,23,19,3,0
6480bb9482dff502bff80bcf,2017,,,1,CH Morris,CJ Anderson,41,19,3,3,0,15,7,1,1,26,12,2,2
6480bb9f9eae77e599a46300,2012,,,1,Harbhajan Singh,KA Pollard,41,25,3,2,0,20,12,3,0,21,13,0,2
6480bb9dc4ec5a52f8bcc465,2009/10,,,1,AB Barath,DPMD Jayawardene,41,27,7,1,1,9,9,0,1,31,18,7,0
6480bb94ca3c1b1eac5e8dd3,2018,,,2,DJ Bravo,Imran Tahir,41,15,1,5,1,39,13,1,5,2,2,0,0
6480bb9aab9770e7260312df,2007/08,,,1,AS Yadav,RG Sharma,41,15,4,3,1,8,5,1,0,33,10,3,3
6480bb99af95c6c90c4c3924,2023,,,1,Ishan Kishan,RG Sharma,41,28,7,1,1,12,10,1,1,28,18,6,0
6480bb9e88141830a7a309b5,2011,,,2,RN ten Doeschate,Shakib Al Hasan,41,25,6,0,1,12,9,2,0,26,16,4,0
6480bb99537b54b870dc74d1,2023,,,2,B Sai Sudharsan,Shubman Gill,41,40,4,0,1,19,20,2,0,22,20,2,0
6480bb99cbb648c5c0ecb205,2023,,,2,Shubman Gill,WP Saha,41,25,7,0,1,29,15,6,0,10,10,1,0
6480bb99f33a7dd80eb0a544,2023,,,1,KL Rahul,KR Mayers,41,21,6,2,1,12,9,1,1,27,12,5,1
6480bb95a8153d4daac6e4f7,2019,,,2,RA Jadeja,SK Raina,41,24,6,0,0,31,17,5,0,9,7,1,0
6480bb96c880c7df4e055f14,2020/21,,,1,KA Pollard,RG Sharma,41,18,2,4,1,12,8,0,1,29,10,2,3
6480bb9f87652064dab6c573,2013,,,1,MS Gony,PP Chawla,41,19,3,3,1,33,14,2,3,6,5,1,0
6480bb9a8ac627a1ebf8dacf,2007/08,,,2,MEK Hussey,SK Raina,41,33,1,2,1,13,16,0,0,28,17,1,2
6480bb9c9685addc4a78d7d0,2009/10,,,1,MS Bisla,Yuvraj Singh,41,32,5,1,1,14,16,2,0,24,16,3,1
6480bb97c48a16e84b55a325,2020/21,,,1,AB de Villiers,AJ Finch,41,41,2,1,1,15,19,0,0,25,22,2,1
6480bb9763013a01eae041f2,2020/21,,,1,HH Pandya,KA Pollard,41,26,1,4,1,15,13,1,1,25,13,0,3
6480bb9abfe839459b1a28f6,2007/08,,,2,SE Marsh,Yuvraj Singh,41,24,6,0,1,26,15,4,0,14,9,2,0
6480bb9abfe839459b1a28f6,2007/08,,,2,RR Sarwan,SE Marsh,41,36,6,0,1,15,15,2,0,26,21,4,0
6480bba3bca9c998d5f3e3d0,2016,,,2,BCJ Cutting,Yuvraj Singh,41,22,1,4,0,18,11,0,2,20,11,1,2
6480bb99f47261f111a6cc1a,2023,,,1,Shubman Gill,V Shankar,41,30,4,1,1,25,18,3,0,15,12,1,1
6480bb95cf9d446747bd74fe,2019,,,1,RR Pant,S Dhawan,41,22,4,1,1,25,13,2,1,13,9,2,0
6480bb93575636076d81e4c5,2017,,,2,EJG Morgan,M Vohra,41,32,2,2,1,13,17,0,1,22,15,2,1
6480bba1017a98eead1ec861,2015,,,1,AM Rahane,DJ Hooda,41,21,1,4,1,22,12,0,2,19,9,1,2
6480bb988b447f26d7a96c0c,2022,,,2,D Brevis,Ishan Kishan,41,19,6,1,1,31,13,6,1,4,6,0,0
6480bba2f39653e2f61baca2,2015,,,2,SS Tiwary,Yuvraj Singh,41,20,5,2,1,7,7,1,0,32,13,4,2
6480bb9c07d77f83fb139c41,2009,,,2,S Sohal,SM Katich,41,27,5,1,1,30,17,4,1,9,10,1,0
6480bb9ab34d149420eae546,2023,,,1,PN Mankad,Q de Kock,41,25,5,1,1,26,20,5,0,10,5,0,1
6480bb9809c62ba77e5df472,2021,,,2,Shubman Gill,VR Iyer,41,32,4,1,1,29,18,4,0,12,14,0,1
6480bba0404171e13faa181e,2013,,,1,G Gambhir,JH Kallis,41,41,5,0,1,20,18,2,0,21,23,3,0
6480bba0c7bf2b92ac8d836a,2013,,,1,G Gambhir,MS Bisla,41,33,5,1,1,12,14,1,0,26,19,4,1
6480bb984a8abbb79a69e6ce,2022,,,2,AK Markram,R Shepherd,41,32,1,2,1,16,14,1,0,24,18,0,2
6480bba11eff9b230a172302,2014,,,2,AM Rahane,SV Samson,41,38,6,0,1,18,19,2,0,20,19,4,0
6480bb97a4220e27710e38de,2021,,,2,AD Russell,Shakib Al Hasan,41,24,4,2,1,30,13,3,2,10,11,1,0
6480bba26ca6ec72ba377236,2016,,,2,AB de Villiers,KL Rahul,41,28,3,1,1,17,15,1,0,24,13,2,1
6480bb94a964c10b5f10ae52,2017,,,1,AM Rahane,RA Tripathi,41,33,5,1,1,12,13,1,0,28,20,4,1
6480bb99773871f8e2ddc4b1,2022,,,2,LS Livingstone,S Dhawan,41,28,1,3,1,25,14,0,3,12,14,1,0
6480bb9523e6dc3c988ce398,2019,,,1,AD Nath,V Kohli,41,33,4,1,1,13,15,0,1,27,18,4,0
6480bb947a7c9fe868fc901a,2017,,,1,KK Nair,SS Iyer,41,30,5,1,1,26,22,5,0,10,8,0,1
6480bb9ddcbb8fbbad6614c8,2009/10,,,2,DPMD Jayawardene,IK Pathan,41,40,4,1,1,27,23,3,1,12,17,1,0
6480bba25855b7a7195a9bc5,2016,,,2,KH Pandya,RG Sharma,41,25,4,2,1,36,17,4,2,5,8,0,0
6480bb96f1eadf803ffc292c,2020/21,,,2,SPD Smith,YBK Jaiswal,41,34,2,2,1,24,17,2,1,14,17,0,1
6480bb99b0fa4d217ed7f255,2023,,,2,H Klaasen,Washington Sundar,41,26,4,1,1,26,17,2,1,15,9,2,0
6480bb9a9514379c05d59c38,2023,,,1,JO Holder,YBK Jaiswal,40,20,4,2,1,11,9,0,1,25,11,4,1
6480bba0b5eabeb0a150b93f,2013,,,1,CH Gayle,V Kohli,40,16,2,4,1,28,7,2,3,11,9,0,1
6480bba136257b71aa9952cf,2014,,,1,BB McCullum,RA Jadeja,40,35,2,1,1,11,15,0,0,27,20,2,1
6480bb9f2305d07e3c65be11,2013,,,2,DJ Hussey,PP Chawla,40,31,2,3,1,16,16,1,1,23,15,1,2
6480bb9482dff502bff80bcf,2017,,,1,KK Nair,SV Samson,40,25,4,2,1,16,6,2,1,24,19,2,1
6480bb9e83b8575f74b8e962,2012,,,1,F du Plessis,MS Dhoni,40,24,1,3,1,18,12,0,2,22,12,1,1
6480bb9ccba48a6bb44ccc21,2009,,,1,ML Hayden,S Badrinath,40,42,2,1,1,13,19,0,0,22,23,2,1
6480bb9802d8f5ec4413766d,2022,,,2,KS Williamson,RA Tripathi,40,26,1,3,1,20,15,0,2,17,11,1,1
6480bb9d8f5769d3a514fd88,2009/10,,,2,KA Pollard,SS Tiwary,40,14,1,4,0,33,13,1,3,6,1,0,1
6480bb94ca96a1c1f17d1294,2017,,,1,RA Tripathi,SPD Smith,40,31,3,1,1,26,17,2,1,14,14,1,0
6480bb9fe31a789bcb52d583,2012,,,1,JD Ryder,MJ Clarke,40,32,0,2,1,21,14,0,2,13,18,0,0
6480bba234aac105851964b1,2015,,,1,F du Plessis,MEK Hussey,40,37,3,0,1,21,22,2,0,17,15,1,0
6480bba2704d23da78c3eb15,2016,,,2,GJ Maxwell,WP Saha,40,35,5,0,1,13,15,2,0,24,20,3,0
6480bb97b945155c90dccd3d,2021,,,1,RA Tripathi,VR Iyer,40,26,5,1,1,21,12,2,1,17,14,3,0
6480bb978c66ea3d9c85132d,2020/21,,,1,S Dhawan,SS Iyer,40,34,1,1,1,18,14,0,1,21,20,1,0
6480bba358370ecde0231113,2016,,,1,MS Dhoni,NLTC Perera,40,27,1,2,1,21,14,1,1,17,13,0,1
6480bb9f0f1f6c03d8e2f039,2013,,,2,A Ashish Reddy,A Mishra,40,29,2,1,1,19,15,0,1,19,14,2,0
6480bb94fbd0b904d63e0e07,2017,,,2,KS Williamson,S Dhawan,40,26,2,1,1,16,11,0,1,22,15,2,0
6480bba264ad6b873d0d07d8,2016,,,1,BB McCullum,SK Raina,40,18,3,2,1,29,12,3,2,5,6,0,0
6480bb9e8dfd9ba30b93cbd8,2012,,,2,F du Plessis,SK Raina,40,28,4,2,1,23,16,1,2,16,12,3,0
6480bb9f54d17f50da495682,2012,,,1,M Vijay,SK Raina,40,31,1,3,0,12,11,0,1,28,20,1,2
6480bb9cc5312f3d7cfb650e,2009/10,,,2,KP Pietersen,RV Uthappa,40,15,3,2,1,13,7,2,0,22,8,1,2
6480bb937dc0a09df8f7aeee,2017,,,1,G Gambhir,RV Uthappa,40,26,4,1,1,13,10,1,0,26,16,3,1
6480bb9b82dc3ec84c520466,2009,,,2,MN van Wyk,WP Saha,40,31,2,1,1,19,17,2,0,21,14,0,1
6480bb96e2809aa0bc35c7e9,2019,,,2,MJ Guptill,WP Saha,40,24,6,1,1,14,9,1,1,25,15,5,0
6480bb9439fcd1191cf17a90,2017,,,1,AJ Finch,SK Raina,40,28,4,1,1,13,12,0,1,27,16,4,0
6480bb9b2de4e62ee60b7e5c,2009,,,2,KC Sangakkara,RS Bopara,40,35,3,1,1,26,18,2,1,13,17,1,0
6480bb9a7194d8b20952afae,2007/08,,,2,LRPL Taylor,W Jaffer,40,21,3,3,1,29,15,3,2,9,6,0,1
6480bb952f20835ddd6e533f,2019,,,2,SPD Smith,SV Samson,40,25,1,2,1,20,16,1,1,16,9,0,1
6480bb9698a1d9136a13faf6,2020/21,,,1,CJ Jordan,DJ Hooda,40,17,2,3,0,4,5,0,0,34,12,2,3
6480bb95945c5e5dc4d8c7d6,2019,,,2,PA Patel,V Kohli,40,21,7,1,1,17,9,2,1,23,12,5,0
6480bba0adee98d459585bed,2014,,,2,CM Gautam,KA Pollard,40,30,3,1,1,22,18,3,0,13,12,0,1
6480bb961cdee4d82c395517,2020/21,,,2,S Dhawan,SS Iyer,40,39,5,0,1,21,18,3,0,17,21,2,0
6480bb9ca668b7b36823fb21,2009,,,1,TM Dilshan,V Sehwag,40,20,3,3,1,24,14,2,2,14,6,1,1
6480bba1d3b4ddc36050e3f3,2014,,,1,M Vohra,WP Saha,40,28,1,4,1,24,15,0,3,15,13,1,1
6480bb9b2abb1e5479b853f5,2009,,,2,BJ Hodge,MN van Wyk,40,37,5,0,1,10,19,0,0,29,18,5,0
6480bb9dfb2e8e8c2002df86,2011,,,1,IR Jaggi,S Dhawan,40,29,5,1,1,16,14,3,0,24,15,2,1
6480bb9d85a6220ec9bc7dcb,2011,,,1,MR Marsh,Yuvraj Singh,40,30,2,2,1,11,15,1,0,26,15,1,2
6480bba2256bfaaf14c57ead,2015,,,1,KK Nair,SR Watson,40,22,5,1,1,16,10,3,0,22,12,2,1
6480bb9c757dbd7f92b1130a,2009/10,,,2,DJ Bravo,SR Tendulkar,40,26,5,1,1,23,16,3,1,13,10,2,0
6480bb9ee7a29c9b96ed61e5,2011,,,2,CL White,S Dhawan,40,23,3,1,0,15,12,0,0,25,11,3,1
6480bb9f4780a208e13bfb3d,2013,,,2,R Dravid,STR Binny,40,27,5,1,1,7,7,1,0,33,20,4,1
6480bb94457bfc7687322f80,2017,,,1,Mandeep Singh,P Negi,40,25,3,2,1,4,6,0,0,32,19,3,2
6480bb9fcbbfd8053f253537,2012,,,1,DA Warner,V Sehwag,40,21,4,2,1,15,12,1,1,23,9,3,1
6480bb9802d8f5ec4413766d,2022,,,1,DA Miller,HH Pandya,40,33,1,1,1,12,15,0,0,22,18,1,1
6480bb9b62eb35d78fcd7df0,2007/08,,,1,DJ Hussey,Salman Butt,40,38,4,0,1,9,15,0,0,28,23,4,0
6480bb9651b51fdcda05e4c8,2020/21,,,1,EJG Morgan,PJ Cummins,40,23,2,3,1,22,12,2,2,15,11,0,1
6480bb948211fe47e65f2e77,2018,,,2,KH Pandya,SA Yadav,40,39,6,0,1,24,20,4,0,16,19,2,0
6480bb96f1eadf803ffc292c,2020/21,,,1,HV Patel,SO Hetmyer,40,21,1,4,1,7,8,0,0,31,13,1,4
6480bb9d80536875f41bc605,2011,,,2,AT Rayudu,SR Tendulkar,40,35,4,0,1,21,20,2,0,12,15,2,0
6480bba0fee4ae82492a666f,2013,,,2,RA Jadeja,SK Raina,40,15,6,1,0,14,6,3,0,24,9,3,1
6480bb9b283b30d0503656f7,2007/08,,,2,SB Styris,Y Venugopal Rao,40,29,4,0,1,22,15,2,0,18,14,2,0
6480bb9836d24b9817a35f7d,2022,,,1,A Badoni,KH Pandya,40,23,5,1,1,19,11,2,1,20,12,3,0
6480bb948f3284f793b2763c,2018,,,2,Q de Kock,V Kohli,40,25,6,1,1,19,12,2,1,19,13,4,0
6480bb9a07d46704efe103ef,2007/08,,,2,CL White,R Dravid,40,28,3,2,1,16,16,0,1,24,12,3,1
6480bb9eb2690fb1ed356b42,2011,,,1,Harbhajan Singh,KA Pollard,40,22,4,2,1,16,10,1,1,23,12,3,1
6480bb9a61edc0c77bc4bc86,2007/08,,,2,JA Morkel,MS Dhoni,40,24,3,3,1,30,15,2,3,8,9,1,0
6480bb96ec01f8fb3504bc36,2020/21,,,1,JC Archer,R Tewatia,40,21,1,4,0,16,10,1,1,23,11,0,3
6480bb9c50838010977c168c,2009,,,1,GJ Bailey,PA Patel,40,29,6,1,1,15,12,3,0,25,17,3,1
6480bb9574ca455ec008e942,2018,,,2,CA Lynn,SP Narine,40,20,5,2,1,12,7,1,1,26,13,4,1
6480bb95a8153d4daac6e4f7,2019,,,2,MS Dhoni,SK Raina,40,27,2,2,1,16,13,0,1,24,14,2,1
6480bb976caaa0cc91f652c7,2021,,,2,Shubman Gill,VR Iyer,40,18,4,3,1,13,9,1,1,27,9,3,2
6480bb97a4220e27710e38de,2021,,,2,EJG Morgan,Shakib Al Hasan,40,31,1,3,1,24,17,1,2,16,14,0,1
6480bb9746dfc5c467942a84,2021,,,2,AF Milne,SS Tiwary,40,28,2,1,1,15,15,0,1,22,13,2,0
6480bba08cc4182f0127f2e2,2013,,,1,DR Smith,SR Tendulkar,40,41,3,2,1,22,23,2,1,15,18,1,1
6480bb98436587de59527f2e,2022,,,2,Lalit Yadav,PP Shaw,40,31,4,1,1,7,14,0,0,31,17,4,1
6480bb9d967f5a4cfbd8c74d,2011,,,2,G Gambhir,MK Tiwary,40,34,3,1,1,10,13,1,0,27,21,2,1
6480bb9ef18c54e7aafdd223,2012,,,1,DB Das,RN ten Doeschate,40,29,4,1,1,28,15,3,1,11,14,1,0
6480bb9c12e6c723b248799b,2009,,,2,A Symonds,HH Gibbs,40,32,5,1,1,33,21,4,1,6,11,1,0
6480bb9a40966b9b90fcdf2e,2023,,,1,Harpreet Brar,M Shahrukh Khan,40,16,5,2,0,17,9,2,1,21,7,3,1
6480bb948f3284f793b2763c,2018,,,1,KH Pandya,RG Sharma,40,25,4,2,1,15,12,1,1,24,13,3,1
6480bb9940bd3bf36dd4897f,2023,,,1,DA Miller,HH Pandya,40,26,1,3,1,5,10,0,0,34,16,1,3
6480bb9cff4ec2f71cdf18d1,2009/10,,,1,KA Pollard,S Dhawan,40,28,4,1,1,20,13,2,1,18,15,2,0
6480bb9b3a5e1af467fb027b,2009,,,1,JH Kallis,RV Uthappa,40,29,7,0,1,24,19,5,0,12,10,2,0
6480bb9f68a0a232d83c338c,2012,,,1,AB de Villiers,TM Dilshan,40,30,3,1,1,14,13,1,0,24,17,2,1
6480bb98cce4ab46512c2c03,2022,,,2,A Badoni,E Lewis,40,13,2,3,0,19,9,0,2,16,4,2,1
6480bb9aef150645306cc170,2023,,,2,AR Patel,RV Patel,40,19,2,2,0,26,11,1,2,11,8,1,0
6480bb96acacf3be646d300a,2020/21,,,2,AM Rahane,SO Hetmyer,40,25,5,1,1,19,12,2,1,16,13,3,0
6480bb96c40b697b63d08717,2019,,,2,RR Pant,SE Rutherford,40,21,2,4,1,31,9,2,3,9,12,0,1
6480bba250b404cdcbff22c8,2015,,,1,F du Plessis,SK Raina,40,31,1,2,1,12,11,1,0,25,20,0,2
6480bba071a7a0cbb02d505a,2013,,,2,DA Miller,DJ Hussey,40,39,2,1,1,16,18,1,0,20,21,1,1
6480bb96a467817b9b68ca94,2020/21,,,2,KS Williamson,PK Garg,40,29,4,0,1,21,11,3,0,16,18,1,0
6480bba0ffae8617ee64bd19,2013,,,2,DA Warner,RE van der Merwe,39,32,1,1,1,21,16,0,1,14,16,1,0
6480bb9f0f959bc6104820c3,2013,,,1,DA Warner,UBT Chand,39,34,4,1,1,13,15,2,0,23,19,2,1
6480bba1553f17c77d5f1ca2,2014,,,1,AJ Finch,KL Rahul,39,29,4,2,1,29,16,3,2,10,13,1,0
6480bb9b50f9e801edc13d5a,2007/08,,,1,P Kumar,R Vinay Kumar,39,25,3,1,1,7,8,1,0,23,17,2,1
6480bb9bb7a4f1e16df25c8e,2009,,,2,AA Bilakhia,HH Gibbs,39,26,2,1,0,12,14,1,0,20,12,1,1
6480bba11c977a5d11c1aa38,2015,,,2,JP Duminy,Yuvraj Singh,39,27,3,2,1,28,15,3,2,9,12,0,0
6480bb9a577cde04d3672225,2023,,,2,AM Rahane,S Dube,39,23,2,2,1,27,13,2,2,11,10,0,0
6480bb96b7b695186bbb6a3e,2019,,,1,HH Pandya,KA Pollard,39,22,2,3,1,16,10,1,1,23,12,1,2
6480bba1ff55936e203ca5a6,2014,,,1,GJ Maxwell,V Sehwag,39,32,3,1,1,14,14,1,0,25,18,2,1
6480bba01a3f8444c7a33ba6,2014,,,2,R Ashwin,RA Jadeja,39,31,2,0,0,9,13,1,0,23,18,1,0
6480bb9cba868c69775db687,2009,,,1,LRPL Taylor,V Kohli,39,23,1,4,0,17,12,0,2,20,11,1,2
6480bb9f9eae77e599a46300,2012,,,1,KD Karthik,SR Tendulkar,39,40,4,0,1,9,15,0,0,24,25,4,0
6480bb9825eb960aded1ff64,2022,,,2,DA Miller,R Tewatia,39,28,2,3,1,33,14,2,3,6,14,0,0
6480bb981dc3f7250f93bc92,2022,,,1,KL Rahul,MP Stoinis,39,25,2,2,1,23,11,1,2,10,14,1,0
6480bba2563745309ee2bdfb,2016,,,2,DA Miller,WP Saha,39,25,4,0,1,18,13,1,0,21,12,3,0
6480bb95014388d3e8c62904,2019,,,2,CA Ingram,SS Iyer,39,29,5,1,1,22,21,2,1,15,8,3,0
6480bb9bcc2f6123673672d0,2007/08,,,1,MK Tiwary,S Dhawan,39,35,5,0,1,24,20,4,0,14,15,1,0
6480bba223f162806c0794ac,2015,,,2,AT Rayudu,RG Sharma,39,31,0,2,1,22,14,0,2,17,17,0,0
6480bb989bf19eb260a04f0e,2022,,,1,N Rana,SS Iyer,39,33,5,0,1,17,15,3,0,19,18,2,0
6480bba0e52e9733fc6d9937,2013,,,2,DJ Hussey,SE Marsh,39,20,6,1,1,32,15,5,1,7,5,1,0
6480bb9dd10e35e6145534dc,2011,,,1,KC Sangakkara,S Dhawan,39,36,6,0,1,24,26,4,0,14,10,2,0
6480bb982f070b023b901b3e,2021,,,2,R Ashwin,SS Iyer,39,36,2,1,0,20,21,0,1,17,15,2,0
6480bb9f58a3e7ea877fc9dc,2012,,,1,CL White,DJ Harris,39,31,3,1,1,8,13,1,0,25,18,2,1
6480bb989bf19eb260a04f0e,2022,,,1,AD Russell,N Rana,39,26,4,2,1,26,16,2,2,11,10,2,0
6480bba06e8cb70fb4bdc83e,2013,,,1,CH Gayle,MA Agarwal,39,31,5,2,1,10,11,2,0,29,20,3,2
6480bb9c37b72d7a51019794,2009/10,,,1,A Symonds,RG Sharma,39,33,4,0,1,15,20,2,0,21,13,2,0
6480bb9b09e6c98206422ae5,2009,,,2,AD Mascarenhas,RA Jadeja,39,44,1,0,1,17,21,1,0,20,23,0,0
6480bba22349149c9ec92d49,2016,,,2,PA Patel,RG Sharma,39,24,6,1,1,21,15,4,0,17,9,2,1
6480bb9eb2690fb1ed356b42,2011,,,2,KC Sangakkara,S Sohal,39,42,1,2,1,27,28,1,1,11,14,0,1
6480bb94704f6dfeb7f4d270,2017,,,2,CA Lynn,SP Narine,39,22,8,0,1,21,12,4,0,18,10,4,0
6480bb951677500061c85592,2019,,,1,AS Joseph,KA Pollard,39,13,2,4,0,0,0,0,0,37,13,2,4
6480bb9746dfc5c467942a84,2021,,,1,DJ Bravo,RD Gaikwad,39,16,1,4,1,23,8,0,3,15,8,1,1
6480bb97a42828c5a5ebef1c,2020/21,,,1,Ishan Kishan,KH Pandya,39,23,3,2,1,26,13,3,1,13,10,0,1
6480bb9bb7a4f1e16df25c8e,2009,,,2,HH Gibbs,RG Sharma,39,37,2,1,1,20,18,2,0,18,19,0,1
6480bb9e502d7987de08e5d5,2012,,,2,PA Patel,S Dhawan,39,24,3,2,1,19,13,2,1,16,11,1,1
6480bb9d872bbb611f6266cb,2011,,,1,PC Valthaty,SE Marsh,39,26,4,1,1,27,12,4,1,12,14,0,0
6480bb9f4bdcea2f81049fe9,2012,,,2,DJ Bravo,M Vijay,39,17,3,2,1,33,12,3,2,4,5,0,0
6480bb9df46e9f48932124df,2009/10,,,2,DA Warner,V Sehwag,39,22,6,1,1,31,15,5,1,5,7,1,0
6480bba2ad3f26917361061f,2016,,,2,Q de Kock,SV Samson,39,28,6,0,1,29,14,6,0,9,14,0,0
6480bba223f162806c0794ac,2015,,,1,F du Plessis,MS Dhoni,39,37,1,2,1,17,16,0,1,22,21,1,1
6480bba3041017fe2c0593f2,2016,,,2,AB de Villiers,STR Binny,39,25,4,1,1,17,10,2,0,21,15,2,1
6480bb9482dff502bff80bcf,2017,,,1,CJ Anderson,SS Iyer,39,26,0,3,1,15,12,0,1,24,14,0,2
6480bb9ce544a2fc17a48bee,2009,,,2,BB McCullum,WP Saha,39,17,5,1,0,26,12,5,0,10,5,0,1
6480bb963c729ccbcb9446f8,2020/21,,,1,N Rana,Shubman Gill,39,34,4,1,1,28,17,3,1,11,17,1,0
6480bb94704f6dfeb7f4d270,2017,,,1,M Vohra,MJ Guptill,39,29,5,0,1,25,16,4,0,11,13,1,0
6480bb9d8f5769d3a514fd88,2009/10,,,2,AM Nayar,AT Rayudu,39,28,5,0,1,20,14,2,0,17,14,3,0
6480bba0be153677ce53c58e,2014,,,2,DA Miller,GJ Bailey,39,19,3,2,0,22,9,1,2,17,10,2,0
6480bb9b2a5f2fd5053534dc,2007/08,,,2,IK Pathan,LA Pomersbach,39,14,5,2,0,9,5,0,1,28,9,5,1
6480bb9ab34d149420eae546,2023,,,2,RK Singh,VG Arora,39,12,4,3,0,36,11,4,3,1,1,0,0
6480bba1743abcb135a6a4c7,2015,,,2,SPD Smith,STR Binny,39,25,4,0,1,16,12,2,0,13,13,2,0
6480bb95d675b7da24db1a57,2019,,,1,AD Russell,CR Brathwaite,39,19,1,4,1,34,14,1,4,5,5,0,0
6480bb96ec01f8fb3504bc36,2020/21,,,1,MK Lomror,RV Uthappa,39,36,2,1,1,22,19,1,1,17,17,1,0
6480bb972a7d4e1071ea662e,2021,,,1,Ishan Kishan,J Yadav,39,34,2,1,1,20,17,1,1,19,17,1,0
6480bb9c71030f4c6f018f55,2009,,,1,A Symonds,HH Gibbs,39,45,2,0,1,23,21,1,0,15,24,1,0
6480bba000b91f6c5cf57fdb,2013,,,2,AM Rahane,R Dravid,39,45,2,2,1,12,21,0,1,25,24,2,1
6480bb99358a21ba3487db81,2023,,,1,RA Tripathi,Washington Sundar,39,50,3,0,1,23,25,3,0,14,25,0,0
6480bb9b4fc6889967a3cd54,2007/08,,,2,SR Tendulkar,ST Jayasuriya,39,17,6,2,1,2,2,0,0,36,15,6,2
6480bb9b9614f21d90333e15,2007/08,,,2,M Rawat,YK Pathan,39,24,5,1,1,22,16,2,1,16,8,3,0
6480bb9894cc2d00f057a1f1,2021,,,1,MP Stoinis,S Dhawan,39,44,2,0,1,18,23,1,0,18,21,1,0
6480bb9df57ec21d17310ad2,2011,,,1,G Gambhir,JH Kallis,39,25,3,1,1,12,9,1,0,23,16,2,1
6480bb99695e001cdaca81e0,2022,,,1,DJ Bravo,MS Dhoni,39,29,2,2,1,12,15,0,1,18,14,2,1
6480bb97746881ab34c38bf8,2020/21,,,2,HH Pandya,Ishan Kishan,39,28,0,3,1,15,13,0,1,23,15,0,2
6480bb9fe3bc767415c60bfa,2012,,,2,BB McCullum,JH Kallis,39,41,2,1,1,17,17,0,1,21,24,2,0
6480bb98373b1ea5035ab3da,2021,,,2,LH Ferguson,Shivam Mavi,39,21,2,3,1,15,8,1,1,20,13,1,2
6480bba07fa24b891b818984,2013,,,2,KA Pollard,R Dhawan,39,25,3,1,1,20,14,1,1,13,11,2,0
6480bb953aab41e7ed166b9d,2019,,,2,KH Pandya,Yuvraj Singh,39,22,5,1,1,32,15,5,1,5,7,0,0
6480bb9a6935abf34d88ca97,2007/08,,,2,JDP Oram,MEK Hussey,39,20,2,3,1,13,10,0,1,24,10,2,2
6480bb9c54a72690027ba3d4,2009/10,,,2,KA Pollard,SR Tendulkar,39,20,6,1,1,20,9,3,1,18,11,3,0
6480bba326249b668a4713d6,2016,,,2,AJ Finch,KD Karthik,39,16,5,2,1,29,10,3,2,10,6,2,0
6480bba071a7a0cbb02d505a,2013,,,1,DA Warner,MC Juneja,39,39,3,1,1,25,19,2,1,14,20,1,0
6480bb93182304739a535742,2017,,,2,CH Morris,CJ Anderson,39,10,4,3,0,38,9,4,3,1,1,0,0
6480bb9d02d996f85dd5e945,2011,,,1,BB McCullum,DPMD Jayawardene,39,27,4,3,1,22,16,2,2,16,11,2,1
6480bb94704f6dfeb7f4d270,2017,,,2,CA Lynn,G Gambhir,39,35,3,1,1,29,17,3,1,8,18,0,0
6480bb9d182be5b0fbe5a4e2,2011,,,1,J Botha,SR Watson,39,43,2,2,1,25,22,1,1,14,21,1,1
6480bba0a4e7c61a5656729e,2014,,,1,GJ Bailey,R Dhawan,39,36,4,0,0,15,14,1,0,23,22,3,0
6480bb9480627b50308b7903,2017,,,2,N Rana,PA Patel,39,34,2,1,1,19,16,1,1,19,18,1,0
6480bb983ad1bab18d1d8774,2022,,,2,SE Rutherford,Shahbaz Ahmed,39,31,1,3,1,10,11,1,0,27,20,0,3
6480bb9a43249ece8e841e56,2023,,,1,KD Karthik,KM Jadhav,39,24,5,1,1,29,17,4,1,10,7,1,0
6480bb966c197bad273f91f1,2020/21,,,1,RG Sharma,SA Yadav,39,26,5,1,1,10,9,0,1,24,17,5,0
6480bb9aef150645306cc170,2023,,,1,AK Markram,Abhishek Sharma,39,28,5,1,1,8,13,0,0,31,15,5,1
6480bb9df46e9f48932124df,2009/10,,,1,AT Rayudu,SS Tiwary,39,26,2,2,1,13,11,1,0,26,15,1,2
6480bb9b166300b6298fc71a,2009,,,2,LA Carseldine,RA Jadeja,39,16,5,1,1,9,6,1,0,28,10,4,1
6480bba2563745309ee2bdfb,2016,,,1,JP Faulkner,P Kumar,39,25,5,0,1,23,12,3,0,15,13,2,0
6480bb966c9efd5bf35d10b9,2019,,,1,AD Russell,KD Karthik,39,32,1,3,1,14,14,0,1,23,18,1,2
6480bb9ca5c1d511ad78e92d,2009,,,2,KD Karthik,Y Nagar,39,32,2,0,1,16,12,1,0,20,20,1,0
6480bb94ebff9a116f68560b,2018,,,1,CA Lynn,N Rana,39,30,5,1,1,21,14,3,0,18,16,2,1
6480bb99ecbdaaf953b8eee5,2023,,,2,A Badoni,K Gowtham,39,22,0,1,1,13,11,0,0,17,11,0,1
6480bb9d86effd7e5e6a5261,2011,,,2,AB de Villiers,SS Tiwary,39,25,2,1,1,21,12,2,1,14,13,0,0
6480bb96593f4f87a2c294bc,2020/21,,,1,AB de Villiers,S Dube,39,22,3,2,1,32,15,3,2,7,7,0,0
6480bb96b56e8d513b451da1,2020/21,,,2,Gurkeerat Singh,V Kohli,39,41,6,0,0,21,24,4,0,18,17,2,0
6480bb9fd26b695cee9d8761,2013,,,2,BJ Hodge,JP Faulkner,39,25,4,1,0,17,11,3,0,19,14,1,1
6480bb98323919fff9902666,2022,,,2,SV Samson,YBK Jaiswal,39,25,5,1,1,23,12,4,0,16,13,1,1
6480bb98bc3569cc8d04101a,2022,,,1,D Brevis,Ishan Kishan,39,30,3,2,1,29,19,2,2,10,11,1,0
6480bba3de527604cd2f96f3,2016,,,2,DA Warner,MC Henriques,39,24,4,1,1,20,11,2,1,18,13,2,0
6480bb995f3db9699a1f794d,2022,,,2,R Ashwin,R Parag,39,20,3,2,0,25,10,2,2,10,10,1,0
6480bb95e435367dc64d9844,2019,,,2,AM Rahane,SV Samson,39,22,7,0,1,12,12,2,0,22,10,5,0
6480bba1017a98eead1ec861,2015,,,2,M Vijay,SE Marsh,39,26,2,2,1,19,10,0,2,19,16,2,0
6480bb9802d8f5ec4413766d,2022,,,2,AK Markram,N Pooran,39,18,3,2,0,12,8,1,0,26,10,2,2
6480bb9b283b30d0503656f7,2007/08,,,2,RG Sharma,SB Styris,39,26,3,2,1,32,13,3,2,7,13,0,0
6480bb9c13fa57328b17e4e2,2009/10,,,1,KD Karthik,M Manhas,39,23,6,0,1,17,11,2,0,22,12,4,0
6480bb9f58a3e7ea877fc9dc,2012,,,2,DJ Hussey,Mandeep Singh,39,26,3,2,1,16,16,1,1,20,10,2,1
6480bba03a099a1a2e9c3dc5,2013,,,2,BJ Rohrer,CM Gautam,39,18,3,3,1,28,11,1,3,11,7,2,0
6480bba25855b7a7195a9bc5,2016,,,1,JP Duminy,P Negi,39,22,3,1,0,24,12,2,1,10,10,1,0
6480bb9be7cbbb90a12dc916,2009,,,2,SR Tendulkar,ST Jayasuriya,39,35,6,0,1,12,15,1,0,26,20,5,0
6480bba26ca6ec72ba377236,2016,,,2,AB de Villiers,Sachin Baby,39,20,2,3,1,25,12,1,2,13,8,1,1
6480bb99f47261f111a6cc1a,2023,,,2,C Green,Ishan Kishan,39,33,1,2,1,23,16,0,2,12,17,1,0
6480bb93ec7e3351941d3b5b,2017,,,1,DJ Hooda,Yuvraj Singh,39,20,3,2,1,15,10,0,1,22,10,3,1
6480bb99409885bcc7b67109,2023,,,1,SV Samson,YBK Jaiswal,39,29,2,1,1,17,17,1,0,20,12,1,1
6480bb9b9d7aa6d8e47576d7,2007/08,,,1,PA Patel,S Vidyut,39,32,4,1,1,21,18,3,0,16,14,1,1
6480bb9a7f7a862ba0b2c59e,2007/08,,,1,MS Dhoni,SK Raina,39,40,4,0,1,22,27,2,0,16,13,2,0
6480bb9cb881721acc1bab60,2009,,,1,RG Sharma,Y Venugopal Rao,38,19,2,2,0,28,12,2,2,7,7,0,0
6480bb96ec7d98e34055e8fc,2020/21,,,1,JC Archer,TK Curran,38,12,1,4,0,27,8,0,4,8,4,1,0
6480bba2c04b3acd88a50839,2015,,,1,G Gambhir,RV Uthappa,38,27,5,1,1,12,10,2,0,23,17,3,1
6480bb9dd778cb6c44535092,2009/10,,,1,BB McCullum,DJ Hussey,38,22,2,1,0,11,8,1,0,20,14,1,1
6480bb960d9d6af315534958,2019,,,1,Mandeep Singh,SM Curran,38,24,2,2,1,15,10,0,1,23,14,2,1
6480bb9825eb960aded1ff64,2022,,,1,RA Jadeja,S Dube,38,22,2,2,1,22,12,0,2,16,10,2,0
6480bb9d967f5a4cfbd8c74d,2011,,,1,Y Nagar,Y Venugopal Rao,38,21,2,2,1,18,8,0,2,17,13,2,0
6480bb99433f6e11060ba714,2022,,,2,JM Bairstow,S Dhawan,38,24,5,1,1,28,15,4,1,9,9,1,0
6480bb960d9d6af315534958,2019,,,2,RV Uthappa,Shubman Gill,38,27,3,1,1,22,14,2,1,16,13,1,0
6480bba19cc161a3fb8a8795,2014,,,1,GJ Bailey,R Dhawan,38,20,3,2,1,25,12,1,2,13,8,2,0
6480bb98f01e4672b988c112,2022,,,2,DJ Hooda,Q de Kock,38,34,3,1,1,25,24,3,0,13,10,0,1
6480bb966c9efd5bf35d10b9,2019,,,1,KD Karthik,SP Narine,38,19,4,3,1,27,11,3,2,11,8,1,1
6480bba3b818a7cff6fe4f89,2016,,,2,C Munro,G Gambhir,38,31,3,1,1,16,17,1,0,18,14,2,1
6480bba0dcd1149b9b0b501f,2013,,,2,MK Tiwary,RN ten Doeschate,38,18,5,1,1,13,7,2,0,24,11,3,1
6480bb9ea1e127d68e288e04,2011,,,2,BB McCullum,BJ Hodge,38,43,3,0,1,17,21,1,0,18,22,2,0
6480bba1af9481df8b4f9f0f,2015,,,2,CH Gayle,HV Patel,38,13,2,4,1,31,11,2,3,6,2,0,1
6480bba0be153677ce53c58e,2014,,,1,DR Smith,SK Raina,38,23,3,2,1,22,12,1,2,14,11,2,0
6480bb9b46b4360184dc19f3,2007/08,,,1,WPUJC Vaas,Y Venugopal Rao,38,20,3,2,1,9,8,0,0,28,12,3,2
6480bb9575ad32214d0f6ec0,2019,,,2,JC Buttler,RA Tripathi,38,25,1,2,1,23,17,1,2,8,8,0,0
6480bb9c2778066dafd78a71,2009/10,,,1,JM Kemp,MS Dhoni,38,27,3,1,1,21,15,1,1,16,12,2,0
6480bb9c6f1c8ea3dc73226f,2009/10,,,2,SR Tendulkar,ST Jayasuriya,38,22,6,0,1,27,12,5,0,7,10,1,0
6480bb9f022f0e8cd6e9cdeb,2012,,,1,LRPL Taylor,Y Venugopal Rao,38,20,4,1,1,27,12,3,1,10,8,1,0
6480bba1587a54176a9badf4,2014,,,1,Shakib Al Hasan,YK Pathan,38,14,2,4,1,1,5,0,0,36,9,2,4
6480bb93d5dc00a79edede9c,2017,,,1,KH Pandya,N Rana,38,21,3,3,1,37,20,3,3,1,1,0,0
6480bb96c880c7df4e055f14,2020/21,,,2,KL Rahul,MA Agarwal,38,29,4,0,1,12,11,1,0,25,18,3,0
6480bb977f55a1c473670850,2021,,,2,HH Pandya,Ishan Kishan,38,18,2,3,0,5,6,0,0,30,12,2,3
6480bb9f36ad55c3c7fd6548,2012,,,2,G Gambhir,MK Tiwary,38,42,2,1,1,22,20,2,1,13,22,0,0
6480bb99d2bd76016d47896d,2023,,,2,DA Warner,RR Rossouw,38,30,3,1,1,7,10,0,0,30,20,3,1
6480bb9b3a5e1af467fb027b,2009,,,2,MS Dhoni,SK Raina,38,34,0,2,1,16,14,0,1,21,20,0,1
6480bba04b49d2ff5f997e02,2013,,,1,AJ Finch,RV Uthappa,38,31,4,1,1,13,11,1,1,24,20,3,0
6480bb9d5cca30c933d4baf4,2011,,,1,PC Valthaty,SE Marsh,38,32,3,1,1,13,18,0,1,21,14,3,0
6480bb9b0b09749af4aa32dd,2009,,,1,IK Pathan,RS Bopara,38,24,5,1,1,32,17,5,1,6,7,0,0
6480bb94834e2b780c4782b5,2017,,,2,AT Rayudu,KA Pollard,38,17,3,3,1,27,10,3,2,11,7,0,1
6480bb99350726d00af209bf,2022,,,2,N Pooran,RA Tripathi,38,23,5,1,1,19,14,2,1,16,9,3,0
6480bb9c7a11e1cbeea46b0e,2009/10,,,2,GC Smith,NV Ojha,38,29,6,0,1,26,17,4,0,12,12,2,0
6480bb943565d22d24ec0ae8,2017,,,1,KS Williamson,Yuvraj Singh,38,22,4,0,1,31,16,4,0,6,6,0,0
6480bb9575ad32214d0f6ec0,2019,,,1,CH Gayle,KL Rahul,38,34,2,3,1,30,22,2,3,4,12,0,0
6480bb99b0fa4d217ed7f255,2023,,,1,DA Warner,MR Marsh,38,25,6,1,1,12,10,1,1,25,15,5,0
6480bb95e25835586d412978,2018,,,2,E Lewis,SA Yadav,38,34,2,2,1,10,13,0,0,28,21,2,2
6480bb9c0dec1a788da66d33,2009/10,,,1,AC Voges,NV Ojha,38,29,2,2,1,17,16,1,0,21,13,1,2
6480bb9f03dd3a09740f0bd0,2013,,,1,AM Rahane,BJ Hodge,38,31,4,1,1,12,14,0,1,25,17,4,0
6480bb9af85f41b4de44ca19,2023,,,2,Rashid Khan,V Shankar,38,18,2,3,1,26,12,2,2,10,6,0,1
6480bba23ed328dbb847b4e7,2016,,,1,SR Watson,Sachin Baby,38,16,6,1,1,19,8,4,0,16,8,2,1
6480bb9dc4ec5a52f8bcc465,2009/10,,,1,KC Sangakkara,Yuvraj Singh,38,38,2,1,1,21,17,1,1,15,21,1,0
6480bb99bbae76f3f761d060,2023,,,1,AM Rahane,RA Jadeja,38,13,2,4,1,20,5,2,2,18,8,0,2
6480bb94c008939d7976abfe,2018,,,1,JC Buttler,RA Tripathi,38,24,1,3,1,21,13,1,2,15,11,0,1
6480bb9fd4a1af6234c9e57c,2012,,,2,Mandeep Singh,SE Marsh,38,28,5,1,1,27,18,4,1,8,10,1,0
6480bb964752e7c0f9e39d3c,2020/21,,,2,HH Pandya,Q de Kock,38,20,4,2,0,21,11,3,1,17,9,1,1
6480bb9df57ec21d17310ad2,2011,,,2,B Chipli,KC Sangakkara,38,34,5,0,1,21,19,3,0,16,15,2,0
6480bb9e300070746cc2eb67,2011,,,2,SS Tiwary,Z Khan,38,34,2,1,1,17,13,0,1,21,21,2,0
6480bba26bb69626041c4ba1,2015,,,2,AD Russell,RV Uthappa,38,18,4,2,1,32,12,4,2,6,6,0,0
6480bb9f218f37b46bef4afb,2013,,,2,LJ Wright,SPD Smith,38,13,6,1,1,34,10,6,1,2,3,0,0
6480bb9e9f1ef9ac02266570,2011,,,2,MK Pandey,SC Ganguly,38,30,4,2,1,30,21,3,2,8,9,1,0
6480bb98825d8ceb716e3f3c,2022,,,2,KS Williamson,N Pooran,38,27,0,3,1,16,12,0,1,21,15,0,2
6480bb9bb7a4f1e16df25c8e,2009,,,1,ML Hayden,MS Dhoni,38,34,2,1,1,14,12,1,0,22,22,1,1
6480bb9a40966b9b90fcdf2e,2023,,,2,JJ Roy,Rahmanullah Gurbaz,38,28,5,1,1,21,16,4,0,15,12,1,1
6480bb9435048f20502ba1e1,2018,,,1,M Vohra,Q de Kock,38,30,3,3,1,30,17,2,3,7,13,1,0
6480bb9c8cbb5dec60b7d50a,2009/10,,,2,HH Gibbs,VVS Laxman,38,24,3,2,1,25,13,2,2,9,11,1,0
6480bb9c44492d9e5fc4bb60,2009/10,,,2,JH Kallis,R Dravid,38,30,4,0,1,14,14,1,0,21,16,3,0
6480bb9bb070eb19f9ac8a76,2007/08,,,2,RG Sharma,Y Venugopal Rao,38,17,3,3,1,37,14,3,3,1,3,0,0
6480bb9c5ec0713155cad138,2009/10,,,1,AC Gilchrist,HH Gibbs,38,33,2,1,1,18,14,0,1,17,19,2,0
6480bb93d5dc00a79edede9c,2017,,,1,N Rana,PA Patel,38,29,4,1,1,21,19,1,1,17,10,3,0
6480bb9c7a11e1cbeea46b0e,2009/10,,,1,SR Tendulkar,ST Jayasuriya,38,21,5,1,1,12,7,2,0,23,14,3,1
6480bb964a4d5a1709db428e,2020/21,,,2,DJ Hooda,KL Rahul,38,24,3,1,1,13,9,0,1,24,15,3,0
6480bb9ea75f51e7a33e90ed,2012,,,1,DJ Bravo,JA Morkel,38,25,0,2,1,28,17,0,2,8,8,0,0
6480bb962fbc99d08dc59f56,2020/21,,,1,AJ Finch,D Padikkal,38,25,2,2,1,15,13,1,1,18,12,1,1
6480bb94566b0cf89fca84f9,2018,,,1,MS Dhoni,SK Raina,38,20,5,1,0,25,12,3,1,13,8,2,0
6480bb9c9685addc4a78d7d0,2009/10,,,1,DPMD Jayawardene,KC Sangakkara,38,37,2,0,1,16,15,1,0,22,22,1,0
6480bb9ab99ef699d66ad5a0,2023,,,2,TH David,Tilak Varma,38,16,3,3,0,12,6,2,0,26,10,1,3
6480bb9993e6e474a4e37366,2023,,,1,Ishan Kishan,RG Sharma,38,24,6,1,1,15,11,3,0,21,13,3,1
6480bba2e8614b1263627c1b,2015,,,2,EJG Morgan,S Dhawan,38,23,2,2,1,17,12,1,1,19,11,1,1
6480bb95f282ca61c07afe9b,2018,,,1,Mohammed Siraj,TG Southee,38,29,3,1,1,3,7,0,0,34,22,3,1
6480bb9e713e850d3dd0cba9,2012,,,2,B Lee,MK Tiwary,38,22,3,2,1,25,11,2,2,12,11,1,0
6480bb9c6f1c8ea3dc73226f,2009/10,,,1,TM Dilshan,V Sehwag,38,22,6,0,1,17,12,3,0,19,10,3,0
6480bba120182b9ca0b70004,2014,,,1,AP Tare,KA Pollard,38,14,2,3,1,7,5,1,0,30,9,1,3
6480bb99b0fa4d217ed7f255,2023,,,2,MA Agarwal,RA Tripathi,38,39,2,0,1,25,22,2,0,12,17,0,0
6480bb96d1b3bea0aa2127e4,2020/21,,,2,PJ Cummins,Shivam Mavi,38,11,2,4,1,31,9,1,4,5,2,1,0
6480bb9bee2e48d9c41b1e23,2009,,,1,M Vijay,MS Dhoni,38,32,0,2,1,16,18,0,1,16,14,0,1
6480bb9dc4ec5a52f8bcc465,2009/10,,,2,JP Duminy,KA Pollard,38,25,3,1,1,18,11,1,1,18,14,2,0
6480bba03ef1ed797291b091,2013,,,2,PA Patel,S Dhawan,38,23,5,1,1,26,14,5,0,9,9,0,1
6480bb9b9dd7fe8c5cbdbab0,2009,,,2,AB de Villiers,KD Karthik,38,33,2,0,1,19,17,0,0,18,16,2,0
6480bba11c977a5d11c1aa38,2015,,,1,KL Rahul,RS Bopara,38,37,0,2,1,24,21,0,2,14,16,0,0
6480bb99fe078839da40e7ab,2023,,,2,DA Warner,PP Shaw,38,28,7,0,1,24,17,5,0,13,11,2,0
6480bb9a7f7a862ba0b2c59e,2007/08,,,1,JA Morkel,Joginder Sharma,38,23,1,3,1,21,13,0,2,16,10,1,1
6480bb984f0f3dc0df6d4531,2022,,,1,TH David,Tilak Varma,38,22,3,1,1,25,13,2,1,12,9,1,0
6480bb9b2ca4a7b325526f1f,2009,,,2,AS Raut,YK Pathan,38,23,3,2,1,13,9,1,0,24,14,2,2
6480bb95f282ca61c07afe9b,2018,,,1,PA Patel,V Kohli,38,29,4,2,1,29,18,3,2,8,11,1,0
6480bb9f0f1f6c03d8e2f039,2013,,,1,AJ Finch,RV Uthappa,38,26,7,0,1,16,12,3,0,22,14,4,0
6480bb9dc8b09381d0f01a9d,2011,,,2,M Manhas,Yuvraj Singh,38,44,1,1,1,20,23,0,1,17,21,1,0
6480bb981f136a7564719d7f,2022,,,1,JM Sharma,LS Livingstone,38,18,2,3,1,23,11,1,2,14,7,1,1
6480bb9834c7569d5fa64353,2022,,,1,HH Pandya,Shubman Gill,38,24,5,1,1,25,14,3,1,12,10,2,0
6480bb9c2778066dafd78a71,2009/10,,,1,JA Morkel,MS Dhoni,38,30,1,2,1,12,13,0,0,26,17,1,2
6480bba264ad6b873d0d07d8,2016,,,1,KD Karthik,RA Jadeja,38,23,2,1,1,22,13,2,0,12,10,0,1
6480bb99f47261f111a6cc1a,2023,,,1,HH Pandya,Shubman Gill,38,24,4,1,1,13,14,1,0,23,10,3,1
6480bba38060854b4fab1831,2016,,,1,KL Rahul,SR Watson,38,32,3,2,1,23,18,2,1,15,14,1,1
6480bba136257b71aa9952cf,2014,,,2,GJ Maxwell,V Sehwag,38,14,1,4,1,13,6,1,1,22,8,0,3
6480bb99773871f8e2ddc4b1,2022,,,2,M Shahrukh Khan,S Dhawan,38,21,3,3,1,19,10,2,1,19,11,1,2
6480bb95a8153d4daac6e4f7,2019,,,1,CA Lynn,SP Narine,38,29,6,1,1,32,22,6,1,2,7,0,0
6480bb9d54ae15d3d0ed9e5e,2011,,,1,BJ Hodge,DPMD Jayawardene,38,27,2,1,1,14,14,1,0,21,13,1,1
6480bb9404b444be6724e41e,2017,,,2,MK Tiwary,SPD Smith,38,30,3,1,1,26,16,3,1,10,14,0,0
6480bb98f98edd45b1ccb406,2022,,,1,A Badoni,MP Stoinis,38,23,1,3,1,8,9,0,0,28,14,1,3
6480bb97f2f0fabec8f94d86,2020/21,,,2,RA Jadeja,SM Curran,38,17,2,3,0,31,11,2,3,5,6,0,0
6480bb9a807eb5f39489408a,2023,,,1,MS Dhoni,RA Jadeja,38,18,2,3,1,20,8,1,2,15,10,1,1
6480bba06e8cb70fb4bdc83e,2013,,,2,KC Sangakkara,PA Patel,38,34,4,0,1,18,17,2,0,20,17,2,0
6480bb98b8bb5b0d2c2f0848,2022,,,1,HR Shokeen,Tilak Varma,38,36,3,1,1,25,25,3,0,12,11,0,1
6480bb94009d0662ee94f07b,2018,,,1,KA Pollard,SA Yadav,38,36,4,2,1,28,23,3,2,10,13,1,0
6480bb97d5e3b0911408f222,2020/21,,,2,MS Dhoni,RD Gaikwad,37,31,4,1,0,19,21,3,0,16,10,1,1
6480bb9871b0ff7264721cbc,2022,,,1,DA Warner,MR Marsh,37,21,5,1,1,22,14,3,1,10,7,2,0
6480bb95960e393c939ab44c,2018,,,1,RR Pant,SS Iyer,37,27,4,1,1,32,18,4,1,5,9,0,0
6480bb950c59218964b27cc0,2018,,,1,AM Rahane,JC Buttler,37,22,5,1,1,9,10,1,0,28,12,4,1
6480bb9e692eaa193a417426,2012,,,1,AB McDonald,CA Pujara,37,24,4,2,1,25,12,3,2,11,12,1,0
6480bb95e435367dc64d9844,2019,,,2,SPD Smith,SV Samson,37,22,3,2,1,24,13,2,1,13,9,1,1
6480bb98436587de59527f2e,2022,,,1,Ishan Kishan,TH David,37,19,3,2,1,24,11,3,1,12,8,0,1
6480bb97c48a16e84b55a325,2020/21,,,1,AB de Villiers,S Dube,37,30,3,0,1,28,17,3,0,8,13,0,0
6480bb9eda28fb340ed37b49,2012,,,1,KC Sangakkara,S Dhawan,37,35,4,1,1,12,15,1,0,24,20,3,1
6480bb9c58b62383739c022e,2009,,,1,AM Nayar,Harbhajan Singh,37,19,4,1,1,29,12,4,1,6,7,0,0
6480bb9c21492b9a562c6f46,2009/10,,,2,OA Shah,SC Ganguly,37,31,1,2,1,18,15,0,2,16,16,1,0
6480bba1d3b4ddc36050e3f3,2014,,,2,RN ten Doeschate,SA Yadav,37,21,3,3,1,16,7,0,2,20,14,3,1
6480bb971ffe5345804e7f32,2020/21,,,2,BA Stokes,JC Buttler,37,18,6,1,1,15,9,3,0,22,9,3,1
6480bb9938b659481e3ab6dc,2022,,,1,D Padikkal,JC Buttler,37,26,2,2,1,28,20,2,2,7,6,0,0
6480bb9871b0ff7264721cbc,2022,,,2,N Pooran,Shashank Singh,37,12,2,3,1,20,6,0,3,10,6,2,0
6480bb9cdf6c63fec90a42df,2009/10,,,2,M Vijay,SK Raina,37,33,4,0,1,18,15,2,0,17,18,2,0
6480bba237377ccc608266d2,2016,,,2,JC Buttler,PA Patel,37,20,3,2,1,24,13,3,1,12,7,0,1
6480bb964592640608a9163c,2020/21,,,2,RV Uthappa,SV Samson,37,30,4,1,1,18,15,1,1,19,15,3,0
6480bba0f401cc6b6bc6ed10,2013,,,1,AM Rahane,SR Watson,37,28,5,1,1,13,13,0,1,24,15,5,0
6480bb980b5b26e8c4335a4b,2022,,,1,MA Agarwal,S Dhawan,37,35,2,1,1,18,21,2,0,16,14,0,1
6480bb95945c5e5dc4d8c7d6,2019,,,1,SA Yadav,Yuvraj Singh,37,18,1,4,1,13,6,1,1,23,12,0,3
6480bb9a9801c2dda3fe88e9,2007/08,,,2,MK Tiwary,R Bhatia,37,27,3,1,1,15,12,2,0,17,15,1,1
6480bb9e6d7f7f691dde322d,2012,,,2,PA Patel,S Dhawan,37,33,3,1,1,19,18,1,1,16,15,2,0
6480bba18e95c84faca0bdb6,2015,,,2,AM Rahane,SV Samson,37,30,3,2,1,26,18,2,2,11,12,1,0
6480bb9558345af5a1bb044d,2019,,,1,AB de Villiers,PA Patel,37,29,5,1,1,8,13,1,0,25,16,4,1
6480bb9e156723e64d6bd26b,2012,,,2,KA Pollard,RG Sharma,37,30,1,3,1,24,18,0,3,13,12,1,0
6480bb963c729ccbcb9446f8,2020/21,,,2,Abdul Samad,DA Warner,37,22,3,1,1,23,15,2,1,14,7,1,0
6480bb9a6935abf34d88ca97,2007/08,,,1,KC Sangakkara,SM Katich,37,20,3,1,1,27,12,3,1,8,8,0,0
6480bb9bcc2f6123673672d0,2007/08,,,2,DR Smith,ST Jayasuriya,37,30,3,1,1,17,17,2,0,18,13,1,1
6480bb9a596c087c0396ec2e,2007/08,,,2,R Dravid,S Chanderpaul,37,30,6,0,1,20,19,3,0,16,11,3,0
6480bba0b07a395235841955,2013,,,1,KC Sangakkara,S Dhawan,37,34,4,1,1,21,21,3,0,16,13,1,1
6480bb9e1a26096ce68e9ca3,2012,,,2,MA Agarwal,TM Dilshan,37,36,5,0,1,15,17,2,0,19,19,3,0
6480bb94dfad571ef76493a9,2017,,,2,KA Pollard,RG Sharma,37,18,3,2,1,27,12,2,2,10,6,1,0
6480bb95ff5da0069bc5274e,2018,,,2,AJ Finch,R Ashwin,37,20,1,3,1,27,12,0,3,10,8,1,0
6480bb9ab83a3072124dda22,2023,,,1,Anmolpreet Singh,RA Tripathi,37,21,7,0,1,15,8,3,0,20,13,4,0
6480bb96f8379d02d3435ceb,2020/21,,,1,RA Tripathi,Shubman Gill,37,26,6,0,1,23,14,5,0,11,12,1,0
6480bb9c44492d9e5fc4bb60,2009/10,,,2,JH Kallis,RV Uthappa,37,32,3,0,1,17,15,2,0,20,17,1,0
6480bb951354c40599b60208,2018,,,1,KS Williamson,Shakib Al Hasan,37,22,5,1,1,18,14,3,0,18,8,2,1
6480bb9c21492b9a562c6f46,2009/10,,,1,AA Jhunjhunwala,AC Voges,37,25,4,0,1,18,14,2,0,19,11,2,0
6480bb9db38208342bc57b96,2011,,,1,G Gambhir,YK Pathan,37,24,2,2,1,14,10,2,0,21,14,0,2
6480bb9800ba03eb1f9437d2,2022,,,2,DA Miller,WP Saha,37,24,4,0,1,13,12,1,0,20,12,3,0
6480bb9619eaed447b2a05d4,2020/21,,,2,Ishan Kishan,Q de Kock,37,33,2,2,1,19,14,2,1,18,19,0,1
6480bb95014388d3e8c62904,2019,,,1,MM Ali,V Kohli,37,23,1,3,1,32,18,1,3,4,5,0,0
6480bba1b8e3071cc513602a,2014,,,1,SPD Smith,STR Binny,37,43,0,0,1,20,25,0,0,12,18,0,0
6480bba0bc196f7168b3d989,2013,,,2,DJ Hussey,SE Marsh,37,27,4,1,1,22,16,2,1,15,11,2,0
6480bba1dd2f8125fc8b203f,2014,,,2,GJ Bailey,WP Saha,37,24,5,1,1,15,14,2,0,22,10,3,1
6480bb9866dd8ba9b48863c2,2022,,,1,F du Plessis,GJ Maxwell,37,26,5,1,1,14,15,2,0,23,11,3,1
6480bb9f87652064dab6c573,2013,,,1,M Vohra,Mandeep Singh,37,29,5,0,1,17,16,2,0,19,13,3,0
6480bb9435048f20502ba1e1,2018,,,2,HH Pandya,JP Duminy,37,29,3,1,1,25,19,2,1,10,10,1,0
6480bb94dfad571ef76493a9,2017,,,2,KA Pollard,LMP Simmons,37,23,1,4,1,14,10,0,2,22,13,1,2
6480bb95c28e7980e1768064,2018,,,2,JC Buttler,STR Binny,37,30,3,1,1,15,13,2,0,22,17,1,1
6480bb9e3db1392e753dd785,2012,,,2,LRPL Taylor,V Sehwag,37,29,3,1,0,9,13,0,0,27,16,3,1
6480bb9dfb2e8e8c2002df86,2011,,,1,DB Ravi Teja,DT Christian,37,27,2,2,1,15,14,1,0,22,13,1,2
6480bb9740aaba2132c0eb0e,2021,,,1,F du Plessis,SK Raina,37,27,2,3,1,12,9,1,0,24,18,1,3
6480bb9d02d996f85dd5e945,2011,,,2,M Vijay,SK Raina,37,30,7,0,1,26,14,6,0,10,16,1,0
6480bb9d105fba311a23a588,2011,,,2,AB de Villiers,MA Agarwal,37,29,2,2,1,18,16,1,1,17,13,1,1
6480bb9e156723e64d6bd26b,2012,,,1,DT Christian,S Dhawan,37,23,1,4,1,3,7,0,0,34,16,1,4
6480bba19cc161a3fb8a8795,2014,,,2,LMP Simmons,RG Sharma,37,33,2,1,1,16,13,0,1,18,20,2,0
6480bb9edbd8851db7e06741,2012,,,1,BJ Hodge,J Botha,37,17,5,1,1,23,8,5,0,14,9,0,1
6480bb96ec7d98e34055e8fc,2020/21,,,2,F du Plessis,KM Jadhav,37,29,3,0,1,13,13,0,0,22,16,3,0
6480bb9dd89d4266d59a4592,2011,,,2,R McLaren,RJ Harris,37,45,2,0,1,18,21,1,0,17,24,1,0
6480bba1587a54176a9badf4,2014,,,1,SA Yadav,YK Pathan,37,11,4,3,1,5,2,1,0,32,9,3,3
6480bb9e30b7f3c09cfbdabb,2011,,,2,AL Menaria,SR Watson,37,21,2,4,1,16,12,2,1,20,9,0,3
6480bb94009d0662ee94f07b,2018,,,1,E Lewis,Ishan Kishan,37,20,4,2,1,23,11,2,2,9,9,2,0
6480bba1af9481df8b4f9f0f,2015,,,2,AB de Villiers,CH Gayle,37,18,4,2,1,28,13,3,2,8,5,1,0
6480bb9552e25b3867e5c38a,2019,,,1,RG Sharma,SA Yadav,37,28,6,0,1,10,10,1,0,26,18,5,0
6480bba2a215721aadf7a90a,2015,,,2,AM Rahane,SR Watson,37,33,5,0,1,23,17,4,0,14,16,1,0
6480bb981f136a7564719d7f,2022,,,2,HH Pandya,Shubman Gill,37,26,5,0,1,27,18,5,0,7,8,0,0
6480bb996c5ae75a32d978e8,2022,,,2,DA Miller,WP Saha,37,36,2,0,0,15,20,1,0,18,16,1,0
6480bba07b5396a7b65684d3,2013,,,2,JH Kallis,MS Bisla,37,33,5,1,1,20,16,2,1,17,17,3,0
6480bb976344f6d667dfd965,2021,,,1,RR Pant,SPD Smith,37,36,3,0,1,11,15,0,0,25,21,3,0
6480bb991a76403912eef285,2023,,,1,M Shahrukh Khan,S Dhawan,37,22,2,2,1,11,10,1,0,23,12,1,2
6480bba2ebdcfb98389cee5a,2015,,,2,F du Plessis,MS Dhoni,37,36,3,0,1,23,20,2,0,9,16,1,0
6480bb99efa58b95852be382,2023,,,2,Shubman Gill,WP Saha,37,24,3,2,1,9,8,1,0,25,16,2,2
6480bb9498a98d52f9285b52,2017,,,2,MK Tiwary,MS Dhoni,37,18,2,2,1,9,5,1,0,25,13,1,2
6480bb967d799ced7fe5d8e9,2020/21,,,1,KL Rahul,Mandeep Singh,37,30,3,1,1,20,16,2,1,17,14,1,0
6480bb9399a527d39bc17dad,2017,,,2,TM Head,V Kohli,37,19,1,2,1,14,7,0,1,22,12,1,1
6480bb9cd0eb4289b2222e37,2009/10,,,2,DR Martyn,YK Pathan,37,38,1,2,1,10,14,0,0,26,24,1,2
6480bba0ffae8617ee64bd19,2013,,,1,DJ Bravo,MS Dhoni,37,18,2,2,0,12,8,1,0,25,10,1,2
6480bb933fdc96ee7273400e,2017,,,2,HH Pandya,TG Southee,37,9,1,5,1,29,6,1,4,7,3,0,1
6480bb9edd901481f13ce9ba,2012,,,1,DA Miller,DJ Hussey,37,35,2,0,1,8,13,0,0,23,22,2,0
6480bba1f5d65d6146678a7f,2015,,,1,MK Tiwary,Yuvraj Singh,37,30,4,1,1,20,16,3,0,16,14,1,1
6480bb95014388d3e8c62904,2019,,,2,RR Pant,SS Iyer,37,26,3,1,1,16,12,2,0,19,14,1,1
6480bb9a9514379c05d59c38,2023,,,1,R Ashwin,YBK Jaiswal,37,15,5,2,1,3,3,0,0,32,12,5,2
6480bba273adb498d96b27a9,2016,,,1,CR Brathwaite,SW Billings,37,12,3,3,1,27,8,3,2,9,4,0,1
6480bb973e451a92813d78cc,2020/21,,,2,N Rana,Shubman Gill,37,21,6,1,1,26,13,6,0,9,8,0,1
6480bb9808d6857eeb335d94,2022,,,2,R Powell,SN Thakur,37,24,1,3,0,28,10,1,3,8,14,0,0
6480bb971ffe5345804e7f32,2020/21,,,1,MP Stoinis,SS Iyer,37,26,2,2,1,12,12,1,0,24,14,1,2
6480bb993e44f97eccb361fe,2023,,,2,SM Curran,Sikandar Raza,37,21,3,3,1,6,6,1,0,30,15,2,3
6480bb94a964c10b5f10ae52,2017,,,1,AM Rahane,SPD Smith,37,39,0,1,0,22,21,0,1,15,18,0,0
6480bb9eeeaf037e5e41ab86,2012,,,2,Bipul Sharma,Mandeep Singh,37,26,5,0,1,18,13,2,0,19,13,3,0
6480bb987b6845947f7ca137,2022,,,1,R Ashwin,SO Hetmyer,37,18,1,2,0,6,5,0,0,27,13,1,2
6480bb9f68a0a232d83c338c,2012,,,1,MA Agarwal,Z Khan,37,13,3,3,0,36,10,3,3,1,3,0,0
6480bb99537b54b870dc74d1,2023,,,1,JM Sharma,PBB Rajapaksa,37,34,6,0,1,25,23,5,0,11,11,1,0
6480bb9b72f6a46338302131,2009,,,2,DJ Bravo,JP Duminy,37,32,4,0,1,13,16,0,0,24,16,4,0
6480bb9482dff502bff80bcf,2017,,,1,RR Pant,SS Iyer,37,24,4,1,1,26,13,3,1,9,11,1,0
6480bb9384cbae8edee3707f,2017,,,1,JC Buttler,PA Patel,37,24,2,2,1,19,13,1,2,8,11,1,0
6480bb99433f6e11060ba714,2022,,,1,AR Patel,MR Marsh,37,29,5,0,1,13,16,2,0,18,13,3,0
6480bb970127afddc00607cc,2021,,,1,KM Jadhav,KS Williamson,37,13,5,2,0,12,4,1,1,25,9,4,1
6480bb9c620c92d09ba1b6b9,2009,,,1,DR Smith,WPUJC Vaas,37,29,0,2,1,17,14,0,1,20,15,0,1
6480bb99c26e725b7b6f1637,2023,,,2,D Padikkal,R Parag,37,26,5,1,1,21,14,4,0,15,12,1,1
6480bb980cc3d01eab3a4748,2022,,,1,KD Karthik,V Kohli,37,17,3,3,0,32,14,3,3,3,3,0,0
6480bb9836af59f8283f4081,2022,,,1,DJ Mitchell,JC Buttler,37,41,2,0,1,17,20,1,0,18,21,1,0
6480bba179195d83fa7fbfbb,2014,,,2,SA Yadav,Shakib Al Hasan,37,30,1,1,0,9,17,0,0,21,13,1,1
6480bba2e8614b1263627c1b,2015,,,1,CH Morris,STR Binny,37,14,2,3,0,34,11,2,3,3,3,0,0
6480bb9873e53eace3a69dc7,2022,,,2,AD Russell,UT Yadav,37,24,1,4,1,24,12,0,3,13,12,1,1
6480bb941ab79050c3c90ee5,2018,,,1,AD Russell,TK Curran,37,14,0,5,0,34,9,0,5,2,5,0,0
6480bb9ea1e127d68e288e04,2011,,,1,MEK Hussey,WP Saha,37,35,2,1,1,20,19,2,0,16,16,0,1
6480bb954817ed0a4ba25bc2,2018,,,1,E Lewis,SA Yadav,37,19,3,3,1,9,7,0,1,26,12,3,2
6480bba1b8e3071cc513602a,2014,,,2,AJ Finch,S Dhawan,37,24,7,0,1,3,4,0,0,33,20,7,0
6480bb9e05381e16815803e9,2011,,,2,MK Pandey,RV Uthappa,37,31,3,0,1,9,13,0,0,22,18,3,0
6480bb9c9685addc4a78d7d0,2009/10,,,1,IK Pathan,K Goel,37,27,2,2,1,20,12,1,1,17,15,1,1
6480bb9eb559e2934b31c47c,2012,,,1,DJ Bravo,SK Raina,37,24,5,0,1,17,14,3,0,14,10,2,0
6480bb99cbb648c5c0ecb205,2023,,,1,Rahmanullah Gurbaz,VR Iyer,37,31,3,1,1,25,17,3,1,11,14,0,0
6480bba25855b7a7195a9bc5,2016,,,1,SS Iyer,SV Samson,37,30,3,1,1,17,15,1,1,16,15,2,0
6480bb97493381c4d7dc7bf4,2021,,,1,CH Morris,R Tewatia,37,21,2,2,1,10,6,0,1,23,15,2,1
6480bb96b7b695186bbb6a3e,2019,,,1,Ishan Kishan,SA Yadav,37,36,4,0,1,20,20,3,0,15,16,1,0
6480bb962831291a868490e7,2020/21,,,1,EJG Morgan,N Rana,37,19,6,1,1,17,8,2,1,20,11,4,0
6480bb9371e90dbd44ee19a3,2017,,,1,CJ Anderson,PJ Cummins,37,13,3,3,0,25,7,1,3,12,6,2,0
6480bb96b7b695186bbb6a3e,2019,,,2,SK Raina,SR Watson,37,32,3,1,1,8,14,0,0,26,18,3,1
6480bb995193664eda3e9e10,2022,,,2,Ishan Kishan,Ramandeep Singh,37,33,2,0,1,22,17,2,0,12,16,0,0
6480bb9698a1d9136a13faf6,2020/21,,,1,DJ Hooda,Mandeep Singh,36,27,2,1,1,25,16,1,1,11,11,1,0
6480bb98aae066234fd8f11e,2022,,,1,DA Miller,Shubman Gill,36,19,1,3,1,11,9,1,0,24,10,0,3
6480bb94ce8e0a620532955b,2018,,,2,C Munro,SS Iyer,36,20,4,2,1,26,11,3,2,10,9,1,0
6480bb964592640608a9163c,2020/21,,,1,KS Williamson,PK Garg,36,15,1,3,1,19,7,0,2,15,8,1,1
6480bba0120becd670aec59d,2013,,,2,CH Gayle,SS Tiwary,36,39,3,1,1,21,21,2,1,13,18,1,0
6480bba13b673297bce003e2,2014,,,2,AB de Villiers,Yuvraj Singh,36,20,2,2,1,10,10,1,0,21,10,1,2
6480bb9866dd8ba9b48863c2,2022,,,2,DJ Hooda,KH Pandya,36,27,2,2,1,13,14,1,0,19,13,1,2
6480bb99f2a793884331579e,2023,,,1,RK Singh,VR Iyer,36,27,3,1,1,18,15,2,0,18,12,1,1
6480bb958f77e7d3929d28e3,2018,,,1,AR Patel,KK Nair,36,26,0,3,1,14,12,0,1,21,14,0,2
6480bb9ca668b7b36823fb21,2009,,,1,DA Warner,G Gambhir,36,21,5,1,1,15,9,1,1,21,12,4,0
6480bb98dd9a2108c79e1014,2022,,,2,DA Warner,SN Khan,36,24,4,1,0,23,11,3,1,12,13,1,0
6480bb94b991069934e5c7d2,2018,,,1,DJM Short,RA Tripathi,36,25,4,1,1,26,18,3,1,10,7,1,0
6480bba08ffdd4393211d261,2014,,,1,DJG Sammy,KV Sharma,36,16,1,3,0,17,9,1,1,17,7,0,2
6480bb9ea1e127d68e288e04,2011,,,1,JA Morkel,WP Saha,36,22,3,1,0,13,10,2,0,20,12,1,1
6480bb938ed49c6d5c211429,2017,,,1,MK Pandey,YK Pathan,36,20,3,2,1,26,13,2,2,9,7,1,0
6480bb94fbd0b904d63e0e07,2017,,,2,KS Williamson,MC Henriques,36,17,3,1,0,29,11,3,1,7,6,0,0
6480bb997d1393ca85856ec2,2022,,,1,HH Pandya,Rashid Khan,36,15,2,3,0,17,9,1,1,19,6,1,2
6480bb9c13817091131f76e3,2009/10,,,2,IK Pathan,PP Chawla,36,25,1,2,1,21,12,0,2,9,13,1,0
6480bb94d8ce46258c13e90e,2017,,,1,KA Pollard,RG Sharma,36,24,3,2,1,9,9,1,0,26,15,2,2
6480bba11eff9b230a172302,2014,,,1,G Gambhir,MK Pandey,36,25,2,1,1,15,14,1,0,19,11,1,1
6480bba0ca27548122e36880,2013,,,2,JH Kallis,MS Bisla,36,38,0,2,1,19,20,0,1,16,18,0,1
6480bb9822eeb0c1c117f221,2021,,,1,PP Shaw,S Dhawan,36,20,6,1,1,29,13,5,1,7,7,1,0
6480bb9a77f349a0fd8d96d6,2023,,,1,Atharva Taide,S Dhawan,36,21,5,2,1,19,12,3,1,16,9,2,1
6480bb99cf7659c6e45bd01d,2023,,,1,Abhishek Sharma,RA Tripathi,36,30,3,1,1,18,13,2,0,17,17,1,1
6480bb9f8d3b0a3d1e28a4b7,2013,,,2,DB Ravi Teja,NLTC Perera,36,26,1,1,1,9,11,0,0,26,15,1,1
6480bb9e05571c1a4c163ef1,2012,,,2,AM Rahane,R Dravid,36,28,5,1,1,15,10,3,0,20,18,2,1
6480bb9692a7f0d52bd43127,2019,,,1,AB de Villiers,PA Patel,36,19,4,2,1,10,8,1,0,26,11,3,2
6480bb9d3ab782f83ce3e381,2011,,,2,EJG Morgan,JH Kallis,36,34,4,1,1,14,15,0,1,19,19,4,0
6480bb9737b1d7284b5297c1,2021,,,2,V Kohli,Washington Sundar,36,27,4,0,1,19,11,4,0,10,16,0,0
6480bba19701e99975ce7c59,2015,,,2,CH Gayle,V Kohli,36,27,4,1,1,20,17,3,1,11,10,1,0
6480bb971c9e4a3ef11759f3,2021,,,1,KL Rahul,MA Agarwal,36,34,3,2,1,19,20,2,1,15,14,1,1
6480bb9b2a5f2fd5053534dc,2007/08,,,1,SR Tendulkar,ST Jayasuriya,36,16,2,2,1,5,4,1,0,20,12,1,2
6480bba20559f15c3489f637,2015,,,2,KL Rahul,RS Bopara,36,37,1,1,1,19,20,0,1,17,17,1,0
6480bb9e9162dceff15dc334,2011,,,2,DJ Hussey,Mandeep Singh,36,23,3,1,0,19,13,2,1,15,10,1,0
6480bba29fb420d92aef1d2a,2015,,,2,KV Sharma,P Kumar,36,22,1,3,1,26,14,0,3,9,8,1,0
6480bb982fc21d541267f7b9,2022,,,2,SS Iyer,SW Billings,36,35,1,1,1,11,13,0,0,25,22,1,1
6480bb9404b444be6724e41e,2017,,,2,RA Tripathi,SPD Smith,36,24,5,1,1,7,6,1,0,28,18,4,1
6480bba19701e99975ce7c59,2015,,,1,AM Rahane,SR Watson,36,30,5,1,1,18,12,2,1,16,18,3,0
6480bb9df57ec21d17310ad2,2011,,,2,DB Ravi Teja,DT Christian,36,16,2,3,1,13,8,1,1,22,8,1,2
6480bb98825d8ceb716e3f3c,2022,,,2,M Jansen,N Pooran,36,12,3,3,0,0,0,0,0,33,12,3,3
6480bb9399a527d39bc17dad,2017,,,1,BB McCullum,SK Raina,36,16,2,3,1,12,8,0,1,23,8,2,2
6480bba2557febf92f9f79ab,2015,,,1,F du Plessis,RA Jadeja,36,35,1,0,1,18,15,1,0,15,20,0,0
6480bb9574ca455ec008e942,2018,,,1,B Kumar,Rashid Khan,36,11,2,4,0,5,2,1,0,30,9,1,4
6480bb9837deb0fb66704166,2022,,,2,DJ Hooda,Q de Kock,36,23,3,1,1,7,8,0,0,27,15,3,1
6480bba2b99fcf06aaeac805,2015,,,1,AT Rayudu,RG Sharma,36,25,2,2,1,13,9,0,1,22,16,2,1
6480bb9eeeaf037e5e41ab86,2012,,,2,AC Gilchrist,PC Valthaty,36,26,4,1,1,27,18,3,1,7,8,1,0
6480bb9d872bbb611f6266cb,2011,,,1,PC Valthaty,Sunny Singh,36,23,4,1,1,16,12,2,0,20,11,2,1
6480bb9d80536875f41bc605,2011,,,2,Harbhajan Singh,KA Pollard,36,14,2,2,1,9,3,0,1,19,11,2,1
6480bb9e9162dceff15dc334,2011,,,1,DPMD Jayawardene,OA Shah,36,20,2,2,1,9,8,1,0,23,12,1,2
6480bb95e25835586d412978,2018,,,1,AR Patel,KK Nair,36,21,1,3,1,13,10,0,1,23,11,1,2
6480bb94605dacb25c83dc35,2018,,,1,KL Rahul,MA Agarwal,36,18,6,1,1,20,10,3,1,16,8,3,0
6480bb99a620a7afdb3217fe,2023,,,2,DA Warner,RR Rossouw,36,30,6,0,1,19,18,4,0,14,12,2,0
6480bb972a7d4e1071ea662e,2021,,,2,Lalit Yadav,S Dhawan,36,33,3,1,1,10,13,0,0,25,20,3,1
6480bb9e56c724ba25b94666,2011,,,1,KD Karthik,SE Marsh,36,28,5,0,1,21,16,4,0,13,12,1,0
6480bb9b2ca4a7b325526f1f,2009,,,2,AS Raut,SK Warne,36,26,2,2,1,17,11,2,0,19,15,0,2
6480bb9db9ed29ce1ee8764f,2011,,,2,DJ Hussey,SE Marsh,36,19,2,2,1,20,10,0,2,16,9,2,0
6480bb99efa58b95852be382,2023,,,1,MM Ali,RD Gaikwad,36,22,5,2,1,23,17,4,1,12,5,1,1
6480bb94457bfc7687322f80,2017,,,1,AB de Villiers,KM Jadhav,36,26,4,1,1,4,8,0,0,31,18,4,1
6480bba1c67d2c9c1279a4c8,2014,,,1,AB de Villiers,Yuvraj Singh,36,26,2,3,1,22,10,1,2,14,16,1,1
6480bb9a36f2ab9a44baa0f8,2023,,,1,SV Samson,YBK Jaiswal,36,21,3,2,1,23,14,2,1,13,7,1,1
6480bb9384cbae8edee3707f,2017,,,1,HH Pandya,KA Pollard,36,27,4,1,1,13,11,0,1,22,16,4,0
6480bba2704d23da78c3eb15,2016,,,1,RV Uthappa,YK Pathan,36,20,2,2,1,24,13,2,1,11,7,0,1
6480bba04b49d2ff5f997e02,2013,,,1,AJ Finch,MK Pandey,36,27,1,3,1,24,13,1,2,10,14,0,1
6480bb9618b5973b98c0ba18,2019,,,1,B Kumar,KS Williamson,36,16,3,2,0,7,5,1,0,28,11,2,2
6480bb9e156723e64d6bd26b,2012,,,1,DT Christian,KC Sangakkara,36,33,2,1,1,20,14,1,1,14,19,1,0
6480bb973da000031d26fbba,2021,,,1,KL Rahul,Mandeep Singh,36,33,4,0,1,19,19,2,0,15,14,2,0
6480bb98f01e4672b988c112,2022,,,2,Avesh Khan,MP Stoinis,36,13,2,4,0,7,2,0,1,28,11,2,3
6480bb99e909d98c8193bac5,2023,,,2,Abdul Samad,Umran Malik,36,14,3,3,0,16,6,2,1,19,8,1,2
6480bb995193664eda3e9e10,2022,,,1,N Rana,SS Iyer,36,17,2,4,1,29,9,1,4,6,8,1,0
6480bb947a7076697fc0b339,2017,,,1,MS Dhoni,SPD Smith,36,23,2,2,1,23,11,1,2,13,12,1,0
6480bb9b4fc6889967a3cd54,2007/08,,,1,LPC Silva,Y Venugopal Rao,36,28,4,0,1,17,14,3,0,16,14,1,0
6480bba273adb498d96b27a9,2016,,,2,RV Uthappa,SA Yadav,36,23,1,1,1,8,10,0,0,21,13,1,1
6480bb9bb7a4f1e16df25c8e,2009,,,1,JDP Oram,S Badrinath,36,19,4,2,1,27,10,3,2,8,9,1,0
6480bb94ce8e0a620532955b,2018,,,2,R Tewatia,V Shankar,36,14,0,4,0,3,4,0,0,30,10,0,4
6480bb9c6f1c8ea3dc73226f,2009/10,,,2,AP Tare,SR Tendulkar,36,17,4,2,1,17,10,0,2,18,7,4,0
6480bb95f2e3c32afe233820,2018,,,2,M Vohra,V Kohli,36,26,4,1,1,5,6,0,0,31,20,4,1
6480bb99bbae76f3f761d060,2023,,,1,AM Rahane,DP Conway,36,28,3,1,1,18,13,2,0,18,15,1,1
6480bb9774dd8e44bbeeb5a4,2021,,,2,RR Pant,S Dhawan,36,21,3,2,1,14,11,1,1,22,10,2,1
6480bb97b945155c90dccd3d,2021,,,1,AD Russell,N Rana,36,26,2,2,1,20,15,2,1,13,11,0,1
6480bb964c4bea88164f168d,2020/21,,,1,SP Narine,Shubman Gill,36,29,3,2,1,15,14,2,1,18,15,1,1
6480bb95cf9d446747bd74fe,2019,,,1,PP Shaw,S Dhawan,36,27,7,0,1,24,16,5,0,10,11,2,0
6480bb9f68a0a232d83c338c,2012,,,1,SS Tiwary,TM Dilshan,36,26,2,2,1,21,16,1,2,9,10,1,0
6480bb9e65a802582c071438,2012,,,2,AT Rayudu,RJ Peterson,36,13,3,3,0,19,6,1,2,16,7,2,1
6480bb9619eaed447b2a05d4,2020/21,,,1,AB de Villiers,D Padikkal,36,24,3,2,1,15,12,1,1,20,12,2,1
6480bb96c40b697b63d08717,2019,,,1,Mohammad Nabi,V Shankar,36,16,5,2,1,14,9,3,0,22,7,2,2
6480bb9929c7e430acd1ef18,2022,,,2,MR Marsh,RR Pant,36,19,6,1,1,16,11,2,1,20,8,4,0
6480bb9f146f5849bb759148,2013,,,2,MK Pandey,RV Uthappa,36,41,2,1,1,10,19,0,0,24,22,2,1
6480bb9f03dd3a09740f0bd0,2013,,,1,BJ Hodge,DH Yagnik,36,22,4,1,1,17,11,3,0,16,11,1,1
6480bb9c9e328ac30bcaf6b0,2009/10,,,2,AN Ahmed,Harbhajan Singh,36,22,1,3,1,4,7,0,0,28,15,1,3
6480bb9ca5c1d511ad78e92d,2009,,,2,AB de Villiers,G Gambhir,36,31,4,1,1,10,13,1,0,26,18,3,1
6480bb9f4bdcea2f81049fe9,2012,,,2,M Vijay,MS Dhoni,36,17,1,3,1,10,7,0,1,23,10,1,2
6480bb9a807eb5f39489408a,2023,,,1,AT Rayudu,S Dube,36,19,1,3,1,18,11,1,1,16,8,0,2
6480bba18a431be2cc738de0,2014,,,1,KP Pietersen,Q de Kock,36,32,5,0,1,14,15,2,0,22,17,3,0
6480bb9c121ee402b7b2eda6,2009,,,1,MK Pandey,V Kohli,36,18,0,3,0,16,9,0,1,19,9,0,2
6480bb9deba74e341b44c765,2009/10,,,1,JH Kallis,R Dravid,36,44,5,0,1,19,32,3,0,15,12,2,0
6480bb9c8f3ef1685cdf4017,2009,,,2,SC Ganguly,Yashpal Singh,36,34,3,1,1,21,14,1,1,13,20,2,0
6480bb9d40fc01528c7b7270,2009/10,,,2,KP Pietersen,MK Pandey,36,20,7,1,1,28,13,5,1,8,7,2,0
6480bb9d59f2ded94f736145,2011,,,1,NLTC Perera,RA Jadeja,36,40,5,0,1,22,23,4,0,11,17,1,0
6480bb95c701f5c8388f7f88,2018,,,1,CH Gayle,KL Rahul,36,27,3,3,1,14,12,3,0,21,15,0,3
6480bb9c963968000dfd00d1,2009/10,,,2,IK Pathan,KC Sangakkara,36,33,4,1,1,21,17,2,1,15,16,2,0
6480bb975ea60ce128803d60,2021,,,1,F du Plessis,MS Dhoni,36,16,5,1,1,15,8,3,0,17,8,2,1
6480bb9b77a0ff5cb3d0e3e0,2009,,,1,M Vijay,ML Hayden,36,28,4,1,1,14,13,2,0,20,15,2,1
6480bb989bf19eb260a04f0e,2022,,,2,KS Williamson,RA Tripathi,36,22,5,0,1,17,16,3,0,12,6,2,0
6480bba0d2cdb40c68c4739c,2013,,,2,AT Rayudu,KD Karthik,36,37,4,0,1,22,21,3,0,13,16,1,0
6480bba192383a244f185c5a,2014,,,1,M Vijay,Q de Kock,36,25,4,2,1,7,9,1,0,24,16,3,2
6480bb94d8aa9021808a4760,2017,,,2,G Gambhir,IR Jaggi,36,25,1,2,0,28,17,1,2,5,8,0,0
6480bb98de3641699db2c5a1,2021,,,2,AR Patel,SO Hetmyer,36,27,2,1,1,5,10,0,0,27,17,2,1
6480bba1f5d65d6146678a7f,2015,,,1,MK Tiwary,SS Iyer,36,25,3,1,1,12,12,2,0,18,13,1,1
6480bb999424dd02cf40772a,2022,,,2,KL Rahul,MP Stoinis,36,17,1,3,1,20,8,1,2,9,9,0,1
6480bb9d0f6794fbf429449b,2011,,,1,EJG Morgan,MK Tiwary,36,38,1,1,1,10,12,1,0,22,26,0,1
6480bb9ccfdcb55be258ec95,2009,,,1,JA Morkel,MS Dhoni,36,18,3,2,0,21,10,1,2,11,8,2,0
6480bb9f79be50f1621abcc6,2012,,,1,Azhar Mahmood,Gurkeerat Singh,36,38,2,1,1,23,21,2,1,10,17,0,0
6480bba18e95c84faca0bdb6,2015,,,2,DJ Hooda,JP Faulkner,36,18,3,1,1,17,8,1,1,17,10,2,0
6480bb96e2809aa0bc35c7e9,2019,,,1,Q de Kock,RG Sharma,36,32,7,0,1,11,14,2,0,24,18,5,0
6480bba0fee4ae82492a666f,2013,,,1,KC Sangakkara,PA Patel,35,22,4,1,1,3,9,0,0,29,13,4,1
6480bb9d54ae15d3d0ed9e5e,2011,,,2,EJG Morgan,YK Pathan,35,28,3,1,1,18,16,1,1,17,12,2,0
6480bb9cba868c69775db687,2009,,,2,MS Dhoni,SK Raina,35,33,1,1,1,13,14,0,0,20,19,1,1
6480bb976344f6d667dfd965,2021,,,1,S Dhawan,SPD Smith,35,30,6,0,1,24,20,5,0,11,10,1,0
6480bb9f7258f976eb8fe943,2012,,,2,MEK Hussey,SK Raina,35,30,6,0,1,7,13,1,0,23,17,5,0
6480bba2e680f2464af841ae,2015,,,2,KV Sharma,MC Henriques,35,26,3,1,1,16,13,2,0,18,13,1,1
6480bb9c8f3ef1685cdf4017,2009,,,2,AB Agarkar,M Kartik,35,23,1,2,1,24,13,1,2,11,10,0,0
6480bb942efd740a6ffc47df,2017,,,1,HH Pandya,RG Sharma,35,20,1,2,0,14,9,0,1,19,11,1,1
6480bb99cf7659c6e45bd01d,2023,,,1,Abhishek Sharma,HC Brook,35,26,4,1,1,16,13,1,1,18,13,3,0
6480bb9b50f9e801edc13d5a,2007/08,,,1,CL White,R Dravid,35,28,3,1,1,26,20,3,1,7,8,0,0
6480bb96267b63eb2c6747b0,2019,,,1,PP Shaw,S Dhawan,35,21,6,1,1,18,10,4,0,16,11,2,1
6480bba11a59d64bb4aa66f4,2014,,,2,AM Rahane,SV Samson,35,33,3,1,1,13,16,1,0,20,17,2,1
6480bb95b33a36f0dd77d1a1,2018,,,1,BCJ Cutting,HH Pandya,35,18,2,3,1,8,6,0,1,24,12,2,2
6480bb962fbc99d08dc59f56,2020/21,,,1,CH Morris,I Udana,35,13,1,4,0,25,8,1,3,10,5,0,1
6480bb9a61edc0c77bc4bc86,2007/08,,,2,MS Dhoni,SP Fleming,35,20,5,0,1,7,6,1,0,26,14,4,0
6480bb97aabcd4374e076d04,2021,,,1,Abdul Samad,Abhishek Sharma,35,24,2,2,1,18,13,1,1,16,11,1,1
6480bba01893b0faadb9c761,2013,,,2,CH Gayle,TM Dilshan,35,34,4,1,1,17,16,2,1,13,18,2,0
6480bb933fdc96ee7273400e,2017,,,1,AM Rahane,MA Agarwal,35,19,5,1,1,27,14,4,1,6,5,1,0
6480bb94dcc956fa4ca06b92,2018,,,1,C de Grandhomme,V Kohli,35,15,0,3,0,11,6,0,1,21,9,0,2
6480bb99358a21ba3487db81,2023,,,2,KL Rahul,KR Mayers,35,27,5,0,1,17,13,3,0,13,14,2,0
6480bb932d6ccb8870dcd72d,2017,,,2,AM Rahane,SPD Smith,35,33,3,1,1,18,14,1,1,17,19,2,0
6480bb98b8bb5b0d2c2f0848,2022,,,1,JD Unadkat,Tilak Varma,35,16,2,2,0,19,9,1,1,15,7,1,1
6480bb98af25209ef756aa2c,2021,,,1,AB de Villiers,GJ Maxwell,35,16,4,2,1,11,5,1,1,22,11,3,1
6480bb9e65a802582c071438,2012,,,1,Mandeep Singh,N Saini,35,33,5,0,1,22,16,4,0,12,17,1,0
6480bba1cef79f12933bbf27,2014,,,1,DR Smith,SK Raina,35,20,1,4,1,33,18,1,4,2,2,0,0
6480bb9d109617dfa089c2c6,2011,,,1,J Botha,LRPL Taylor,35,20,2,0,0,12,12,0,0,14,8,2,0
6480bba163bd0c619365a16b,2015,,,2,LMP Simmons,PA Patel,35,26,6,0,1,15,14,3,0,17,12,3,0
6480bb9d6919e7181371271f,2011,,,2,PP Chawla,R McLaren,35,52,2,0,1,15,28,0,0,20,24,2,0
6480bba16af3f513920ef499,2015,,,2,G Gambhir,RV Uthappa,35,22,2,2,1,4,8,0,0,29,14,2,2
6480bb9fe7d0f611ba6ad229,2012,,,2,AB de Villiers,SS Tiwary,35,16,2,2,0,9,4,0,1,25,12,2,1
6480bb9b50f9e801edc13d5a,2007/08,,,1,MV Boucher,SP Goswami,35,33,4,0,1,18,15,3,0,17,18,1,0
6480bb9e28b7a946a6921fa6,2011,,,1,CH Gayle,V Kohli,35,24,0,3,1,27,14,0,3,7,10,0,0
6480bb932f8447acd7840076,2017,,,2,BB McCullum,JJ Roy,35,29,5,0,1,5,10,0,0,29,19,5,0
6480bba01a3f8444c7a33ba6,2014,,,2,BB McCullum,DR Smith,35,32,2,2,1,6,10,0,0,28,22,2,2
6480bba1dd2f8125fc8b203f,2014,,,2,DA Miller,WP Saha,35,22,1,2,1,16,12,1,1,15,10,0,1
6480bb9f23c17ccb47aa9e58,2013,,,2,DJ Hussey,Gurkeerat Singh,35,31,3,1,1,25,16,2,1,10,15,1,0
6480bb9e5ab10d1241d6509d,2012,,,1,CH Gayle,MA Agarwal,35,22,2,3,1,23,12,2,2,9,10,0,1
6480bb9da9ca2f2d3738d79e,2011,,,2,MD Mishra,RV Uthappa,35,24,4,1,1,12,10,2,0,17,14,2,1
6480bba1abec4894f2f69a35,2014,,,2,AB de Villiers,CH Gayle,35,17,1,4,1,16,9,0,2,18,8,1,2
6480bba22daffa649f339a05,2016,,,1,BB McCullum,SK Raina,35,28,1,1,1,20,16,1,1,11,12,0,0
6480bb9ca181f55cb21526f5,2009/10,,,1,SR Tendulkar,SS Tiwary,35,30,4,0,1,9,9,1,0,25,21,3,0
6480bb9f00ef088221497043,2013,,,2,DJ Bravo,RA Jadeja,35,14,4,2,0,7,4,1,0,27,10,3,2
6480bba0404171e13faa181e,2013,,,2,DR Smith,KD Karthik,35,18,3,2,1,28,12,2,2,7,6,1,0
6480bb9ddcbb8fbbad6614c8,2009/10,,,1,DA Warner,G Gambhir,35,16,5,0,1,2,4,0,0,26,12,5,0
6480bba2ab35be3ffcfa932a,2016,,,2,DA Warner,S Dhawan,35,19,3,1,1,22,10,2,1,8,9,1,0
6480bb9d362f72789dcdc5a7,2009/10,,,1,DE Bollinger,S Badrinath,35,26,3,1,1,16,14,1,1,16,12,2,0
6480bb9619eaed447b2a05d4,2020/21,,,2,KH Pandya,SA Yadav,35,19,5,1,1,10,10,1,0,23,9,4,1
6480bb9a8053274c083224d9,2023,,,2,AM Rahane,DP Conway,35,29,2,1,1,21,17,1,1,11,12,1,0
6480bb9c620c92d09ba1b6b9,2009,,,1,DR Smith,Y Venugopal Rao,35,14,2,3,1,23,7,0,3,12,7,2,0
6480bb9d716a89dbf5e486d0,2011,,,1,J Botha,R Dravid,35,27,5,1,1,7,8,1,0,27,19,4,1
6480bb9be7cbbb90a12dc916,2009,,,1,Joginder Sharma,MS Dhoni,35,25,1,2,1,16,15,0,1,19,10,1,1
6480bb968211e65fcbffa192,2019,,,1,AB de Villiers,V Kohli,35,10,3,3,1,10,3,2,0,25,7,1,3
6480bb9e83b8575f74b8e962,2012,,,1,DJ Bravo,MS Dhoni,35,22,1,1,1,13,10,1,0,19,12,0,1
6480bb9b62eb35d78fcd7df0,2007/08,,,1,A Chopra,Salman Butt,35,36,5,0,1,13,17,2,0,18,19,3,0
6480bb9cb881721acc1bab60,2009,,,2,DJ Hussey,WP Saha,35,11,2,3,1,26,8,2,2,7,3,0,1
6480bb9edb0554f003f5428a,2012,,,2,CH Gayle,MA Agarwal,35,27,4,1,1,25,14,3,1,10,13,1,0
6480bba097818bcc0db9555d,2014,,,1,CA Pujara,GJ Maxwell,35,26,2,1,1,15,14,2,0,17,12,0,1
6480bb9c13fa57328b17e4e2,2009/10,,,1,DA Warner,V Sehwag,35,21,6,1,1,6,8,1,0,29,13,5,1
6480bb9c2f07203e8e510386,2009/10,,,2,AB de Villiers,G Gambhir,35,34,3,0,1,7,13,0,0,22,21,3,0
6480bb9d967f5a4cfbd8c74d,2011,,,2,MK Tiwary,RN ten Doeschate,35,24,2,1,1,13,12,0,0,19,12,2,1
6480bb97dee20878b0c4246c,2021,,,1,SO Hetmyer,SS Iyer,35,30,2,1,1,17,15,1,1,16,15,1,0
6480bb95960e393c939ab44c,2018,,,2,BCJ Cutting,M Markande,35,25,2,2,1,30,15,2,2,3,10,0,0
6480bb9a325c576efe386437,2023,,,1,KD Karthik,MK Lomror,35,19,4,1,1,11,9,0,1,19,10,4,0
6480bba31cc11024436836b5,2016,,,2,KK Nair,Q de Kock,35,19,4,2,1,8,8,1,0,27,11,3,2
6480bb9bc80883a975281815,2009,,,1,KP Pietersen,R Dravid,35,24,6,0,1,19,14,3,0,16,10,3,0
6480bb9ee0795047740de5a7,2011,,,1,AM Rahane,J Botha,35,26,4,0,1,25,16,4,0,9,10,0,0
6480bb9eee740f701b0ee154,2011,,,1,M Vijay,SK Raina,35,27,2,3,1,21,17,1,2,14,10,1,1
6480bb98bd3ca4df44cf9d8f,2022,,,1,GJ Maxwell,SS Prabhudessai,35,19,3,2,1,29,14,2,2,6,5,1,0
6480bba3de527604cd2f96f3,2016,,,1,JP Duminy,KK Nair,35,27,3,0,1,17,15,1,0,17,12,2,0
6480bb990b96e91d3fbf421b,2022,,,2,D Padikkal,JC Buttler,35,31,1,2,1,9,12,0,0,26,19,1,2
6480bb973e451a92813d78cc,2020/21,,,1,DA Warner,MK Pandey,35,31,1,2,1,17,16,1,0,18,15,0,2
6480bba2ab35be3ffcfa932a,2016,,,2,EJG Morgan,KV Sharma,35,24,3,1,0,7,7,0,0,26,17,3,1
6480bba0a3e806f41a4dab41,2013,,,1,JH Kallis,MK Tiwary,35,37,4,0,1,15,15,2,0,18,22,2,0
6480bba0fee4ae82492a666f,2013,,,1,KV Sharma,NLTC Perera,35,23,3,2,1,13,11,2,0,22,12,1,2
6480bb942fc9529eb2869c17,2018,,,1,Q de Kock,V Kohli,35,26,3,2,1,17,11,0,2,18,15,3,0
6480bb9be2940d96c1f903ca,2007/08,,,2,MV Boucher,R Dravid,35,30,5,0,1,17,15,3,0,18,15,2,0
6480bb95960e393c939ab44c,2018,,,1,Abhishek Sharma,V Shankar,35,19,1,2,0,15,10,0,1,16,9,1,1
6480bb96267b63eb2c6747b0,2019,,,2,AB de Villiers,S Dube,35,25,0,3,1,13,12,0,1,22,13,0,2
6480bb9aef150645306cc170,2023,,,1,AJ Hosein,H Klaasen,35,18,2,2,0,16,10,1,1,18,8,1,1
6480bba30373b229e0090b67,2016,,,1,F Behardien,MP Stoinis,35,18,4,1,0,9,7,1,0,26,11,3,1
6480bb9ba6cd609c32579bde,2009,,,2,AM Rahane,JP Duminy,35,19,2,2,1,10,8,1,0,22,11,1,2
6480bb94d8ce46258c13e90e,2017,,,1,JC Buttler,PA Patel,35,26,6,0,1,17,13,3,0,18,13,3,0
6480bb9abfe839459b1a28f6,2007/08,,,1,D Kalyankrishna,RG Sharma,35,18,6,0,1,3,8,0,0,31,10,6,0
6480bb973e3a3dbbb7ae3707,2020/21,,,2,CH Gayle,MA Agarwal,35,18,3,2,1,29,13,3,2,4,5,0,0
6480bb9bca2c11520f5b3b9e,2007/08,,,2,RR Powar,WA Mota,35,32,3,1,1,16,17,1,1,18,15,2,0
6480bb9439fcd1191cf17a90,2017,,,1,AJ Tye,KD Karthik,35,21,3,1,1,22,12,2,1,12,9,1,0
6480bb9da9ca2f2d3738d79e,2011,,,1,A Symonds,RG Sharma,35,30,3,1,0,16,15,2,0,19,15,1,1
6480bb94f27c8167d1685878,2017,,,1,CJ Anderson,SS Iyer,35,18,0,4,0,18,12,0,2,13,6,0,2
6480bb96e8ba017befb2bc8a,2020/21,,,1,RR Pant,SS Iyer,35,44,0,1,1,12,20,0,0,21,24,0,1
6480bb9c968c81bdfcc6df5b,2009,,,2,A Symonds,TL Suman,35,22,4,1,1,24,15,2,1,11,7,2,0
6480bb9e19dd5297ba8ca5f7,2011,,,2,JP Duminy,KC Sangakkara,35,35,2,1,1,13,17,0,0,22,18,2,1
6480bba11c977a5d11c1aa38,2015,,,2,AD Mathews,KM Jadhav,35,23,1,2,0,15,11,0,1,19,12,1,1
6480bba3d3dc891a3092643e,2016,,,1,AM Rahane,UT Khawaja,35,28,4,1,1,19,15,4,0,14,13,0,1
6480bb9c266a85f1960d87e9,2009,,,2,IK Pathan,KC Sangakkara,35,20,1,3,0,21,11,0,3,10,9,1,0
6480bb9f302200e3bc89464e,2012,,,2,AL Menaria,OA Shah,35,32,1,1,1,20,17,1,1,12,15,0,0
6480bb9c454e9eefca545bde,2009/10,,,2,MJ Lumb,NV Ojha,35,23,7,0,1,21,13,4,0,13,10,3,0
6480bb9cff4ec2f71cdf18d1,2009/10,,,2,MS Bisla,SE Marsh,35,20,4,0,1,11,10,1,0,16,10,3,0
6480bb980ea7c3bcea4fdf9c,2022,,,2,MA Agarwal,S Dhawan,35,28,2,2,1,25,17,2,2,5,11,0,0
6480bb9c17dcdfd5b06984f0,2009/10,,,2,AD Mathews,DJ Hussey,35,32,2,1,1,13,11,1,0,18,21,1,1
6480bba154ce29a67e4752df,2015,,,1,AB de Villiers,KD Karthik,35,10,4,2,1,19,5,3,1,13,5,1,1
6480bb973e3a3dbbb7ae3707,2020/21,,,1,MP Stoinis,S Dhawan,35,23,2,1,1,9,10,0,0,25,13,2,1
6480bba1017a98eead1ec861,2015,,,2,DA Miller,WP Saha,35,15,4,2,1,15,7,0,2,19,8,4,0
6480bb9c761c43b2dfb9767d,2009,,,2,AM Rahane,DJ Bravo,35,22,3,2,1,1,5,0,0,33,17,3,2
6480bb96ec01f8fb3504bc36,2020/21,,,1,MK Lomror,R Parag,35,34,1,1,1,17,16,0,1,16,18,1,0
6480bb9d61e9b86b0f0aae49,2009/10,,,1,A Symonds,RG Sharma,35,30,4,0,1,19,20,2,0,13,10,2,0
6480bb9e19dd5297ba8ca5f7,2011,,,1,MR Marsh,WD Parnell,35,27,1,2,1,25,14,1,2,8,13,0,0
6480bb931e6d2b03141b586d,2017,,,1,AD Mathews,RR Pant,35,14,2,4,1,1,4,0,0,34,10,2,4
6480bb98a95cb1650c81c926,2022,,,1,DJ Mitchell,SV Samson,35,32,1,3,1,7,11,0,0,27,21,1,3
6480bb9ec0a4e3f137edb047,2011,,,1,MA Agarwal,V Kohli,35,33,3,0,1,17,21,2,0,12,12,1,0
6480bb9b09e6c98206422ae5,2009,,,1,CH Gayle,LR Shukla,35,26,2,2,1,21,18,1,2,8,8,1,0
6480bb98d2cd0fa3ed0ffc21,2022,,,1,K Rabada,OF Smith,35,22,4,2,1,25,16,4,1,7,6,0,1
6480bba1de7febd9f1f0138e,2014,,,1,DR Smith,F du Plessis,35,34,4,0,1,13,15,2,0,20,19,2,0
6480bb9fd4a1af6234c9e57c,2012,,,2,Mandeep Singh,N Saini,35,25,4,0,1,16,12,2,0,19,13,2,0
6480bb98cbaaf700d226941a,2022,,,1,D Padikkal,JC Buttler,35,20,3,3,1,7,7,1,0,28,13,2,3
6480bba1448ab5c40ac64696,2014,,,2,AT Rayudu,RG Sharma,35,40,3,0,1,24,18,3,0,11,22,0,0
6480bb987b6845947f7ca137,2022,,,1,KK Nair,SV Samson,35,28,4,0,1,13,13,1,0,21,15,3,0
6480bb960d9d6af315534958,2019,,,2,KD Karthik,Shubman Gill,35,19,3,1,0,21,9,2,1,12,10,1,0
6480bb9836af59f8283f4081,2022,,,1,JC Buttler,SO Hetmyer,35,11,1,4,1,29,8,1,4,1,3,0,0
6480bba136257b71aa9952cf,2014,,,1,MM Sharma,MS Dhoni,35,20,3,2,0,1,3,0,0,27,17,3,2
6480bba3ebbd8e4867dfa673,2016,,,1,KK Nair,SV Samson,35,21,6,0,1,24,12,5,0,10,9,1,0
6480bb9d91920239b62f48ad,2009/10,,,2,KA Pollard,R McLaren,35,14,2,3,1,20,7,0,3,12,7,2,0
6480bb9baa08d0494c0b8dc3,2007/08,,,2,A Kumble,R Dravid,35,20,2,3,1,8,8,1,0,27,12,1,3
6480bb94cb5adf24f5ad15c3,2017,,,1,LMP Simmons,PA Patel,35,27,1,3,1,5,13,0,0,28,14,1,3
6480bb996c324f07ab7f763c,2023,,,1,B Sai Sudharsan,V Shankar,35,24,2,0,1,18,13,1,0,17,11,1,0
6480bb9da9ca2f2d3738d79e,2011,,,2,M Kartik,RV Uthappa,35,30,4,0,1,11,13,1,0,21,17,3,0
6480bb9f03dd3a09740f0bd0,2013,,,1,AM Rahane,R Dravid,35,32,5,0,1,17,12,3,0,17,20,2,0
6480bb9d0f6794fbf429449b,2011,,,2,KM Jadhav,RA Jadeja,35,19,1,3,1,12,11,1,0,23,8,0,3
6480bba07fa24b891b818984,2013,,,2,AT Rayudu,RG Sharma,35,29,4,0,1,21,14,3,0,11,15,1,0
6480bb9692a7f0d52bd43127,2019,,,1,PA Patel,V Kohli,35,21,6,0,1,17,13,4,0,13,8,2,0
6480bb9db0ecec8acdd30619,2011,,,2,JD Ryder,TD Paine,35,31,2,1,1,23,14,2,1,8,17,0,0
6480bba1551dc12c8f2a7038,2014,,,1,KD Karthik,M Vijay,35,21,3,1,1,18,13,2,0,14,8,1,1
6480bb9c71030f4c6f018f55,2009,,,1,AC Gilchrist,HH Gibbs,34,26,6,1,1,23,13,4,1,11,13,2,0
6480bb931ee18ac840f40603,2017,,,1,HM Amla,WP Saha,34,31,0,1,1,21,16,0,1,11,15,0,0
6480bb9c2f07203e8e510386,2009/10,,,2,G Gambhir,KD Karthik,34,29,5,0,1,13,11,2,0,20,18,3,0
6480bb9a1a3e8cef5633f4e6,2023,,,1,H Klaasen,MA Agarwal,34,17,3,2,1,13,7,2,0,21,10,1,2
6480bb9a3d3f26063faa9f71,2007/08,,,1,M Kartik,WP Saha,34,23,3,1,1,17,13,2,0,17,10,1,1
6480bba2f05e90a9005771d2,2015,,,2,DR Smith,SK Raina,34,20,3,3,1,20,13,3,1,13,7,0,2
6480bb932d6ccb8870dcd72d,2017,,,1,AR Patel,HM Amla,34,32,1,1,1,23,19,1,1,9,13,0,0
6480bba1c67d2c9c1279a4c8,2014,,,2,DA Warner,NV Ojha,34,18,1,3,1,17,7,0,2,15,11,1,1
6480bba03a099a1a2e9c3dc5,2013,,,1,DA Miller,SE Marsh,34,29,4,1,1,15,15,1,1,18,14,3,0
6480bb9b62eb35d78fcd7df0,2007/08,,,2,A Mishra,MF Maharoof,34,29,3,0,1,24,17,3,0,10,12,0,0
6480bba177ab201442a0e3c8,2015,,,1,KD Karthik,V Kohli,34,28,2,1,1,9,11,1,0,19,17,1,1
6480bba2679194b06d4834db,2016,,,1,DA Warner,EJG Morgan,34,25,3,0,1,23,13,2,0,11,12,1,0
6480bb9f955d5c84cde78f58,2012,,,2,CJ Ferguson,SPD Smith,34,33,3,0,1,16,17,1,0,16,16,2,0
6480bba1b85900d7d83de308,2014,,,2,DA Miller,GJ Maxwell,34,25,2,2,1,8,10,0,0,25,15,2,2
6480bb98436587de59527f2e,2022,,,1,Ishan Kishan,Tilak Varma,34,22,5,0,1,12,7,2,0,22,15,3,0
6480bba2bae80e615447f251,2015,,,1,BB McCullum,SK Raina,34,27,6,0,1,20,15,4,0,14,12,2,0
6480bb954817ed0a4ba25bc2,2018,,,2,CH Gayle,KL Rahul,34,23,4,2,1,18,11,2,1,16,12,2,1
6480bb9e80233e83b9d1be1f,2012,,,2,NV Ojha,V Sehwag,34,31,3,1,1,13,15,2,0,14,16,1,1
6480bb9d76ba2d9dd45c74a8,2011,,,1,J Botha,SR Watson,34,19,3,2,1,10,6,2,0,24,13,1,2
6480bb96ec01f8fb3504bc36,2020/21,,,2,AB de Villiers,V Kohli,34,20,4,0,0,12,10,1,0,22,10,3,0
6480bb9e5de755887230bb00,2012,,,1,JD Ryder,SC Ganguly,34,32,3,0,1,17,16,2,0,16,16,1,0
6480bb9f3700dfaa08e18c43,2012,,,2,DJ Bravo,JA Morkel,34,19,2,3,1,20,11,1,2,14,8,1,1
6480bb981dc3f7250f93bc92,2022,,,2,R Powell,RR Pant,34,25,3,2,1,27,13,2,2,6,12,1,0
6480bb95b1f28cf5bcf5e167,2018,,,1,KS Williamson,SP Goswami,34,22,6,0,1,22,13,4,0,12,9,2,0
6480bb9ca5c1d511ad78e92d,2009,,,1,JH Kallis,MV Boucher,34,26,2,1,0,22,17,1,1,10,9,1,0
6480bb9eb35365cccf73d55c,2011,,,1,S Rana,Yuvraj Singh,34,33,3,0,1,15,13,2,0,17,20,1,0
6480bba2b99fcf06aaeac805,2015,,,2,KK Nair,SV Samson,34,16,3,2,1,7,5,1,0,26,11,2,2
6480bba25855b7a7195a9bc5,2016,,,2,KA Pollard,RG Sharma,34,27,1,1,1,19,18,0,1,12,9,1,0
6480bb98f98edd45b1ccb406,2022,,,1,DJ Hooda,KH Pandya,34,32,2,1,1,18,12,1,1,15,20,1,0
6480bb9c89f35f11aae1f2d0,2009/10,,,2,AC Voges,YK Pathan,34,25,3,2,1,10,11,1,0,24,14,2,2
6480bb9d9f4551d7ec79c951,2009/10,,,1,DPMD Jayawardene,SE Marsh,34,18,4,2,1,21,8,2,2,10,10,2,0
6480bba15f6842352b6338ae,2014,,,1,MK Pandey,RV Uthappa,34,28,2,1,1,6,11,0,0,25,17,2,1
6480bba16e510ff78ef635a1,2014,,,2,SR Watson,SV Samson,34,33,5,1,1,8,18,1,0,24,15,4,1
6480bb9763013a01eae041f2,2020/21,,,2,DA Warner,JM Bairstow,34,25,2,2,1,6,10,0,0,25,15,2,2
6480bba0ffae8617ee64bd19,2013,,,2,J Botha,UBT Chand,34,26,4,2,1,17,14,2,1,16,12,2,1
6480bb9d91920239b62f48ad,2009/10,,,2,R McLaren,SR Tendulkar,34,36,4,0,1,12,18,1,0,19,18,3,0
6480bb96c40b697b63d08717,2019,,,1,KS Williamson,MK Pandey,34,42,1,0,1,12,17,0,0,18,25,1,0
6480bb9d182be5b0fbe5a4e2,2011,,,1,J Botha,LRPL Taylor,34,34,2,0,1,20,17,1,0,12,17,1,0
6480bb9f36ad55c3c7fd6548,2012,,,1,KD Karthik,SR Tendulkar,34,30,4,1,1,18,18,3,0,16,12,1,1
6480bb9e34659755628e7471,2012,,,1,MK Pandey,SPD Smith,34,10,1,4,1,12,4,1,1,19,6,0,3
6480bb94c2dcb1007bf6788b,2017,,,2,AR Patel,WP Saha,34,21,2,1,1,19,10,1,1,13,11,1,0
6480bb95b98d000799e11963,2018,,,1,C de Grandhomme,SN Khan,34,13,2,3,1,17,8,0,2,16,5,2,1
6480bb9ca21b98f1be8254e2,2009/10,,,1,KM Jadhav,PD Collingwood,34,24,1,2,1,7,9,0,0,25,15,1,2
6480bba287d112bccc55ccd2,2015,,,1,M Vohra,WP Saha,34,13,5,1,1,1,1,0,0,31,12,5,1
6480bb966539f85263cb6429,2019,,,1,AT Rayudu,MS Dhoni,34,10,2,3,0,5,2,1,0,26,8,1,3
6480bb9525ace33768e8b671,2019,,,2,JM Bairstow,V Shankar,34,32,1,2,1,27,21,1,2,7,11,0,0
6480bba388682c5ca10ff37a,2016,,,2,DA Warner,MC Henriques,34,19,4,1,1,29,14,4,1,4,5,0,0
6480bb98adf21699eaa67796,2022,,,2,DP Conway,MM Ali,34,27,4,1,1,20,13,2,1,14,14,2,0
6480bb991a76403912eef285,2023,,,2,D Padikkal,SV Samson,34,32,1,0,1,11,18,0,0,17,14,1,0
6480bb95d4da0397e79acffa,2019,,,1,CA Lynn,SP Narine,34,16,3,3,1,10,10,2,0,24,6,1,3
6480bb9ccfdcb55be258ec95,2009,,,2,BB McCullum,SC Ganguly,34,29,5,1,1,29,15,5,1,4,14,0,0
6480bba0adee98d459585bed,2014,,,1,M Vijay,Q de Kock,34,41,3,0,1,10,17,1,0,16,24,2,0
6480bb94834e2b780c4782b5,2017,,,1,MK Pandey,YK Pathan,34,16,1,3,1,11,9,1,0,20,7,0,3
6480bb9af968df9497d2b9c4,2007/08,,,1,DJ Hussey,RT Ponting,34,39,4,0,1,17,20,3,0,13,19,1,0
6480bb9ea1e127d68e288e04,2011,,,2,BB McCullum,Y Gnaneswara Rao,34,26,5,0,1,13,9,2,0,19,17,3,0
6480bb9c89e2e8ecb04f94cb,2009/10,,,2,DA Warner,V Sehwag,34,23,4,2,1,31,16,4,2,3,7,0,0
6480bb9eb559e2934b31c47c,2012,,,1,M Vijay,SK Raina,34,31,1,1,1,10,15,1,0,22,16,0,1
6480bba1743abcb135a6a4c7,2015,,,2,CH Morris,JP Faulkner,34,17,1,3,1,4,5,0,0,29,12,1,3
6480bb9772f78629131db057,2021,,,2,KL Rahul,M Shahrukh Khan,34,24,2,3,1,26,14,2,2,8,10,0,1
6480bb95c8ecc2185a67f4fd,2019,,,2,Rashid Khan,YK Pathan,34,20,1,2,0,15,8,1,1,16,12,0,1
6480bba2f36e449a59f4a812,2015,,,1,JP Duminy,MA Agarwal,34,27,3,1,1,13,14,2,0,16,13,1,1
6480bb9ac9149c73fdf073b3,2023,,,2,AR Patel,DA Warner,34,16,2,3,1,15,8,1,1,18,8,1,2
6480bb95e25835586d412978,2018,,,1,CH Gayle,Yuvraj Singh,34,30,2,1,1,22,20,2,1,6,10,0,0
6480bb96e18d7a1b3e62552d,2019,,,1,KS Williamson,Mohammad Nabi,34,14,1,3,1,14,7,1,1,17,7,0,2
6480bba223f162806c0794ac,2015,,,2,AT Rayudu,HH Pandya,34,13,1,4,0,12,5,1,1,21,8,0,3
6480bb9a5d25d853e1cbfe3e,2007/08,,,2,JR Hopes,K Goel,34,29,5,2,1,8,8,2,0,26,21,3,2
6480bb951354c40599b60208,2018,,,1,CR Brathwaite,YK Pathan,34,18,1,3,1,21,11,0,3,10,7,1,0
6480bb9e80233e83b9d1be1f,2012,,,1,CJ McKay,Harbhajan Singh,34,27,4,1,1,8,15,0,0,25,12,4,1
6480bb9e93f969bcc8a79433,2011,,,2,MEK Hussey,S Badrinath,34,32,1,1,1,12,15,0,0,22,17,1,1
6480bba133267f04941acf7d,2014,,,1,DA Warner,KL Rahul,34,25,4,1,1,20,10,2,1,14,15,2,0
6480bb9b7b8617115de9683b,2007/08,,,2,PA Patel,SK Raina,34,31,5,0,1,10,16,1,0,19,15,4,0
6480bb9f146f5849bb759148,2013,,,1,PA Patel,PA Reddy,34,32,4,0,1,19,18,3,0,12,14,1,0
6480bb964c4bea88164f168d,2020/21,,,1,EJG Morgan,PJ Cummins,34,22,2,1,1,19,12,1,1,12,10,1,0
6480bb975ea60ce128803d60,2021,,,2,KD Karthik,PJ Cummins,34,22,3,2,1,16,9,1,1,18,13,2,1
6480bb9a9801c2dda3fe88e9,2007/08,,,2,KD Karthik,MK Tiwary,34,29,3,1,1,24,14,2,1,10,15,1,0
6480bb9993e6e474a4e37366,2023,,,2,AT Rayudu,RD Gaikwad,34,23,3,1,0,20,16,3,0,11,7,0,1
6480bb99e909d98c8193bac5,2023,,,2,HC Brook,MA Agarwal,34,37,4,0,1,13,21,1,0,21,16,3,0
6480bb97af44a48533f08540,2020/21,,,2,SPD Smith,SV Samson,34,21,4,1,1,15,12,2,0,19,9,2,1
6480bba065b341458c934986,2013,,,2,DB Das,R Bhatia,34,41,2,1,1,16,22,1,1,14,19,1,0
6480bb9404b444be6724e41e,2017,,,1,KK Nair,MN Samuels,34,31,1,2,1,6,10,0,0,27,21,1,2
6480bba16e510ff78ef635a1,2014,,,1,CJ Anderson,MEK Hussey,34,15,2,3,1,18,7,1,2,15,8,1,1
6480bb9a9dc58f49d783faa9,2023,,,1,Anuj Rawat,MG Bracewell,34,15,3,2,0,29,11,3,2,5,4,0,0
6480bb9af968df9497d2b9c4,2007/08,,,1,DB Das,RT Ponting,34,28,5,1,1,29,20,5,1,4,8,0,0
6480bb949a2d28d1ad7d367f,2018,,,1,G Gambhir,RR Pant,34,19,4,1,1,6,6,0,0,28,13,4,1
6480bb9a87f64c1a12f62ece,2007/08,,,1,ML Hayden,PA Patel,34,19,5,1,1,15,8,2,1,14,11,3,0
6480bba2eea6f31945e4c5e2,2016,,,2,HH Pandya,RG Sharma,34,26,0,1,1,9,10,0,0,20,16,0,1
6480bb9c2f07203e8e510386,2009/10,,,1,KC Sangakkara,RS Bopara,34,23,2,2,1,17,9,1,1,15,14,1,1
6480bb974e2f8e7f41c506dc,2021,,,2,Q de Kock,SA Yadav,34,20,6,0,1,18,10,3,0,16,10,3,0
6480bb97a4220e27710e38de,2021,,,2,N Rana,RA Tripathi,34,25,5,1,1,9,5,0,1,25,20,5,0
6480bb994aafcf67cd092a7d,2023,,,1,Abishek Porel,SN Khan,34,23,1,2,1,20,11,0,2,14,12,1,0
6480bb9b2ca4a7b325526f1f,2009,,,1,AC Gilchrist,HH Gibbs,34,25,5,1,1,25,15,4,1,8,10,1,0
6480bba29f384ce360fa8131,2016,,,1,GJ Maxwell,WP Saha,34,14,3,2,0,30,10,3,2,4,4,0,0
6480bb9c7ac2dca34620d56e,2009/10,,,1,MS Dhoni,SK Raina,34,34,3,0,1,14,19,1,0,17,15,2,0
6480bba0c7bf2b92ac8d836a,2013,,,2,OA Shah,SV Samson,34,32,2,1,1,19,16,2,0,15,16,0,1
6480bb94c008939d7976abfe,2018,,,2,GJ Maxwell,RR Pant,34,21,4,1,1,17,11,2,1,15,10,2,0
6480bb931b06a170006b4713,2017,,,2,Ishan Kishan,SK Raina,34,26,4,1,1,4,11,0,0,30,15,4,1
6480bb9754755bb7a7427d52,2021,,,2,DA Miller,SV Samson,34,31,3,0,0,24,23,3,0,7,8,0,0
6480bba0d4b2f9be71a5f230,2014,,,2,JDS Neesham,JP Duminy,34,20,1,3,1,8,11,0,1,21,9,1,2
6480bb9f03dd3a09740f0bd0,2013,,,2,EJG Morgan,R Bhatia,34,19,3,2,1,21,12,1,2,12,7,2,0
6480bb950ddd55d8aed7d015,2019,,,1,BA Stokes,SPD Smith,34,28,2,1,0,7,14,0,0,22,14,2,1
6480bba2d313234709068efb,2015,,,1,LMP Simmons,RG Sharma,34,25,2,2,1,18,12,1,1,15,13,1,1
6480bba388682c5ca10ff37a,2016,,,2,B Kumar,BCJ Cutting,34,8,2,3,0,1,1,0,0,28,7,2,3
6480bb9d8f5769d3a514fd88,2009/10,,,1,R Dravid,RV Uthappa,34,20,2,2,1,7,7,0,0,26,13,2,2
6480bba26bb69626041c4ba1,2015,,,1,D Wiese,Mandeep Singh,34,14,2,2,0,9,7,0,0,24,7,2,2
6480bb93c1cc671d66c471ba,2017,,,2,MK Pandey,SP Narine,34,12,2,3,1,31,10,2,3,1,2,0,0
6480bb9e502d7987de08e5d5,2012,,,2,CL White,KC Sangakkara,33,31,2,1,1,20,17,1,1,12,14,1,0
6480bb9c1e676472f4841aa9,2009/10,,,2,JA Morkel,S Badrinath,33,21,5,1,1,4,7,0,0,29,14,5,1
6480bb999424dd02cf40772a,2022,,,2,KL Rahul,M Vohra,33,21,1,2,1,8,10,0,0,19,11,1,2
6480bb96e2809aa0bc35c7e9,2019,,,2,MK Pandey,V Shankar,33,37,2,0,1,20,20,2,0,12,17,0,0
6480bb949a2d28d1ad7d367f,2018,,,2,KK Nair,Yuvraj Singh,33,27,5,1,1,27,13,4,1,6,14,1,0
6480bb989bf19eb260a04f0e,2022,,,1,N Rana,SP Jackson,33,18,1,3,1,26,11,1,2,7,7,0,1
6480bb9c58b62383739c022e,2009,,,1,SR Tendulkar,ST Jayasuriya,33,36,0,0,1,10,15,0,0,16,21,0,0
6480bb958c7b985a2b586a02,2018,,,2,RK Singh,Shubman Gill,33,30,3,0,1,16,18,2,0,11,12,1,0
6480bb9553f3fc8903579544,2018,,,1,HH Pandya,RG Sharma,33,21,0,3,1,19,13,0,2,12,8,0,1
6480bb962a1612c936d161ba,2019,,,2,DJ Bravo,MJ Santner,33,27,2,1,1,17,12,2,0,14,15,0,1
6480bba35038a60ea566794a,2016,,,2,DA Warner,NV Ojha,33,20,1,3,1,23,12,1,2,10,8,0,1
6480bb93d9581d69657887c3,2017,,,2,AP Tare,SW Billings,33,28,4,0,1,18,17,3,0,14,11,1,0
6480bb948f3284f793b2763c,2018,,,2,Mandeep Singh,V Kohli,33,29,2,0,1,16,14,1,0,14,15,1,0
6480bba32e54551792a9e915,2016,,,2,MJ Guptill,RG Sharma,33,23,4,2,1,3,6,0,0,30,17,4,2
6480bba1cef79f12933bbf27,2014,,,1,DR Smith,F du Plessis,33,21,7,0,1,14,10,3,0,19,11,4,0
6480bb9af1b34d6aa89e434e,2023,,,2,LS Livingstone,SM Curran,33,11,1,4,1,19,6,0,3,11,5,1,1
6480bb9f955d5c84cde78f58,2012,,,1,AM Rahane,BJ Hodge,33,23,3,0,1,18,9,3,0,14,14,0,0
6480bba0f401cc6b6bc6ed10,2013,,,1,BJ Hodge,JP Faulkner,33,21,2,2,0,18,10,0,2,11,11,2,0
6480bb996c324f07ab7f763c,2023,,,1,Shubman Gill,WP Saha,33,26,4,0,1,10,9,1,0,17,17,3,0
6480bb9f58a3e7ea877fc9dc,2012,,,2,Azhar Mahmood,Mandeep Singh,33,21,4,1,1,9,5,1,0,24,16,3,1
6480bb9754755bb7a7427d52,2021,,,1,KD Karthik,RA Tripathi,33,30,2,1,1,15,15,2,0,16,15,0,1
6480bb96f8379d02d3435ceb,2020/21,,,1,N Rana,RA Tripathi,33,23,1,2,1,9,10,1,0,23,13,0,2
6480bba1603d86b7d278a366,2015,,,1,G Gambhir,RV Uthappa,33,26,2,2,1,19,16,0,2,12,10,2,0
6480bb9c9685addc4a78d7d0,2009/10,,,2,AD Mathews,MK Tiwary,33,20,3,0,1,19,11,2,0,11,9,1,0
6480bb9baa08d0494c0b8dc3,2007/08,,,2,DT Patil,R Dravid,33,20,3,1,1,9,12,0,0,22,8,3,1
6480bb9a17692bfb5bd3894c,2007/08,,,2,AB de Villiers,S Dhawan,33,27,3,0,0,13,10,1,0,19,17,2,0
6480bb9e65a802582c071438,2012,,,1,DJ Hussey,SE Marsh,33,31,1,1,1,20,14,1,1,11,17,0,0
6480bb94b9d954a885cc531b,2017,,,1,AT Rayudu,RG Sharma,33,28,5,0,1,11,13,1,0,21,15,4,0
6480bb9db6a011b38afed5dc,2011,,,1,MD Mishra,R Sharma,33,19,1,3,0,21,10,1,2,10,9,0,1
6480bba0001885407e860a8d,2013,,,1,PA Patel,S Dhawan,33,28,5,0,1,11,12,1,0,22,16,4,0
6480bb9ab99ef699d66ad5a0,2023,,,1,LS Livingstone,MW Short,33,25,2,1,1,24,16,2,1,7,9,0,0
6480bb95f214d4f82ab97ee5,2018,,,2,CA Lynn,N Rana,33,27,3,1,1,11,10,1,0,21,17,2,1
6480bb99fa79383bdc7df827,2022,,,2,F du Plessis,V Kohli,33,20,4,1,1,10,6,2,0,20,14,2,1
6480bba2e680f2464af841ae,2015,,,2,EJG Morgan,MC Henriques,33,39,2,0,1,22,25,2,0,10,14,0,0
6480bb9b4fc6889967a3cd54,2007/08,,,2,DJ Thornely,SR Tendulkar,33,33,4,0,1,8,16,0,0,21,17,4,0
6480bb9bb070eb19f9ac8a76,2007/08,,,1,SE Marsh,Yuvraj Singh,33,30,3,0,1,13,15,1,0,17,15,2,0
6480bb95945c5e5dc4d8c7d6,2019,,,1,RG Sharma,SA Yadav,33,25,3,0,1,17,14,2,0,12,11,1,0
6480bba136257b71aa9952cf,2014,,,1,BB McCullum,SK Raina,33,8,5,2,1,0,1,0,0,32,7,5,2
6480bb96593f4f87a2c294bc,2020/21,,,1,AB de Villiers,V Kohli,33,28,1,0,1,19,15,1,0,14,13,0,0
6480bb9836af59f8283f4081,2022,,,2,KA Pollard,TH David,33,23,2,1,1,10,14,0,0,20,9,2,1
6480bba28257fe87dd859e3e,2015,,,1,DA Miller,GJ Bailey,33,27,2,0,1,19,14,2,0,13,13,0,0
6480bb977f55a1c473670850,2021,,,2,Ishan Kishan,SA Yadav,33,14,6,0,1,19,6,3,0,13,8,3,0
6480bb9ba9d43057d652a5fe,2009,,,2,DJ Bravo,JP Duminy,33,31,3,1,1,15,20,1,1,15,11,2,0
6480bb964a4d5a1709db428e,2020/21,,,2,KL Rahul,N Pooran,33,22,2,2,1,9,10,0,0,24,12,2,2
6480bb9fa236b26050f19633,2012,,,1,R Dravid,SP Goswami,33,31,3,0,1,19,15,2,0,12,16,1,0
6480bba1d9f266a28a109f29,2015,,,1,M Vijay,V Sehwag,33,30,4,1,1,19,18,2,1,11,12,2,0
6480bb9fcb2b412c0ebd4afa,2013,,,1,GH Vihari,KC Sangakkara,33,32,2,0,1,14,15,1,0,16,17,1,0
6480bb9371e90dbd44ee19a3,2017,,,2,DA Miller,EJG Morgan,33,32,3,0,1,11,17,0,0,20,15,3,0
6480bb951677500061c85592,2019,,,2,DA Warner,JM Bairstow,33,22,5,0,1,15,12,2,0,16,10,3,0
6480bba0c3cc8c51bc6c1c3a,2013,,,2,AB de Villiers,V Kohli,33,25,4,0,1,21,13,3,0,10,12,1,0
6480bba32e54551792a9e915,2016,,,2,KA Pollard,N Rana,33,19,4,1,1,3,7,0,0,27,12,4,1
6480bb98cce4ab46512c2c03,2022,,,2,E Lewis,Q de Kock,33,20,2,1,1,23,11,2,1,9,9,0,0
6480bb9e1d754facf4fad618,2012,,,2,MN Samuels,SPD Smith,33,22,2,1,1,20,13,2,1,10,9,0,0
6480bb9f7ff1377c4d13a645,2013,,,2,AD Mathews,Yuvraj Singh,33,26,1,2,1,9,12,0,0,23,14,1,2
6480bb94640655c49683aee1,2018,,,2,JC Archer,K Gowtham,33,14,4,1,1,8,6,1,0,23,8,3,1
6480bb9a1032ce724214f6dd,2007/08,,,2,AB de Villiers,V Sehwag,33,23,3,2,1,21,17,2,1,12,6,1,1
6480bb964a4d5a1709db428e,2020/21,,,2,KL Rahul,MA Agarwal,33,21,4,1,1,21,11,3,1,11,10,1,0
6480bb982fc21d541267f7b9,2022,,,2,AM Rahane,N Rana,33,22,3,1,1,8,5,1,0,21,17,2,1
6480bb94988cb8c136ec7e46,2018,,,1,KK Nair,R Ashwin,33,20,1,2,1,19,9,1,1,14,11,0,1
6480bb9a51ee1ef33a5b2dbb,2007/08,,,1,SE Marsh,Yuvraj Singh,33,18,4,2,1,16,8,2,1,17,10,2,1
6480bb9b17739118ee6c3bd0,2007/08,,,1,SC Ganguly,Salman Butt,33,30,6,0,1,8,12,1,0,24,18,5,0
6480bba0ad06ad631cf7665f,2014,,,1,F du Plessis,MS Dhoni,33,16,1,2,1,14,8,0,1,18,8,1,1
6480bba18a431be2cc738de0,2014,,,1,M Vijay,Q de Kock,33,25,3,1,1,13,11,1,0,20,14,2,1
6480bb9df46e9f48932124df,2009/10,,,2,G Gambhir,V Sehwag,33,18,5,0,1,17,9,3,0,14,9,2,0
6480bb97ce981c1918dce924,2021,,,1,KH Pandya,SA Yadav,33,15,3,2,1,9,7,1,0,24,8,2,2
6480bb9da398a7c3c645732c,2011,,,1,AL Menaria,LRPL Taylor,33,24,2,2,1,19,12,0,2,14,12,2,0
6480bba26bb69626041c4ba1,2015,,,2,G Gambhir,RV Uthappa,33,23,5,0,1,12,8,2,0,17,15,3,0
6480bba22349149c9ec92d49,2016,,,1,MS Dhoni,SS Tiwary,33,32,2,0,1,20,20,2,0,11,12,0,0
6480bb9f146f5849bb759148,2013,,,2,AM Nayar,LRPL Taylor,33,27,2,0,1,19,14,2,0,14,13,0,0
6480bba280f09c38002cf14b,2015,,,2,M Vohra,WP Saha,33,30,0,2,1,22,20,0,2,8,10,0,0
6480bb96e61ac20a6e10582e,2019,,,1,AT Rayudu,M Vijay,33,38,2,0,1,15,18,1,0,16,20,1,0
6480bb96c3293977af83acbf,2019,,,2,RR Pant,SS Iyer,33,25,1,4,1,18,16,1,2,15,9,0,2
6480bb9b9dd7fe8c5cbdbab0,2009,,,1,ML Hayden,SK Raina,33,17,1,2,1,22,10,1,2,5,7,0,0
6480bb9800ba03eb1f9437d2,2022,,,1,M Jansen,Shashank Singh,33,11,1,4,0,8,5,0,1,25,6,1,3
6480bba1d3370c13ea1f79f3,2014,,,1,CH Gayle,PA Patel,33,33,3,2,1,22,23,1,2,11,10,2,0
6480bb9558345af5a1bb044d,2019,,,2,Ishan Kishan,SA Yadav,33,17,0,4,1,21,9,0,3,12,8,0,1
6480bb9996eb97dd08b62f78,2023,,,2,P Simran Singh,SM Curran,33,26,1,3,1,23,14,0,3,10,12,1,0
6480bba13b673297bce003e2,2014,,,1,RV Uthappa,YK Pathan,33,20,1,2,1,9,7,0,0,22,13,1,2
6480bb9d66dc7da0d45e453c,2011,,,2,DJ Hussey,KD Karthik,33,34,2,0,1,15,20,1,0,15,14,1,0
6480bb9b7b8617115de9683b,2007/08,,,2,JA Morkel,SK Raina,33,24,2,1,0,12,12,1,0,21,12,1,1
6480bb96c10dfe3d8c259db3,2020/21,,,1,AB de Villiers,S Dube,33,18,3,2,1,16,7,1,1,17,11,2,1
6480bb96e29253678ca02869,2020/21,,,1,KL Rahul,Mandeep Singh,33,23,0,2,1,6,7,0,0,27,16,0,2
6480bb967d799ced7fe5d8e9,2020/21,,,2,MK Pandey,V Shankar,33,44,3,0,1,11,21,0,0,20,23,3,0
6480bb953aab41e7ed166b9d,2019,,,2,Q de Kock,RG Sharma,33,21,4,1,1,18,8,2,1,14,13,2,0
6480bb9ade063258af41163b,2007/08,,,2,A Symonds,SB Bangar,33,19,1,3,1,22,12,1,2,9,7,0,1
6480bb9a9801c2dda3fe88e9,2007/08,,,2,G Gambhir,Shoaib Malik,33,21,6,0,1,14,8,3,0,17,13,3,0
6480bba2a215721aadf7a90a,2015,,,2,JP Faulkner,SV Samson,33,21,2,2,1,14,10,2,0,19,11,0,2
6480bb9ce93a7b4315d8fa30,2009,,,1,AC Gilchrist,TL Suman,33,17,5,1,1,28,10,5,1,3,7,0,0
6480bb9b2e179d359c1d446d,2009,,,1,AA Bilakhia,RG Sharma,33,39,3,0,1,12,19,1,0,17,20,2,0
6480bba2bbd9d85769220a68,2015,,,2,JP Duminy,Yuvraj Singh,33,28,5,0,1,8,10,1,0,22,18,4,0
6480bb962a1612c936d161ba,2019,,,1,HH Pandya,KA Pollard,33,22,3,1,0,19,10,1,1,13,12,2,0
6480bb9b9614f21d90333e15,2007/08,,,2,Kamran Akmal,YK Pathan,33,11,1,4,1,24,8,1,3,9,3,0,1
6480bba3bca9c998d5f3e3d0,2016,,,1,HM Amla,M Vijay,33,26,4,1,1,26,14,4,1,6,12,0,0
6480bb99fa79383bdc7df827,2022,,,1,LS Livingstone,R Dhawan,33,11,2,3,1,24,9,2,2,7,2,0,1
6480bb98dd9a2108c79e1014,2022,,,1,MA Agarwal,S Dhawan,33,22,5,0,1,22,12,4,0,9,10,1,0
6480bb931ee18ac840f40603,2017,,,2,HH Pandya,N Rana,33,14,2,3,0,15,4,2,1,17,10,0,2
6480bb99f33a7dd80eb0a544,2023,,,1,A Badoni,KR Mayers,33,16,3,3,1,4,4,1,0,27,12,2,3
6480bba38056992b92414bab,2016,,,1,G Gambhir,RV Uthappa,33,22,5,0,1,7,5,1,0,25,17,4,0
6480bb9b72f6a46338302131,2009,,,1,RG Sharma,Y Venugopal Rao,33,25,2,1,1,20,17,2,0,12,8,0,1
6480bb9ab83a3072124dda22,2023,,,1,AK Markram,H Klaasen,33,20,3,1,1,13,11,1,0,20,9,2,1
6480bb9a87f64c1a12f62ece,2007/08,,,2,AM Nayar,DJ Bravo,33,16,3,1,1,12,6,1,0,20,10,2,1
6480bb973d64aa91e60b4088,2021,,,1,MM Ali,SK Raina,33,22,1,2,1,24,16,1,2,2,6,0,0
6480bb9b8cc888fe3f01f2a4,2009,,,1,DPMD Jayawardene,SM Katich,33,25,4,0,1,13,9,2,0,17,16,2,0
6480bb9b9d7aa6d8e47576d7,2007/08,,,1,MS Dhoni,SK Raina,33,22,1,2,1,11,8,0,1,22,14,1,1
6480bba1ff89cb428182daa6,2014,,,1,Mandeep Singh,V Sehwag,33,27,4,1,1,3,8,0,0,26,19,4,1
6480bb9b77a0ff5cb3d0e3e0,2009,,,2,DA Warner,TM Dilshan,33,21,4,1,1,19,8,4,0,13,13,0,1
6480bb9f302200e3bc89464e,2012,,,2,R Dravid,SR Watson,33,28,5,1,1,20,15,4,0,13,13,1,1
6480bb9d918bd358d046889d,2011,,,1,DA Warner,V Sehwag,33,26,4,0,1,7,11,1,0,23,15,3,0
6480bb973e3a3dbbb7ae3707,2020/21,,,1,RR Pant,S Dhawan,33,31,2,1,1,14,20,1,0,18,11,1,1
6480bb99f47261f111a6cc1a,2023,,,1,DA Miller,R Tewatia,33,10,0,5,1,12,5,0,2,20,5,0,3
6480bb960d5042aa46b7776b,2020/21,,,1,Ishan Kishan,KA Pollard,33,26,3,1,1,18,12,1,1,15,14,2,0
6480bb9a07d46704efe103ef,2007/08,,,2,Misbah-ul-Haq,R Dravid,33,25,3,1,1,26,16,3,1,7,9,0,0
6480bb99350726d00af209bf,2022,,,1,F du Plessis,KD Karthik,33,10,1,4,0,3,2,0,0,30,8,1,4
6480bb9c8c6c106c6ffbeae4,2009/10,,,2,AB de Villiers,KM Jadhav,33,27,2,1,1,8,9,0,0,24,18,2,1
6480bba11a59d64bb4aa66f4,2014,,,2,JP Faulkner,VS Malik,33,13,1,4,0,32,11,1,4,1,2,0,0
6480bba18a289cc4b8d173a4,2014,,,1,MEK Hussey,RG Sharma,33,24,3,1,1,12,10,0,1,21,14,3,0
6480bb98b8bb5b0d2c2f0848,2022,,,2,D Pretorius,MS Dhoni,33,21,3,1,1,22,14,2,1,10,7,1,0
6480bba287d112bccc55ccd2,2015,,,2,CH Gayle,V Kohli,33,18,3,2,1,13,9,1,1,19,9,2,1
6480bb96b7b695186bbb6a3e,2019,,,2,F du Plessis,SR Watson,33,24,4,1,1,26,13,3,1,7,11,1,0
6480bb97ce981c1918dce924,2021,,,1,HH Pandya,Ishan Kishan,33,18,1,3,1,10,8,0,1,22,10,1,2
6480bb9498a98d52f9285b52,2017,,,2,AM Rahane,SPD Smith,33,29,0,1,1,17,13,0,1,15,16,0,0
6480bb9c21492b9a562c6f46,2009/10,,,1,AA Jhunjhunwala,YK Pathan,33,28,4,0,1,18,14,2,0,15,14,2,0
6480bba1e64915b9e7c849ca,2014,,,2,AR Patel,WP Saha,33,31,3,0,1,18,19,2,0,12,12,1,0
6480bb998454ba791a8fdbf8,2023,,,1,DA Warner,PP Shaw,33,22,6,0,1,17,12,3,0,15,10,3,0
6480bba0fee4ae82492a666f,2013,,,1,DW Steyn,KV Sharma,33,27,2,2,1,14,13,1,1,19,14,1,1
6480bb9d93cca4d1a7635fba,2011,,,2,DJ Jacobs,SR Tendulkar,33,26,3,2,1,22,16,2,2,9,10,1,0
6480bb97f2f0fabec8f94d86,2020/21,,,1,N Rana,RK Singh,33,26,4,0,1,22,15,3,0,11,11,1,0
6480bba1670ace74604a420f,2015,,,1,DR Smith,F du Plessis,33,25,4,0,1,15,15,2,0,17,10,2,0
6480bb9eda28fb340ed37b49,2012,,,2,JH Kallis,MK Tiwary,33,34,2,0,1,13,14,1,0,19,20,1,0
6480bb981f136a7564719d7f,2022,,,2,MS Wade,Shubman Gill,32,20,6,0,1,6,7,1,0,25,13,5,0
6480bb9f3700dfaa08e18c43,2012,,,2,DJ Bravo,RA Jadeja,32,32,3,1,1,19,18,1,1,13,14,2,0
6480bb9bb070eb19f9ac8a76,2007/08,,,2,AC Gilchrist,RG Sharma,32,22,2,2,1,19,9,2,1,13,13,0,1
6480bba031c5cf0145ae8cfe,2014,,,1,JP Faulkner,SPD Smith,32,19,4,1,0,8,7,0,1,21,12,4,0
6480bb98634dba60191637ad,2021,,,2,JO Holder,WP Saha,32,19,0,3,1,27,14,0,3,5,5,0,0
6480bba1587a54176a9badf4,2014,,,2,DJG Sammy,Y Venugopal Rao,32,16,4,2,1,17,8,1,2,15,8,3,0
6480bb94dcc956fa4ca06b92,2018,,,2,CA Lynn,KD Karthik,32,14,3,1,1,8,4,1,0,23,10,2,1
6480bba0ca27548122e36880,2013,,,2,G Gambhir,MS Bisla,32,17,4,0,1,14,8,3,0,6,9,1,0
6480bb95a09b947e0837a38a,2019,,,2,Ishan Kishan,KA Pollard,32,19,2,3,1,7,10,1,0,23,9,1,3
6480bb9e300070746cc2eb67,2011,,,2,AB de Villiers,V Kohli,32,24,4,0,1,18,12,3,0,14,12,1,0
6480bb9c8f3ef1685cdf4017,2009,,,2,AB Agarkar,SC Ganguly,32,30,2,1,1,15,16,2,0,13,14,0,1
6480bb9825eb960aded1ff64,2022,,,2,DA Miller,WP Saha,32,25,3,0,1,19,15,3,0,7,10,0,0
6480bb95430629e254bbc4fd,2018,,,2,KD Karthik,SP Narine,32,16,5,1,1,23,12,4,1,5,4,1,0
6480bb93d5dc00a79edede9c,2017,,,1,KA Pollard,N Rana,32,24,1,2,1,11,11,0,1,18,13,1,1
6480bba177ab201442a0e3c8,2015,,,1,AB de Villiers,DJG Sammy,32,24,1,2,1,25,15,1,2,6,9,0,0
6480bb9e8dfd9ba30b93cbd8,2012,,,1,DJ Harris,S Dhawan,32,24,5,0,1,15,14,3,0,14,10,2,0
6480bb9f4bdcea2f81049fe9,2012,,,1,AD Russell,DPMD Jayawardene,32,20,2,1,1,16,11,2,0,14,9,0,1
6480bb948f3284f793b2763c,2018,,,2,CR Woakes,V Kohli,32,22,1,2,1,11,11,0,1,21,11,1,1
6480bb9e692eaa193a417426,2012,,,2,IK Pathan,Y Nagar,32,20,3,1,1,17,9,1,1,14,11,2,0
6480bba1568e0f3990191600,2014,,,1,CH Gayle,VH Zol,32,31,6,0,1,17,19,3,0,15,12,3,0
6480bb9bdde9db92f880e40d,2007/08,,,1,SC Ganguly,WP Saha,32,29,3,1,1,17,14,1,1,13,15,2,0
6480bb97f56e9d700b27a098,2021,,,1,AB de Villiers,DR Sams,32,12,1,3,0,28,10,1,3,3,2,0,0
6480bba31cc11024436836b5,2016,,,1,AT Rayudu,JC Buttler,32,13,3,2,0,13,5,1,1,17,8,2,1
6480bba23ed328dbb847b4e7,2016,,,2,G Gambhir,MK Pandey,32,26,2,1,1,21,17,2,1,7,9,0,0
6480bb9e502d7987de08e5d5,2012,,,1,M Manhas,SPD Smith,32,18,0,3,1,6,8,0,0,24,10,0,3
6480bb94bf9a1728b1b12f4d,2018,,,2,AM Rahane,MK Lomror,32,27,0,1,1,21,15,0,1,11,12,0,0
6480bba13b673297bce003e2,2014,,,2,MA Starc,S Rana,32,19,3,0,0,12,8,1,0,18,11,2,0
6480bb9a577cde04d3672225,2023,,,2,AT Rayudu,S Dube,32,11,1,4,1,19,8,1,2,13,3,0,2
6480bb9f7258f976eb8fe943,2012,,,1,BJ Hodge,J Botha,32,41,1,0,1,19,21,1,0,12,20,0,0
6480bb990b96e91d3fbf421b,2022,,,1,GJ Maxwell,RM Patidar,32,20,1,2,1,24,13,1,2,7,7,0,0
6480bb9d918bd358d046889d,2011,,,2,DL Vettori,SS Tiwary,32,26,1,2,1,10,14,0,1,14,12,1,1
6480bb9cb881721acc1bab60,2009,,,2,BJ Hodge,DJ Hussey,32,18,3,1,1,19,11,3,0,11,7,0,1
6480bb9a77f349a0fd8d96d6,2023,,,2,R Parag,SO Hetmyer,32,22,2,2,1,20,12,1,2,9,10,1,0
6480bba1c67d2c9c1279a4c8,2014,,,1,CH Gayle,RR Rossouw,32,28,4,2,1,26,17,3,2,6,11,1,0
6480bb954da239b357833c8a,2018,,,2,KS Williamson,YK Pathan,32,16,2,2,0,4,4,0,0,27,12,2,2
6480bb9c3b082d71291a593c,2009,,,2,M Vijay,ML Hayden,32,21,4,1,1,5,9,0,0,26,12,4,1
6480bb941ab79050c3c90ee5,2018,,,1,CA Lynn,RV Uthappa,32,23,5,1,1,16,11,3,0,16,12,2,1
6480bb9b2a5f2fd5053534dc,2007/08,,,1,RV Uthappa,SR Tendulkar,32,23,3,0,1,7,10,0,0,19,13,3,0
6480bb943565d22d24ec0ae8,2017,,,1,DA Warner,KS Williamson,32,22,4,0,1,22,13,3,0,9,9,1,0
6480bba0ca27548122e36880,2013,,,1,MS Dhoni,SK Raina,32,21,3,0,1,9,9,1,0,21,12,2,0
6480bb9aa030c8ebcbcc19c9,2007/08,,,1,DJ Bravo,MA Khote,32,21,3,1,1,22,11,2,1,7,10,1,0
6480bb9be88c31fc563da86f,2009,,,2,DPMD Jayawardene,KC Sangakkara,32,27,3,0,1,19,15,2,0,11,12,1,0
6480bb9f2305d07e3c65be11,2013,,,2,AC Gilchrist,PC Valthaty,32,35,4,0,1,22,19,4,0,6,16,0,0
6480bb9e83b8575f74b8e962,2012,,,1,F du Plessis,SK Raina,32,22,3,1,1,9,8,0,0,23,14,3,1
6480bb9e8dfd9ba30b93cbd8,2012,,,1,CL White,PA Patel,32,25,4,0,1,17,14,2,0,15,11,2,0
6480bb947a7076697fc0b339,2017,,,1,DT Christian,SPD Smith,32,13,0,3,1,16,6,0,2,12,7,0,1
6480bb98436587de59527f2e,2022,,,2,Lalit Yadav,SN Thakur,32,22,5,0,1,10,11,1,0,22,11,4,0
6480bba265483f7db002ec7c,2015,,,1,GJ Bailey,M Vijay,32,26,3,0,1,22,16,3,0,8,10,0,0
6480bba1743abcb135a6a4c7,2015,,,1,M Vijay,WP Saha,32,17,3,1,1,23,13,2,1,7,4,1,0
6480bba210201df0f7975000,2016,,,2,KL Rahul,V Kohli,32,23,3,2,1,23,14,2,2,8,9,1,0
6480bba20130c44ed20c9bcf,2016,,,1,JC Buttler,PA Patel,32,32,3,1,1,16,21,3,0,12,11,0,1
6480bb9b8cc888fe3f01f2a4,2009,,,1,DPMD Jayawardene,Yuvraj Singh,32,29,2,0,1,14,13,1,0,14,16,1,0
6480bb9d40fc01528c7b7270,2009/10,,,1,AA Jhunjhunwala,SR Watson,32,42,3,0,1,12,19,1,0,18,23,2,0
6480bba0c9e6d590ed35eb56,2014,,,2,AP Tare,AT Rayudu,32,18,3,0,1,15,9,2,0,10,9,1,0
6480bb96e2809aa0bc35c7e9,2019,,,1,KA Pollard,Q de Kock,32,21,2,2,1,10,9,0,1,21,12,2,1
6480bba2c56d0ef7222ee3b8,2015,,,1,D Wiese,SN Khan,32,15,4,1,1,11,8,2,0,19,7,2,1
6480bb99ecbdaaf953b8eee5,2023,,,1,MM Ali,S Dube,32,21,1,3,1,6,8,0,0,26,13,1,3
6480bb9b4b74852492343291,2007/08,,,1,R Dravid,SP Goswami,32,29,4,1,1,9,11,1,0,23,18,3,1
6480bb9ba9d43057d652a5fe,2009,,,1,IK Pathan,KC Sangakkara,32,24,0,1,1,7,10,0,0,17,14,0,1
6480bb94aad1a08ca4276b4e,2018,,,1,KL Rahul,MA Agarwal,32,19,4,2,1,16,8,1,2,15,11,3,0
6480bb94b991069934e5c7d2,2018,,,2,N Rana,RV Uthappa,32,23,3,1,1,17,12,2,0,14,11,1,1
6480bb9d03ce4b87b32b91f5,2009/10,,,1,AC Gilchrist,MD Mishra,32,25,3,1,1,7,8,1,0,21,17,2,1
6480bb94ebff9a116f68560b,2018,,,2,S Dhawan,WP Saha,32,19,6,0,1,5,4,1,0,24,15,5,0
6480bb97aad3147696268239,2021,,,2,HH Pandya,KA Pollard,32,13,1,3,1,16,7,0,2,14,6,1,1
6480bba0b07a395235841955,2013,,,2,DR Smith,SR Tendulkar,32,28,3,1,1,14,16,1,1,14,12,2,0
6480bb96686655f09172741d,2020/21,,,2,MM Ali,V Kohli,32,37,1,0,1,11,13,1,0,19,24,0,0
6480bb9b46b4360184dc19f3,2007/08,,,1,RG Sharma,Y Venugopal Rao,32,25,1,2,1,23,14,1,2,6,11,0,0
6480bb96593f4f87a2c294bc,2020/21,,,2,JM Bairstow,PK Garg,32,20,4,0,1,18,10,3,0,10,10,1,0
6480bb9d66dc7da0d45e453c,2011,,,2,AC Gilchrist,PC Valthaty,32,27,4,1,1,24,19,3,1,7,8,1,0
6480bba1ff89cb428182daa6,2014,,,2,BB McCullum,RA Jadeja,32,20,5,0,1,14,12,2,0,17,8,3,0
6480bb9e28b7a946a6921fa6,2011,,,2,AN Ahmed,R Sathish,32,25,2,1,0,18,13,1,1,12,12,1,0
6480bba063bacaa2dfabf6fd,2014,,,2,KD Karthik,KP Pietersen,32,26,2,1,1,15,14,1,0,16,12,1,1
6480bb9b9d7aa6d8e47576d7,2007/08,,,2,M Kaif,YK Pathan,32,17,1,3,1,12,9,0,1,20,8,1,2
6480bb98bc3569cc8d04101a,2022,,,2,SW Billings,VR Iyer,32,23,1,3,1,17,12,0,2,13,11,1,1
6480bba358370ecde0231113,2016,,,2,KS Williamson,Yuvraj Singh,32,30,2,2,1,9,9,1,0,23,21,1,2
6480bb9d03ce4b87b32b91f5,2009/10,,,1,A Symonds,DR Smith,32,18,1,2,0,17,10,1,1,13,8,0,1
6480bb9a807eb5f39489408a,2023,,,1,DP Conway,RD Gaikwad,32,25,4,0,1,10,13,1,0,17,12,3,0
6480bb9dfa7d0510ae3a7b40,2011,,,1,JR Hopes,Y Nagar,32,20,1,2,1,8,9,0,0,23,11,1,2
6480bb994877788ec5b187ff,2023,,,2,KD Karthik,Shahbaz Ahmed,32,17,3,1,1,28,14,3,1,3,3,0,0
6480bb9f58a3e7ea877fc9dc,2012,,,2,DA Miller,SD Chitnis,32,18,3,1,0,25,13,3,1,6,5,0,0
6480bba0d2cdb40c68c4739c,2013,,,1,DJ Bravo,M Vijay,32,26,5,0,1,15,16,3,0,13,10,2,0
6480bba090c88df75eba18e6,2014,,,1,AM Nayar,SR Watson,32,38,2,2,1,8,14,1,0,24,24,1,2
6480bba0e52e9733fc6d9937,2013,,,1,DR Smith,KD Karthik,32,30,2,1,1,5,11,0,0,25,19,2,1
6480bb9c17dcdfd5b06984f0,2009/10,,,2,AB Agarkar,WP Saha,32,23,2,0,1,17,13,1,0,12,10,1,0
6480bb9e05381e16815803e9,2011,,,2,JD Ryder,MK Pandey,32,28,6,0,1,15,18,3,0,14,10,3,0
6480bb9a7577454a5220c94b,2007/08,,,1,AM Nayar,RV Uthappa,32,22,2,1,0,12,13,1,0,15,9,1,1
6480bb9ec07aa72ec89917f0,2012,,,1,NV Ojha,V Sehwag,32,22,5,1,1,14,12,3,0,18,10,2,1
6480bba2e8614b1263627c1b,2015,,,1,DJ Hooda,SPD Smith,32,21,4,0,1,7,9,0,0,25,12,4,0
6480bb991a4f7e5f59dd1afc,2023,,,2,RK Singh,SN Thakur,32,16,5,0,1,19,9,3,0,12,7,2,0
6480bb9b724406459cd357c9,2007/08,,,2,Misbah-ul-Haq,V Kohli,32,17,5,1,1,21,8,3,1,11,9,2,0
6480bb95b98d000799e11963,2018,,,1,AB de Villiers,V Kohli,32,23,6,0,1,25,14,5,0,7,9,1,0
6480bba1a6882d256a926a8b,2014,,,1,BCJ Cutting,JP Faulkner,32,13,0,4,1,7,5,0,1,23,8,0,3
6480bb94aad1a08ca4276b4e,2018,,,2,Q de Kock,V Kohli,32,27,6,0,1,10,11,2,0,21,16,4,0
6480bb96a467817b9b68ca94,2020/21,,,2,JM Bairstow,KS Williamson,32,35,2,0,1,11,16,0,0,21,19,2,0
6480bb960d9d6af315534958,2019,,,1,AJ Tye,SM Curran,32,11,5,1,0,0,2,0,0,31,9,5,1
6480bb98adf21699eaa67796,2022,,,1,KD Karthik,MK Lomror,32,18,3,1,1,9,9,1,0,21,9,2,1
6480bba031c5cf0145ae8cfe,2014,,,1,AM Nayar,SV Samson,32,20,4,1,1,14,10,2,0,16,10,2,1
6480bb9aded509be64de3bfb,2007/08,,,2,BB McCullum,SC Ganguly,32,16,3,2,1,24,12,2,2,7,4,1,0
6480bb967c50ceac62ba0719,2020/21,,,1,AT Carey,S Dhawan,32,21,2,0,0,14,9,0,0,18,12,2,0
6480bba28724848c0f3ef034,2015,,,1,KA Pollard,RG Sharma,32,31,5,0,1,9,17,1,0,22,14,4,0
6480bb932f8447acd7840076,2017,,,1,DA Warner,S Dhawan,32,19,1,3,1,23,10,1,2,9,9,0,1
6480bb950ced01a335bd7833,2019,,,1,MM Ali,MP Stoinis,32,16,4,1,0,18,9,2,1,13,7,2,0
6480bb9c54a72690027ba3d4,2009/10,,,1,ML Hayden,PA Patel,32,20,5,0,1,20,12,4,0,7,8,1,0
6480bb951354c40599b60208,2018,,,1,Shakib Al Hasan,YK Pathan,32,22,3,1,1,5,7,0,0,27,15,3,1
6480bb9482dff502bff80bcf,2017,,,1,KK Nair,RR Pant,32,21,4,1,1,23,14,3,1,8,7,1,0
6480bb9d362f72789dcdc5a7,2009/10,,,2,G Gambhir,KD Karthik,32,32,2,0,1,13,16,1,0,13,16,1,0
6480bb9cff4ec2f71cdf18d1,2009/10,,,2,IK Pathan,SE Marsh,32,27,3,0,1,18,14,1,0,14,13,2,0
6480bb9e05381e16815803e9,2011,,,2,CJ Ferguson,Yuvraj Singh,32,20,3,2,1,5,12,0,0,25,8,3,2
6480bba1af9481df8b4f9f0f,2015,,,1,AD Russell,YK Pathan,32,17,3,2,1,28,13,3,2,3,4,0,0
6480bb942fc9529eb2869c17,2018,,,2,DJ Bravo,MS Dhoni,32,11,1,3,0,14,7,1,1,15,4,0,2
6480bb956b439141409fd739,2018,,,1,AM Rahane,JC Buttler,32,19,5,0,1,5,7,0,0,22,12,5,0
6480bb96a467817b9b68ca94,2020/21,,,1,MS Dhoni,RA Jadeja,32,16,4,1,1,18,9,2,1,13,7,2,0
6480bb948a69b3d86293b12b,2017,,,1,AJ Finch,RA Jadeja,32,14,5,1,1,20,8,3,1,12,6,2,0
6480bb931ee18ac840f40603,2017,,,1,AR Patel,HM Amla,32,17,2,2,0,4,5,0,0,25,12,2,2
6480bb95d675b7da24db1a57,2019,,,2,PP Shaw,S Dhawan,32,18,1,4,1,14,7,0,2,18,11,1,2
6480bb9ea1e127d68e288e04,2011,,,2,BJ Hodge,RA Jadeja,32,25,1,1,1,12,12,0,0,19,13,1,1
6480bb945f95e767a8a9cc10,2017,,,1,BA Stokes,RA Tripathi,32,24,4,1,1,26,18,3,1,5,6,1,0
6480bba280f09c38002cf14b,2015,,,1,G Gambhir,MK Pandey,32,24,5,0,1,8,9,1,0,22,15,4,0
6480bba2fbc243afec641844,2015,,,2,MS Dhoni,SK Raina,32,20,3,2,0,25,16,2,2,7,4,1,0
6480bb953b102c650968cba2,2019,,,2,AT Rayudu,SK Raina,32,44,4,0,1,12,23,1,0,19,21,3,0
6480bb9894cc2d00f057a1f1,2021,,,1,PP Shaw,S Dhawan,32,25,2,3,1,18,12,2,1,14,13,0,2
6480bba2c04b3acd88a50839,2015,,,2,AD Mathews,SS Tiwary,32,21,2,2,1,16,10,1,1,15,11,1,1
6480bb96f1eadf803ffc292c,2020/21,,,1,AR Patel,HV Patel,32,13,3,1,1,17,8,2,1,8,5,1,0
6480bb98cce4ab46512c2c03,2022,,,2,DJ Hooda,E Lewis,32,16,3,2,1,13,8,1,1,16,8,2,1
6480bb9edb0554f003f5428a,2012,,,2,CH Gayle,V Kohli,32,26,4,1,1,13,7,1,1,18,19,3,0
6480bba0f858e6c12b25d8c3,2014,,,1,CA Lynn,RV Uthappa,31,36,3,0,1,13,13,2,0,14,23,1,0
6480bb99fe078839da40e7ab,2023,,,1,AD Russell,CV Varun,31,26,1,3,1,25,20,1,3,1,6,0,0
6480bb9c07d77f83fb139c41,2009,,,1,AC Gilchrist,HH Gibbs,31,23,4,1,1,20,16,3,1,9,7,1,0
6480bb9d105fba311a23a588,2011,,,1,BJ Hodge,DPMD Jayawardene,31,22,3,0,1,15,13,2,0,10,9,1,0
6480bb9d80536875f41bc605,2011,,,1,MK Pandey,Yuvraj Singh,31,25,2,2,1,11,9,1,0,20,16,1,2
6480bba10e78f50f124b406a,2015,,,1,D Wiese,MA Starc,31,22,3,1,1,18,16,2,1,9,6,1,0
6480bb9f5867d07199aa832a,2013,,,2,MK Pandey,SPD Smith,31,16,2,2,1,9,8,1,0,21,8,1,2
6480bb9bef0d1fffea8bfd11,2009,,,2,SM Katich,Yuvraj Singh,31,17,2,2,1,15,9,1,1,16,8,1,1
6480bba37e4fcb8af147f79b,2016,,,1,AM Rahane,UT Khawaja,31,22,5,0,1,9,9,1,0,19,13,4,0
6480bb9f7ff1377c4d13a645,2013,,,2,AM Nayar,MR Marsh,31,19,1,2,1,6,7,0,0,24,12,1,2
6480bb99f47261f111a6cc1a,2023,,,2,N Wadhera,SA Yadav,31,14,4,2,1,12,6,1,1,19,8,3,1
6480bba33dab752d79e587d2,2016,,,1,KS Williamson,S Dhawan,31,25,3,0,1,11,11,1,0,18,14,2,0
6480bba210201df0f7975000,2016,,,1,HH Pandya,KA Pollard,31,14,2,3,0,2,3,0,0,27,11,2,3
6480bba19052ba503c5f7c27,2015,,,1,A Ashish Reddy,RS Bopara,31,21,1,2,0,13,9,0,1,17,12,1,1
6480bba210201df0f7975000,2016,,,1,JC Buttler,KA Pollard,31,16,3,2,1,19,8,1,2,12,8,2,0
6480bb9edb0554f003f5428a,2012,,,2,CH Gayle,DL Vettori,31,15,2,3,1,27,11,2,3,4,4,0,0
6480bba16af3f513920ef499,2015,,,2,AD Russell,MK Pandey,31,18,3,2,1,19,10,1,2,12,8,2,0
6480bb9cff4ec2f71cdf18d1,2009/10,,,1,AT Rayudu,SS Tiwary,31,25,1,1,1,9,12,1,0,16,13,0,1
6480bb973da000031d26fbba,2021,,,2,HH Pandya,SS Tiwary,31,32,2,1,1,11,14,1,0,20,18,1,1
6480bb9c71030f4c6f018f55,2009,,,1,DB Ravi Teja,RG Sharma,31,30,2,2,1,10,15,1,0,21,15,1,2
6480bb9ddfb0f2f6f8e813e5,2011,,,2,V Sehwag,Y Venugopal Rao,31,28,4,0,1,25,18,4,0,1,10,0,0
6480bb996c5ae75a32d978e8,2022,,,2,MS Wade,WP Saha,31,25,2,0,1,20,15,2,0,6,10,0,0
6480bb9cb881721acc1bab60,2009,,,1,A Symonds,TL Suman,31,23,3,0,1,11,9,0,0,20,14,3,0
6480bb9af85f41b4de44ca19,2023,,,2,MD Shanaka,Shubman Gill,31,28,3,1,1,17,16,1,1,14,12,2,0
6480bb9a6935abf34d88ca97,2007/08,,,2,MEK Hussey,ML Hayden,31,22,5,1,1,14,12,3,0,16,10,2,1
6480bb9ca21b98f1be8254e2,2009/10,,,1,DA Warner,PD Collingwood,31,24,0,3,1,18,10,0,2,13,14,0,1
6480bb95833c06e6c5119173,2019,,,2,KD Karthik,N Rana,31,25,1,1,1,8,9,0,0,23,16,1,1
6480bb961ee814aee7b674ac,2020/21,,,1,MP Stoinis,R Ashwin,31,17,4,1,1,26,11,4,1,4,6,0,0
6480bb9c620c92d09ba1b6b9,2009,,,2,SA Asnodkar,YK Pathan,31,21,3,1,1,24,14,3,1,6,7,0,0
6480bb97fcc6fccd233157f9,2021,,,2,MK Lomror,SV Samson,31,36,1,1,1,19,24,0,1,11,12,1,0
6480bb9e41b781523bd5aafe,2012,,,1,LR Shukla,R Bhatia,31,23,1,2,1,25,16,1,2,6,7,0,0
6480bba0fbf5f1671e1e557e,2013,,,2,CA Pujara,V Kohli,31,23,4,0,1,16,12,3,0,12,11,1,0
6480bba3aa840e4e9450a200,2016,,,1,KK Nair,Q de Kock,31,26,2,2,1,11,10,0,1,19,16,2,1
6480bb997d1393ca85856ec2,2022,,,2,GJ Maxwell,V Kohli,31,13,1,3,1,19,8,1,2,8,5,0,1
6480bb94988cb8c136ec7e46,2018,,,1,CH Gayle,MA Agarwal,31,21,1,2,1,5,7,0,0,26,14,1,2
6480bb9f014bd6e0ac2b51a8,2013,,,2,KA Pollard,RG Sharma,31,16,1,3,1,9,6,1,0,21,10,0,3
6480bba0120becd670aec59d,2013,,,1,RV Uthappa,Yuvraj Singh,31,19,1,3,1,13,8,1,1,16,11,0,2
6480bb9d716a89dbf5e486d0,2011,,,1,AL Menaria,J Botha,31,20,1,3,1,22,15,0,3,9,5,1,0
6480bb9f4780a208e13bfb3d,2013,,,2,BJ Hodge,R Dravid,31,29,3,0,1,9,15,0,0,22,14,3,0
6480bba286cca051953c976a,2015,,,2,M Vijay,SE Marsh,31,26,4,1,1,21,16,3,1,10,10,1,0
6480bb9399a527d39bc17dad,2017,,,1,BB McCullum,RA Jadeja,31,22,2,2,1,17,9,0,2,14,13,2,0
6480bb9b17739118ee6c3bd0,2007/08,,,1,DJ Hussey,SC Ganguly,31,31,3,1,1,11,15,2,0,19,16,1,1
6480bb966c9efd5bf35d10b9,2019,,,1,N Rana,Shubman Gill,31,27,4,0,1,12,13,2,0,14,14,2,0
6480bb95385ebb9bda58a643,2019,,,2,AR Patel,CH Morris,31,19,1,2,1,20,10,1,1,11,9,0,1
6480bba0be153677ce53c58e,2014,,,2,CA Pujara,V Sehwag,31,18,6,0,1,12,8,2,0,19,10,4,0
6480bba179195d83fa7fbfbb,2014,,,1,SR Watson,SV Samson,31,17,2,2,1,20,10,1,2,10,7,1,0
6480bb97d5e3b0911408f222,2020/21,,,1,AJ Finch,D Padikkal,31,23,3,1,1,15,11,3,0,11,12,0,1
6480bb99b35dc0981e512451,2022,,,1,JC Buttler,YBK Jaiswal,31,24,2,2,1,8,8,1,0,22,16,1,2
6480bb931b06a170006b4713,2017,,,2,BB McCullum,SK Raina,31,17,3,1,1,24,10,3,1,5,7,0,0
6480bb9aab9770e7260312df,2007/08,,,2,G Gambhir,V Sehwag,31,21,5,0,1,12,9,2,0,19,12,3,0
6480bb938ed49c6d5c211429,2017,,,2,DJ Hooda,Yuvraj Singh,31,16,3,2,1,13,7,1,1,17,9,2,1
6480bb9e5de755887230bb00,2012,,,1,JD Ryder,RV Uthappa,31,18,3,1,1,20,11,3,0,10,7,0,1
6480bb98e87e6f83b61088ea,2022,,,1,JM Sharma,M Shahrukh Khan,31,25,0,3,1,25,16,0,3,4,9,0,0
6480bb9908b154f78b12b8fb,2023,,,2,F du Plessis,V Kohli,31,14,3,2,1,17,7,1,2,13,7,2,0
6480bb9a3ffea6235f54cc1e,2023,,,1,AD Russell,RK Singh,31,18,2,2,1,24,15,1,2,5,3,1,0
6480bb9b8cc888fe3f01f2a4,2009,,,2,BB McCullum,BJ Hodge,31,35,3,0,1,15,20,1,0,16,15,2,0
6480bb978c66ea3d9c85132d,2020/21,,,2,MK Pandey,PK Garg,31,21,3,1,1,21,13,3,0,9,8,0,1
6480bb9371e90dbd44ee19a3,2017,,,1,CH Morris,CJ Anderson,31,17,3,1,1,16,8,1,1,11,9,2,0
6480bb97e5be965d3c00760e,2021,,,1,D Padikkal,KS Bharat,31,28,4,0,1,18,14,3,0,11,14,1,0
6480bb9c5ec0713155cad138,2009/10,,,2,BJ Hodge,CA Pujara,31,24,3,1,1,13,8,1,1,10,16,2,0
6480bba1553f17c77d5f1ca2,2014,,,1,AJ Finch,S Dhawan,31,30,5,0,1,17,19,3,0,11,11,2,0
6480bb9b9d7aa6d8e47576d7,2007/08,,,1,JA Morkel,SK Raina,31,22,0,3,1,16,13,0,2,14,9,0,1
6480bb9809c62ba77e5df472,2021,,,2,N Rana,SP Narine,31,20,0,3,1,6,12,0,0,22,8,0,3
6480bb9525ace33768e8b671,2019,,,1,AT Rayudu,RA Jadeja,31,32,2,0,0,18,12,2,0,10,20,0,0
6480bb9f59fd8000010baf09,2013,,,2,DPMD Jayawardene,KM Jadhav,31,23,3,0,1,13,11,1,0,18,12,2,0
6480bb9541caaeddc9ddaac3,2019,,,1,MS Dhoni,RA Jadeja,31,9,0,4,0,21,6,0,3,8,3,0,1
6480bb9b4b74852492343291,2007/08,,,1,B Chipli,JH Kallis,31,29,2,1,1,2,10,0,0,21,19,2,1
6480bb9a596c087c0396ec2e,2007/08,,,2,LRPL Taylor,R Dravid,31,23,1,2,1,18,9,0,2,12,14,1,0
6480bb9d3c4dfa9f054aa47f,2011,,,1,G Gambhir,MS Bisla,31,40,1,0,1,17,18,1,0,9,22,0,0
6480bb9e2c96ab2b87d9466a,2011,,,1,AT Rayudu,KA Pollard,31,15,4,1,1,23,10,3,1,7,5,1,0
6480bb99864a94e086c8395e,2022,,,2,Ramandeep Singh,TH David,31,8,1,4,1,0,0,0,0,29,8,1,4
6480bb988b447f26d7a96c0c,2022,,,1,KL Rahul,MP Stoinis,31,17,1,3,1,21,8,1,2,10,9,0,1
6480bb954e496ec9b12aa120,2019,,,1,AM Rahane,JC Buttler,31,17,4,1,1,14,11,3,0,11,6,1,1
6480bba0c9e6d590ed35eb56,2014,,,2,AT Rayudu,CJ Anderson,31,31,2,0,1,12,13,0,0,18,18,2,0
6480bb937dc0a09df8f7aeee,2017,,,2,GJ Maxwell,HM Amla,31,24,4,1,1,24,12,3,1,7,12,1,0
6480bb96c40b697b63d08717,2019,,,1,MJ Guptill,WP Saha,31,19,1,3,1,23,10,0,3,8,9,1,0
6480bb9866dd8ba9b48863c2,2022,,,2,KH Pandya,KL Rahul,31,18,4,0,1,19,11,3,0,7,7,1,0
6480bb967c50ceac62ba0719,2020/21,,,2,Q de Kock,RG Sharma,31,30,2,1,1,25,18,2,1,5,12,0,0
6480bb9fa1611443840261b7,2012,,,1,JP Duminy,KC Sangakkara,31,41,2,0,1,21,25,2,0,9,16,0,0
6480bb99bb362e3714226928,2022,,,2,MP Stoinis,Mohsin Khan,31,14,2,2,1,20,9,1,2,8,5,1,0
6480bba0a3e806f41a4dab41,2013,,,2,CH Gayle,V Kohli,31,25,2,1,1,14,11,0,1,17,14,2,0
6480bb9dfb2e8e8c2002df86,2011,,,2,AG Paunikar,R Dravid,31,35,5,0,1,20,19,4,0,8,16,1,0
6480bb9765a785922ad360fe,2021,,,1,KS Williamson,MK Pandey,31,30,2,0,1,12,16,1,0,16,14,1,0
6480bba07b5396a7b65684d3,2013,,,1,KD Karthik,RG Sharma,31,22,1,2,1,15,11,0,1,16,11,1,1
6480bb9db9ed29ce1ee8764f,2011,,,2,AM Nayar,SE Marsh,31,14,1,3,1,3,4,0,0,27,10,1,3
6480bba08ffdd4393211d261,2014,,,1,AJ Finch,Y Venugopal Rao,31,27,1,0,1,13,12,1,0,13,15,0,0
6480bb9bc80883a975281815,2009,,,1,P Kumar,R Dravid,31,22,3,1,1,8,10,0,1,22,12,3,0
6480bb9b69f8ace7659e486d,2009,,,2,RA Jadeja,YK Pathan,31,21,4,0,1,11,8,1,0,20,13,3,0
6480bb96e61ac20a6e10582e,2019,,,2,HH Pandya,SA Yadav,31,27,3,0,0,13,11,1,0,18,16,2,0
6480bb993e44f97eccb361fe,2023,,,1,KL Rahul,MP Stoinis,31,20,0,3,1,14,9,0,1,15,11,0,2
6480bb9d4e112d675b2925df,2009/10,,,2,KD Karthik,V Sehwag,31,20,3,1,1,13,12,1,0,16,8,2,1
6480bba0e52e9733fc6d9937,2013,,,2,Azhar Mahmood,DA Miller,31,23,1,2,1,9,13,1,0,17,10,0,2
6480bba0e883438915efc1e6,2013,,,1,KW Richardson,SPD Smith,31,31,2,1,1,18,13,2,1,13,18,0,0
6480bba0a3e806f41a4dab41,2013,,,1,G Gambhir,JH Kallis,31,33,4,0,1,14,15,3,0,15,18,1,0
6480bb99b0fa4d217ed7f255,2023,,,2,HC Brook,MA Agarwal,31,31,5,0,1,7,14,0,0,24,17,5,0
6480bb9a6e44b0c8da00ca72,2007/08,,,1,DPMD Jayawardene,KC Sangakkara,31,17,4,1,1,12,7,0,1,19,10,4,0
6480bba0ca27548122e36880,2013,,,2,BB McCullum,MS Bisla,31,20,6,0,1,6,7,1,0,23,13,5,0
6480bb9a1e358307d26cd50d,2023,,,2,SA Yadav,Vishnu Vinod,31,19,2,2,1,25,13,2,2,5,6,0,0
6480bb95945c5e5dc4d8c7d6,2019,,,2,AB de Villiers,SO Hetmyer,31,15,3,2,1,24,9,3,2,5,6,0,0
6480bb97fcc6fccd233157f9,2021,,,1,Lalit Yadav,SO Hetmyer,31,19,5,0,1,4,7,0,0,25,12,5,0
6480bba2aecb4103bab63c15,2016,,,2,G Gambhir,SA Yadav,31,16,6,0,1,11,5,2,0,18,11,4,0
6480bba090c88df75eba18e6,2014,,,1,AM Rahane,KK Nair,31,27,4,0,1,23,19,4,0,7,8,0,0
6480bb9dc8b09381d0f01a9d,2011,,,2,NL McCullum,Yuvraj Singh,31,34,1,0,1,14,13,0,0,17,21,1,0
6480bb9740aaba2132c0eb0e,2021,,,1,AT Rayudu,RA Jadeja,31,22,3,1,1,14,7,1,1,17,15,2,0
6480bba0d3cbb27b257a9c1f,2013,,,1,DA Miller,SE Marsh,31,25,1,1,1,8,10,0,0,21,15,1,1
6480bb991a76403912eef285,2023,,,2,JC Buttler,SV Samson,31,14,4,2,1,6,3,0,1,25,11,4,1
6480bb9d66dc7da0d45e453c,2011,,,2,Bipul Sharma,KD Karthik,31,28,2,0,1,16,12,1,0,15,16,1,0
6480bb9cd6fe6fad0d6efbd9,2009/10,,,1,GC Smith,NV Ojha,31,21,5,1,1,7,7,1,0,24,14,4,1
6480bb9c963968000dfd00d1,2009/10,,,1,PA Patel,SK Raina,31,23,0,2,1,14,12,0,1,15,11,0,1
6480bb9c7a11e1cbeea46b0e,2009/10,,,1,AP Tare,SR Tendulkar,31,16,4,1,1,23,12,3,1,5,4,1,0
6480bb9af85f41b4de44ca19,2023,,,1,AM Rahane,DP Conway,31,20,1,1,1,17,10,0,1,13,10,1,0
6480bb9a21e416835389fd53,2023,,,2,Atharva Taide,P Simran Singh,31,25,2,1,1,9,12,0,0,22,13,2,1
6480bb98dd9a2108c79e1014,2022,,,1,JM Sharma,M Shahrukh Khan,31,33,4,0,1,24,19,4,0,7,14,0,0
6480bba1f5d65d6146678a7f,2015,,,2,G Gambhir,RV Uthappa,31,25,4,0,1,13,12,2,0,13,13,2,0
6480bba2d313234709068efb,2015,,,1,AT Rayudu,LMP Simmons,31,11,2,3,1,14,4,0,2,16,7,2,1
6480bb9db6a011b38afed5dc,2011,,,1,GC Smith,JD Ryder,31,22,4,0,1,10,12,1,0,17,10,3,0
6480bb97aabcd4374e076d04,2021,,,2,AT Rayudu,MS Dhoni,31,23,2,2,0,16,12,1,1,14,11,1,1
6480bb9c13fa57328b17e4e2,2009/10,,,1,M Manhas,R Bhatia,31,18,2,2,1,9,9,1,0,21,9,1,2
6480bb9c9f9d5376b4227724,2009/10,,,1,CA Pujara,SC Ganguly,31,22,4,0,1,17,13,3,0,8,9,1,0
6480bb9e19dd5297ba8ca5f7,2011,,,1,JD Ryder,MK Pandey,31,24,3,1,1,18,14,1,1,13,10,2,0
6480bb9448fe25ec89c5fcff,2017,,,1,KA Pollard,KV Sharma,31,10,4,2,1,12,4,1,1,19,6,3,1
6480bb9de80788b3c3ebe4e1,2009/10,,,2,R Sathish,SR Tendulkar,31,12,3,2,0,1,2,0,0,30,10,3,2
6480bb964c4bea88164f168d,2020/21,,,2,AS Rajpoot,TK Curran,31,12,1,4,0,7,5,0,1,24,7,1,3
6480bb94605dacb25c83dc35,2018,,,1,DA Miller,KK Nair,31,21,1,1,1,18,13,0,1,10,8,1,0
6480bb9d716a89dbf5e486d0,2011,,,1,J Botha,LRPL Taylor,31,20,2,1,0,13,10,1,0,18,10,1,1
6480bba10e78f50f124b406a,2015,,,1,MS Bisla,RR Rossouw,31,21,4,1,1,17,14,3,0,13,7,1,1
6480bb98a95cb1650c81c926,2022,,,1,DJ Mitchell,R Parag,31,29,1,1,1,9,13,0,0,21,16,1,1
6480bb979e8cc2484c1a8c7b,2020/21,,,2,BA Stokes,SPD Smith,31,17,5,1,1,20,9,4,0,11,8,1,1
6480bba3d3dc891a3092643e,2016,,,1,SS Tiwary,UT Khawaja,31,26,2,1,1,17,15,1,1,12,11,1,0
6480bb9c89e2e8ecb04f94cb,2009/10,,,1,A Symonds,RG Sharma,31,24,4,1,1,21,11,3,1,10,13,1,0
6480bb9e8dfd9ba30b93cbd8,2012,,,2,RA Jadeja,S Badrinath,31,25,3,0,1,8,12,0,0,20,13,3,0
6480bb94dcc956fa4ca06b92,2018,,,2,CA Lynn,N Rana,31,24,3,0,1,14,14,1,0,15,10,2,0
6480bb9c1e676472f4841aa9,2009/10,,,1,MK Pandey,R Dravid,31,20,4,0,1,10,9,1,0,14,11,3,0
6480bb9fc3369c6f5a549d05,2013,,,1,BMAJ Mendis,KM Jadhav,31,31,2,0,1,12,17,0,0,19,14,2,0
6480bba0ad06ad631cf7665f,2014,,,1,F du Plessis,SK Raina,31,22,4,0,1,10,9,1,0,21,13,3,0
6480bba09d1874eb9ded0204,2013,,,2,BJ Rohrer,DPMD Jayawardene,31,27,3,1,1,15,13,2,0,16,14,1,1
6480bb958f77e7d3929d28e3,2018,,,2,Harbhajan Singh,SK Raina,31,34,2,1,1,19,22,2,1,8,12,0,0
6480bb9ae4498012aa089436,2023,,,1,DP Conway,RD Gaikwad,31,21,4,0,1,14,8,2,0,17,13,2,0
6480bba0ddcc30675d83403c,2013,,,1,DJ Bravo,MS Dhoni,31,25,2,2,1,7,16,0,0,23,9,2,2
6480bb987c720def5fbaf218,2022,,,2,Ishan Kishan,RG Sharma,31,22,3,2,1,3,5,0,0,28,17,3,2
6480bb9cc5312f3d7cfb650e,2009/10,,,1,IK Pathan,RS Bopara,31,13,3,1,1,16,5,2,1,13,8,1,0
6480bb982f070b023b901b3e,2021,,,1,SA Yadav,SS Tiwary,31,25,2,1,1,23,16,2,1,8,9,0,0
6480bb942efd740a6ffc47df,2017,,,2,Mandeep Singh,V Kohli,31,22,3,1,1,17,13,3,0,13,9,0,1
6480bb97aed297ca9686c94a,2021,,,1,JA Richardson,M Shahrukh Khan,31,35,3,1,1,15,22,2,0,15,13,1,1
6480bb9f0f1f6c03d8e2f039,2013,,,2,A Mishra,BB Samantray,31,26,2,1,1,11,10,1,0,20,16,1,1
6480bba1ff55936e203ca5a6,2014,,,1,V Sehwag,WP Saha,31,22,5,0,1,14,13,2,0,15,9,3,0
6480bb9c757dbd7f92b1130a,2009/10,,,1,RG Sharma,TL Suman,31,28,0,2,1,14,11,0,1,15,17,0,1
6480bb9ca181f55cb21526f5,2009/10,,,2,JH Kallis,RV Uthappa,31,28,2,1,1,8,13,0,0,23,15,2,1
6480bb9e6d7f7f691dde322d,2012,,,1,RG Sharma,SR Tendulkar,31,34,3,0,1,13,20,2,0,14,14,1,0
6480bba2c56d0ef7222ee3b8,2015,,,1,AB de Villiers,KD Karthik,31,17,2,2,1,11,6,0,1,18,11,2,1
6480bb94adb227976b33d30b,2018,,,2,KD Karthik,Shubman Gill,31,26,1,2,1,12,11,0,1,19,15,1,1
6480bb9341152e168005ccc9,2017,,,2,JD Unadkat,MK Tiwary,31,16,3,2,1,2,5,0,0,27,11,3,2
6480bb9dbefe5e2cceb23e01,2011,,,2,M Vijay,MEK Hussey,31,22,4,1,1,12,9,1,1,15,13,3,0
6480bb9bc8bcea920f081be8,2009,,,2,G Gambhir,TM Dilshan,31,24,2,1,1,13,14,1,0,18,10,1,1
6480bb9b9dd7fe8c5cbdbab0,2009,,,1,A Flintoff,SK Raina,31,22,3,1,1,7,10,0,0,23,12,3,1
6480bb9c9f9d5376b4227724,2009/10,,,2,AC Gilchrist,HH Gibbs,31,16,5,1,1,9,5,2,0,20,11,3,1
6480bb9dd89d4266d59a4592,2011,,,1,AB de Villiers,SS Tiwary,31,17,4,1,1,18,8,2,1,13,9,2,0
6480bba280f09c38002cf14b,2015,,,1,G Gambhir,RV Uthappa,31,21,6,0,1,14,10,3,0,17,11,3,0
6480bba3aa840e4e9450a200,2016,,,1,CH Morris,J Yadav,31,23,3,0,1,25,16,3,0,5,7,0,0
6480bba11c977a5d11c1aa38,2015,,,1,NV Ojha,RS Bopara,31,20,2,2,1,12,10,1,0,19,10,1,2
6480bb9f6b144f2a6d105b32,2013,,,1,MS Dhoni,RA Jadeja,31,19,4,1,1,15,8,3,0,16,11,1,1
6480bba1ebb63d1bd8c60b9d,2014,,,2,KD Karthik,KP Pietersen,31,18,6,0,1,13,7,3,0,17,11,3,0
6480bb9bdde9db92f880e40d,2007/08,,,2,DPMD Jayawardene,Yuvraj Singh,31,20,4,0,1,10,6,1,0,20,14,3,0
6480bb9ea49fe0f895bf242a,2012,,,1,RE Levi,RG Sharma,31,20,4,1,1,10,7,2,0,21,13,2,1
6480bb9c8c6c106c6ffbeae4,2009/10,,,1,EJG Morgan,V Kohli,30,17,3,0,1,15,9,2,0,10,8,1,0
6480bba3fc9599eca1b87a77,2016,,,2,AJ Finch,PV Tambe,30,37,2,1,1,18,18,1,1,7,19,1,0
6480bb98825d8ceb716e3f3c,2022,,,2,AK Markram,KS Williamson,30,23,1,2,1,17,10,0,2,13,13,1,0
6480bb9ea75f51e7a33e90ed,2012,,,2,DA Miller,Mandeep Singh,30,23,3,0,1,19,15,2,0,11,8,1,0
6480bb991a76403912eef285,2023,,,2,D Padikkal,R Parag,30,19,2,2,1,10,7,1,0,20,12,1,2
6480bb958e752648ab95362b,2019,,,2,F du Plessis,KM Jadhav,30,17,3,0,0,16,9,2,0,8,8,1,0
6480bb979e8cc2484c1a8c7b,2020/21,,,1,HH Pandya,KH Pandya,30,11,2,3,0,27,7,2,3,3,4,0,0
6480bb965aa0867bce4e79b3,2019,,,1,F du Plessis,SR Watson,30,25,4,0,1,21,14,3,0,7,11,1,0
6480bb9fa1611443840261b7,2012,,,2,CH Gayle,TM Dilshan,30,17,3,2,1,27,10,3,2,3,7,0,0
6480bb9d79d603cc45fc9b3c,2011,,,2,AM Nayar,SE Marsh,30,16,5,0,1,14,9,2,0,15,7,3,0
6480bb98436587de59527f2e,2022,,,2,PP Shaw,TL Seifert,30,21,4,1,1,7,7,0,1,21,14,4,0
6480bb9c07d77f83fb139c41,2009,,,2,DPMD Jayawardene,IK Pathan,30,26,1,1,1,16,14,0,1,10,12,1,0
6480bba15b304732a6212cdf,2015,,,2,DA Warner,S Dhawan,30,22,5,0,1,4,4,0,0,26,18,5,0
6480bb9ec0a4e3f137edb047,2011,,,1,CH Gayle,MA Agarwal,30,21,3,1,1,8,9,0,1,17,12,3,0
6480bb998454ba791a8fdbf8,2023,,,2,C Green,TH David,30,19,1,2,0,17,8,1,1,13,11,0,1
6480bb95fa6394e733c532a9,2018,,,2,KD Karthik,RV Uthappa,30,20,1,2,1,15,12,0,1,14,8,1,1
6480bb95385ebb9bda58a643,2019,,,1,KH Pandya,SA Yadav,30,32,2,0,1,9,12,0,0,21,20,2,0
6480bba28724848c0f3ef034,2015,,,2,Shakib Al Hasan,YK Pathan,30,20,3,0,1,23,15,3,0,5,5,0,0
6480bb96f8379d02d3435ceb,2020/21,,,2,F du Plessis,SR Watson,30,22,5,0,1,17,10,3,0,12,12,2,0
6480bb95430629e254bbc4fd,2018,,,1,HH Pandya,JP Duminy,30,19,2,1,0,13,8,2,0,13,11,0,1
6480bb9a596c087c0396ec2e,2007/08,,,2,JH Kallis,V Kohli,30,21,3,1,1,6,7,0,0,23,14,3,1
6480bb9737b1d7284b5297c1,2021,,,1,HH Pandya,Ishan Kishan,30,19,3,1,1,13,10,2,0,17,9,1,1
6480bb9d66dc7da0d45e453c,2011,,,1,EJG Morgan,G Gambhir,30,19,5,0,1,24,12,5,0,6,7,0,0
6480bba0c63a6317296391b7,2013,,,2,SR Watson,STR Binny,30,21,0,2,1,17,12,0,2,7,9,0,0
6480bb9ee4565d108b29626f,2012,,,1,MS Dhoni,RA Jadeja,30,30,1,0,1,19,17,1,0,9,13,0,0
6480bb95014388d3e8c62904,2019,,,1,AD Nath,V Kohli,30,16,3,2,1,15,10,3,0,15,6,0,2
6480bb9ca21b98f1be8254e2,2009/10,,,2,JH Kallis,LRPL Taylor,30,15,1,3,1,8,5,1,0,22,10,0,3
6480bb980ea7c3bcea4fdf9c,2022,,,2,JM Bairstow,LS Livingstone,30,26,1,2,1,8,10,1,0,18,16,0,2
6480bb969d80bbba2884b855,2020/21,,,1,Gurkeerat Singh,Washington Sundar,30,33,2,0,1,8,15,0,0,21,18,2,0
6480bb9fc9e4047271240a59,2012,,,2,MS Dhoni,SK Raina,30,17,2,1,1,14,9,2,0,15,8,0,1
6480bba2965d1d15aa6f723e,2016,,,2,DJ Bravo,JP Faulkner,30,19,2,0,0,7,6,0,0,22,13,2,0
6480bb9e6d7f7f691dde322d,2012,,,1,JEC Franklin,RG Sharma,30,33,2,0,1,10,15,0,0,18,18,2,0
6480bb99efa58b95852be382,2023,,,1,RD Gaikwad,S Dube,30,26,0,1,1,16,13,0,1,9,13,0,0
6480bb976caaa0cc91f652c7,2021,,,1,KA Pollard,KH Pandya,30,19,1,2,1,15,11,1,1,12,8,0,1
6480bb9fc524f8142f0b3461,2012,,,1,MJ Clarke,SC Ganguly,30,34,2,0,1,11,16,1,0,14,18,1,0
6480bb9f777b7b1e89543a6e,2013,,,2,AT Rayudu,KD Karthik,30,29,2,0,1,17,18,1,0,12,11,1,0
6480bba1d9f266a28a109f29,2015,,,2,JP Duminy,MA Agarwal,30,27,3,0,1,21,19,3,0,7,8,0,0
6480bba273adb498d96b27a9,2016,,,1,KK Nair,SV Samson,30,25,4,0,1,15,11,2,0,14,14,2,0
6480bba00be5cdbaf6648462,2013,,,1,MC Henriques,V Kohli,30,11,4,2,0,12,3,3,0,17,8,1,2
6480bb9e5ab10d1241d6509d,2012,,,1,CH Gayle,V Kohli,30,35,2,0,1,12,16,1,0,16,19,1,0
6480bb98634dba60191637ad,2021,,,1,AK Markram,CH Gayle,30,35,2,0,1,15,20,1,0,13,15,1,0
6480bba0f858e6c12b25d8c3,2014,,,2,GJ Maxwell,V Sehwag,30,21,2,1,1,15,12,2,0,12,9,0,1
6480bb9c12f907c7b81b11a9,2009,,,2,RA Jadeja,SK Warne,30,36,2,0,1,13,15,1,0,15,21,1,0
6480bb93575636076d81e4c5,2017,,,1,DA Warner,DJ Hooda,30,19,3,0,1,17,9,2,0,12,10,1,0
6480bb9ca181f55cb21526f5,2009/10,,,1,AP Tare,SR Tendulkar,30,18,5,0,1,9,10,2,0,13,8,3,0
6480bba2b99fcf06aaeac805,2015,,,2,AM Rahane,SR Watson,30,19,2,1,1,16,12,2,0,10,7,0,1
6480bba3041017fe2c0593f2,2016,,,1,DJ Bravo,ER Dwivedi,30,12,2,2,1,6,3,1,0,19,9,1,2
6480bba0c1c8569f19cc70f0,2013,,,1,AM Rahane,SR Watson,30,18,3,1,1,25,13,2,1,5,5,1,0
6480bb95d675b7da24db1a57,2019,,,1,N Rana,Shubman Gill,30,24,0,2,1,11,12,0,1,17,12,0,1
6480bb932d6ccb8870dcd72d,2017,,,2,DT Christian,MK Tiwary,30,14,3,2,1,17,8,2,1,13,6,1,1
6480bb984f6c41cd28aa0353,2022,,,1,A Badoni,KL Rahul,30,18,3,1,1,11,7,2,0,19,11,1,1
6480bb985efffbcafdef9f19,2021,,,1,MK Lomror,R Parag,30,13,2,2,1,26,8,2,2,4,5,0,0
6480bb952f20835ddd6e533f,2019,,,2,JC Buttler,SV Samson,30,28,2,0,1,18,14,2,0,12,14,0,0
6480bb933fdc96ee7273400e,2017,,,2,AT Rayudu,N Rana,30,26,1,1,1,10,12,0,0,18,14,1,1
6480bb961ee814aee7b674ac,2020/21,,,2,KL Rahul,MA Agarwal,30,28,2,1,1,21,19,2,1,2,9,0,0
6480bb9f59fd8000010baf09,2013,,,2,DPMD Jayawardene,MC Juneja,30,30,3,0,1,11,16,1,0,17,14,2,0
6480bb9c7b7d7712bdc663de,2009/10,,,2,AC Gilchrist,HH Gibbs,30,25,3,1,1,13,10,0,1,17,15,3,0
6480bb9f60d58ee39ba047b9,2013,,,1,IK Pathan,KM Jadhav,30,25,1,1,1,9,13,0,0,18,12,1,1
6480bb98b00f767943bb8415,2022,,,2,Lalit Yadav,SN Thakur,30,15,2,2,1,20,8,2,1,10,7,0,1
6480bb97f56e9d700b27a098,2021,,,1,GJ Maxwell,RM Patidar,30,26,1,2,1,25,20,1,2,5,6,0,0
6480bb9538916411f52016bf,2019,,,2,JM Bairstow,KS Williamson,30,16,1,2,0,21,7,1,2,8,9,0,0
6480bb9a2b33e06f46eed54f,2023,,,1,AD Russell,VR Iyer,30,19,2,2,1,10,10,0,1,19,9,2,1
6480bb96fed7a7ee65076e4a,2020/21,,,1,BA Stokes,RV Uthappa,30,21,4,1,1,11,8,2,0,19,13,2,1
6480bb947a7c9fe868fc901a,2017,,,2,CH Gayle,Vishnu Vinod,30,29,2,2,1,26,20,2,2,3,9,0,0
6480bb9faf20f0bc714af2ea,2013,,,1,EJG Morgan,YK Pathan,30,26,0,1,0,8,10,0,0,18,16,0,1
6480bb9b2e179d359c1d446d,2009,,,2,G Gambhir,V Sehwag,30,21,5,0,1,9,10,1,0,20,11,4,0
6480bba2256bfaaf14c57ead,2015,,,1,SPD Smith,SR Watson,30,23,2,1,1,14,11,2,0,14,12,0,1
6480bba1743abcb135a6a4c7,2015,,,1,AR Patel,GJ Bailey,30,26,3,0,1,11,12,1,0,16,14,2,0
6480bba11a59d64bb4aa66f4,2014,,,1,M Vohra,SE Marsh,30,25,4,1,1,21,14,2,1,9,11,2,0
6480bb9db0ecec8acdd30619,2011,,,2,RV Uthappa,Yuvraj Singh,30,17,2,2,1,5,4,1,0,24,13,1,2
6480bb9774a44376e3b5eb6f,2021,,,1,N Rana,VR Iyer,30,19,3,1,1,9,6,1,0,20,13,2,1
6480bb97aed297ca9686c94a,2021,,,1,M Ashwin,M Shahrukh Khan,30,28,2,1,1,6,14,0,0,24,14,2,1
6480bb94b882fb725e3f98e5,2018,,,1,CH Gayle,MA Agarwal,30,15,2,2,1,10,6,0,1,18,9,2,1
6480bb975ea60ce128803d60,2021,,,2,KL Nagarkoti,PJ Cummins,30,8,1,4,1,0,2,0,0,30,6,1,4
6480bb95b1f28cf5bcf5e167,2018,,,2,DL Chahar,F du Plessis,30,15,2,2,1,10,6,0,1,20,9,2,1
6480bb9eee740f701b0ee154,2011,,,2,DA Warner,NV Ojha,30,17,3,2,1,4,3,0,0,25,14,3,2
6480bb9e05571c1a4c163ef1,2012,,,1,DJ Bravo,MS Dhoni,30,21,2,0,0,16,10,1,0,14,11,1,0
6480bba1b85900d7d83de308,2014,,,2,GJ Maxwell,M Vohra,30,12,0,4,1,18,7,0,3,11,5,0,1
6480bb97f56e9d700b27a098,2021,,,1,D Padikkal,V Kohli,30,24,5,0,1,17,13,3,0,12,11,2,0
6480bb9edd901481f13ce9ba,2012,,,1,DJ Hussey,SE Marsh,30,19,3,1,1,11,8,1,0,19,11,2,1
6480bba0c63a6317296391b7,2013,,,1,KA Pollard,RG Sharma,30,19,3,1,1,15,11,1,1,13,8,2,0
6480bba2b99fcf06aaeac805,2015,,,1,LMP Simmons,UBT Chand,30,26,2,1,1,21,16,2,1,8,10,0,0
6480bba19701e99975ce7c59,2015,,,1,SPD Smith,STR Binny,30,27,3,0,1,10,10,1,0,19,17,2,0
6480bb9f2305d07e3c65be11,2013,,,1,A Ashish Reddy,NLTC Perera,30,16,1,3,0,7,7,1,0,22,9,0,3
6480bb994aafcf67cd092a7d,2023,,,1,DA Warner,SN Khan,30,24,4,0,1,21,15,4,0,4,9,0,0
6480bb9f36da1a646c80be45,2013,,,1,KA Pollard,RG Sharma,30,17,3,1,1,13,7,1,1,15,10,2,0
6480bba1d3b4ddc36050e3f3,2014,,,1,GJ Bailey,R Dhawan,30,24,1,2,1,16,9,1,1,14,15,0,1
6480bb9c2778066dafd78a71,2009/10,,,2,RG Sharma,TL Suman,30,13,4,1,0,18,8,2,1,10,5,2,0
6480bb94988cb8c136ec7e46,2018,,,2,DJ Bravo,MS Dhoni,30,10,2,3,0,1,1,0,0,28,9,2,3
6480bb98b00f767943bb8415,2022,,,2,Lalit Yadav,R Powell,30,18,1,3,1,12,9,1,1,16,9,0,2
6480bb9fc3369c6f5a549d05,2013,,,2,M Vijay,MEK Hussey,30,27,4,0,1,18,13,3,0,11,14,1,0
6480bb9f231505ffc493730f,2012,,,1,F du Plessis,MS Dhoni,30,22,1,0,1,12,12,0,0,15,10,1,0
6480bb966c197bad273f91f1,2020/21,,,2,JC Buttler,MK Lomror,30,32,3,0,1,18,19,2,0,11,13,1,0
6480bb96c10dfe3d8c259db3,2020/21,,,1,AB de Villiers,D Padikkal,30,19,1,1,1,18,12,0,1,10,7,1,0
6480bb9fa3a890f94f179477,2013,,,1,DJ Hussey,M Vohra,30,25,5,0,1,15,15,2,0,15,10,3,0
6480bb9f90a251567178de39,2012,,,1,Azhar Mahmood,Mandeep Singh,30,16,3,1,1,11,7,0,1,18,9,3,0
6480bba065b341458c934986,2013,,,2,R Bhatia,S Narwal,30,18,4,0,1,6,3,0,0,23,15,4,0
6480bb99c6aa5989a16174d1,2023,,,2,Dhruv Jurel,SO Hetmyer,30,15,2,1,1,20,10,2,1,2,5,0,0
6480bb9737b1d7284b5297c1,2021,,,2,AB de Villiers,KA Jamieson,30,14,3,1,1,26,10,3,1,4,4,0,0
6480bb9e502d7987de08e5d5,2012,,,1,RV Uthappa,SC Ganguly,30,27,3,1,1,17,13,1,1,11,14,2,0
6480bb9df57ec21d17310ad2,2011,,,1,MK Tiwary,YK Pathan,30,19,5,0,1,7,4,1,0,22,15,4,0
6480bb9c21492b9a562c6f46,2009/10,,,1,AA Jhunjhunwala,NV Ojha,30,20,5,0,1,9,8,1,0,19,12,4,0
6480bb9a81d7fd0ac0307b4d,2023,,,1,Ishan Kishan,RG Sharma,30,20,4,1,1,15,10,3,0,11,10,1,1
6480bb9a2b33e06f46eed54f,2023,,,2,JC Buttler,YBK Jaiswal,30,10,3,2,1,0,3,0,0,27,7,3,2
6480bb948f3284f793b2763c,2018,,,2,Mohammed Siraj,V Kohli,30,13,1,3,0,8,3,0,1,21,10,1,2
6480bb9db38208342bc57b96,2011,,,1,EJG Morgan,YK Pathan,30,14,3,1,1,4,4,0,0,25,10,3,1
6480bb973d64aa91e60b4088,2021,,,2,JC Buttler,M Vohra,30,23,3,1,1,15,12,2,0,14,11,1,1
6480bb9f59fd8000010baf09,2013,,,2,IK Pathan,KM Jadhav,30,12,2,2,0,19,8,2,1,11,4,0,1
6480bb9932735ca83d38f6e7,2022,,,2,Abhishek Sharma,KS Williamson,30,32,4,0,1,21,15,3,0,9,17,1,0
6480bb948f3284f793b2763c,2018,,,1,KA Pollard,RG Sharma,30,16,1,2,1,5,7,0,0,23,9,1,2
6480bb9db6a011b38afed5dc,2011,,,2,RV Gomez,S Sreesanth,30,17,3,0,1,23,11,3,0,1,6,0,0
6480bb9a07d46704efe103ef,2007/08,,,2,B Akhil,CL White,30,10,2,3,0,27,7,2,3,3,3,0,0
6480bb9ae4498012aa089436,2023,,,1,AM Rahane,DP Conway,30,27,2,1,1,16,11,1,1,14,16,1,0
6480bb9575ad32214d0f6ec0,2019,,,2,AM Rahane,RA Tripathi,30,26,2,0,1,18,13,1,0,11,13,1,0
6480bb94f1c027945eeb8b10,2017,,,2,KA Pollard,RG Sharma,30,23,1,1,1,4,7,0,0,22,16,1,1
6480bb995193664eda3e9e10,2022,,,2,Ishan Kishan,Tilak Varma,30,24,4,0,1,20,19,3,0,6,5,1,0
6480bb993e61058e682e2ff4,2023,,,1,DA Miller,Shubman Gill,30,29,0,1,1,20,17,0,1,9,12,0,0
6480bb9a365c63af4b3de24c,2023,,,2,Aman Hakim Khan,P Dubey,30,33,3,1,1,15,15,1,1,15,18,2,0
6480bb96c3293977af83acbf,2019,,,1,IS Sodhi,R Parag,30,24,2,0,1,6,11,0,0,17,13,2,0
6480bb9bfcaabf33b5687e32,2007/08,,,1,M Kaif,SR Watson,30,26,2,0,1,12,15,0,0,12,11,2,0
6480bba11c977a5d11c1aa38,2015,,,1,A Ashish Reddy,KV Sharma,30,14,1,3,1,14,7,1,1,16,7,0,2
6480bb9eb2690fb1ed356b42,2011,,,2,A Mishra,S Dhawan,30,10,4,1,0,18,6,4,0,9,4,0,1
6480bb96f1eadf803ffc292c,2020/21,,,1,PP Shaw,SS Iyer,30,18,4,1,1,12,5,1,1,16,13,3,0
6480bb9b50f9e801edc13d5a,2007/08,,,2,RV Uthappa,SR Tendulkar,30,27,4,1,0,19,16,2,1,10,11,2,0
6480bb9e05381e16815803e9,2011,,,1,KD Karthik,SE Marsh,30,30,3,0,1,20,18,2,0,10,12,1,0
6480bb9bcc2f6123673672d0,2007/08,,,1,G Gambhir,S Dhawan,30,21,3,2,1,17,7,2,1,13,14,1,1
6480bb9d91920239b62f48ad,2009/10,,,1,JH Kallis,MK Pandey,30,29,2,1,1,14,11,0,1,16,18,2,0
6480bb954da239b357833c8a,2018,,,1,RR Pant,SS Iyer,30,30,1,1,1,13,16,0,0,17,14,1,1
6480bb993e44f97eccb361fe,2023,,,2,Harpreet Singh,Sikandar Raza,30,30,2,0,1,17,15,2,0,13,15,0,0
6480bb97f2f0fabec8f94d86,2020/21,,,1,EJG Morgan,KD Karthik,30,13,5,0,1,10,5,2,0,20,8,3,0
6480bb987c720def5fbaf218,2022,,,1,JM Bairstow,S Dhawan,30,26,3,0,1,12,13,1,0,17,13,2,0
6480bba069c0322e91e50958,2013,,,2,JH Kallis,YK Pathan,30,27,3,0,1,6,9,0,0,23,18,3,0
6480bb9822eeb0c1c117f221,2021,,,2,MM Ali,RD Gaikwad,30,21,4,0,1,11,9,1,0,19,12,3,0
6480bb96d1b3bea0aa2127e4,2020/21,,,1,HH Pandya,RG Sharma,30,16,3,1,1,16,10,2,1,9,6,1,0
6480bb96f1eadf803ffc292c,2020/21,,,1,MP Stoinis,SO Hetmyer,30,25,0,2,1,15,14,0,1,14,11,0,1
6480bba0c63a6317296391b7,2013,,,2,DH Yagnik,STR Binny,30,22,3,1,1,10,14,1,0,19,8,2,1
6480bb9c13817091131f76e3,2009/10,,,1,A Symonds,TL Suman,30,30,2,1,1,9,13,0,0,21,17,2,1
6480bb95960e393c939ab44c,2018,,,1,GJ Maxwell,PP Shaw,30,19,5,0,1,16,11,3,0,12,8,2,0
6480bba0a3e806f41a4dab41,2013,,,1,JH Kallis,YK Pathan,30,28,2,1,1,11,12,1,0,18,16,1,1
6480bb9b0e32875998e9bfdc,2009,,,1,DL Vettori,M Manhas,30,19,3,1,1,12,7,2,0,16,12,1,1
6480bb938ed49c6d5c211429,2017,,,1,G Gambhir,RV Uthappa,30,20,3,1,1,12,11,2,0,16,9,1,1
6480bba26bb69626041c4ba1,2015,,,1,Mandeep Singh,V Kohli,30,16,2,2,1,21,11,2,1,9,5,0,1
6480bb9df60a79ae5f20b748,2011,,,2,AT Rayudu,SR Tendulkar,30,29,2,0,1,14,15,2,0,11,14,0,0
6480bba24f6e6e2c212c7469,2016,,,1,G Gambhir,MK Pandey,30,27,5,0,0,14,15,2,0,15,12,3,0
6480bba3aa840e4e9450a200,2016,,,1,Q de Kock,SV Samson,29,24,2,1,1,12,12,1,0,17,12,1,1
6480bb982f070b023b901b3e,2021,,,1,Q de Kock,SA Yadav,29,27,1,2,1,19,17,1,1,10,10,0,1
6480bba0404171e13faa181e,2013,,,2,DR Smith,SR Tendulkar,29,29,1,2,1,23,23,1,2,2,6,0,0
6480bb9d86effd7e5e6a5261,2011,,,1,JA Morkel,MEK Hussey,29,16,4,0,1,9,8,1,0,20,8,3,0
6480bb95a8153d4daac6e4f7,2019,,,2,F du Plessis,SR Watson,29,19,6,0,1,23,12,5,0,6,7,1,0
6480bb9b95eac8df5d0180b0,2007/08,,,1,S Dhawan,V Sehwag,29,12,1,3,1,8,5,0,1,19,7,1,2
6480bb9ce7891d47a7fe9c12,2009/10,,,2,DPMD Jayawardene,MS Bisla,29,21,5,0,1,6,7,1,0,20,14,4,0
6480bb9d80536875f41bc605,2011,,,1,AA Jhunjhunwala,MK Pandey,29,30,2,1,1,10,15,2,0,12,15,0,1
6480bba3bca9c998d5f3e3d0,2016,,,2,DA Warner,DJ Hooda,29,26,2,0,1,12,14,1,0,14,12,1,0
6480bb9824c4678d005d7aeb,2022,,,2,SP Jackson,UT Yadav,29,14,1,2,1,7,6,0,0,21,8,1,2
6480bb99358a21ba3487db81,2023,,,1,Anmolpreet Singh,RA Tripathi,29,30,4,0,1,18,16,3,0,9,14,1,0
6480bb9e565ef5f11c5c8f55,2011,,,2,AB de Villiers,M Kaif,29,22,4,1,1,14,11,1,1,15,11,3,0
6480bb9575ad32214d0f6ec0,2019,,,1,KL Rahul,MA Agarwal,29,18,1,2,1,3,6,0,0,26,12,1,2
6480bb9341152e168005ccc9,2017,,,1,AB de Villiers,KM Jadhav,29,29,0,1,1,16,19,0,1,9,10,0,0
6480bba1abec4894f2f69a35,2014,,,1,BB McCullum,DR Smith,29,26,2,2,1,19,13,1,2,9,13,1,0
6480bb9b0e32875998e9bfdc,2009,,,2,GC Smith,RA Jadeja,29,23,2,0,1,11,10,1,0,16,13,1,0
6480bb9a5d25d853e1cbfe3e,2007/08,,,1,Kamran Akmal,SR Watson,29,15,2,2,1,11,6,1,1,14,9,1,1
6480bb9808d6857eeb335d94,2022,,,2,AR Patel,R Powell,29,23,2,1,1,24,17,2,1,5,6,0,0
6480bba0d4b2f9be71a5f230,2014,,,2,KD Karthik,MA Agarwal,29,19,3,0,1,10,8,2,0,17,11,1,0
6480bb9eb2690fb1ed356b42,2011,,,1,A Symonds,SR Tendulkar,29,35,1,0,1,8,19,0,0,13,16,1,0
6480bb942efd740a6ffc47df,2017,,,1,KV Sharma,RG Sharma,29,18,4,0,1,9,8,1,0,18,10,3,0
6480bb96f1eadf803ffc292c,2020/21,,,1,MP Stoinis,RR Pant,29,21,0,3,1,24,16,0,3,4,5,0,0
6480bb954da239b357833c8a,2018,,,1,DT Christian,V Shankar,29,19,1,1,0,7,9,0,0,22,10,1,1
6480bb98d8f59b81335f4a3d,2021,,,1,AB de Villiers,D Padikkal,29,21,0,2,1,12,11,0,1,15,10,0,1
6480bb9506d56930505d45ae,2019,,,1,CH Gayle,MA Agarwal,29,19,5,1,1,27,10,5,1,2,9,0,0
6480bb93d9581d69657887c3,2017,,,2,RR Pant,SV Samson,29,20,2,1,1,20,14,1,1,6,6,1,0
6480bb9aa64355ce98da1141,2007/08,,,1,Misbah-ul-Haq,R Dravid,29,20,3,0,1,8,7,1,0,16,13,2,0
6480bb9d05f8e769574069fa,2009/10,,,2,BB McCullum,WP Saha,29,20,2,2,1,17,8,2,1,12,12,0,1
6480bb941ab79050c3c90ee5,2018,,,2,RA Jadeja,SW Billings,29,13,1,3,1,3,4,0,0,26,9,1,3
6480bb9aded509be64de3bfb,2007/08,,,2,SC Ganguly,WP Saha,29,19,5,1,1,2,3,0,0,27,16,5,1
6480bb9df46e9f48932124df,2009/10,,,1,AT Rayudu,JP Duminy,29,19,4,0,1,11,10,1,0,16,9,3,0
6480bb9d362f72789dcdc5a7,2009/10,,,1,MEK Hussey,SK Raina,29,27,4,0,1,14,12,2,0,12,15,2,0
6480bb9d80e97e178e5f68de,2011,,,2,JH Kallis,YK Pathan,29,24,3,1,1,18,12,3,0,11,12,0,1
6480bba3d3dc891a3092643e,2016,,,1,MS Dhoni,R Ashwin,29,11,2,3,0,27,10,2,3,1,1,0,0
6480bb9d867c041656e9a75f,2009/10,,,1,M Manhas,PD Collingwood,29,33,1,0,1,12,14,0,0,16,19,1,0
6480bb99f2a793884331579e,2023,,,2,SA Yadav,TH David,29,16,2,2,1,6,5,1,0,22,11,1,2
6480bb9a7d91d721555835e5,2007/08,,,2,AB Agarkar,SC Ganguly,29,19,2,2,1,20,13,1,2,7,6,1,0
6480bb9d967f5a4cfbd8c74d,2011,,,2,JH Kallis,SP Goswami,29,27,5,0,1,11,11,2,0,17,16,3,0
6480bb994aafcf67cd092a7d,2023,,,1,AR Patel,SN Khan,29,24,3,1,1,17,11,2,1,12,13,1,0
6480bba31cc11024436836b5,2016,,,1,KA Pollard,KH Pandya,29,15,1,3,1,3,4,0,0,26,11,1,3
6480bba2f05e90a9005771d2,2015,,,2,DJ Bravo,RA Jadeja,29,21,2,0,0,13,9,2,0,14,12,0,0
6480bb9a3ffea6235f54cc1e,2023,,,2,Abhishek Sharma,MA Agarwal,29,18,3,1,1,6,7,1,0,18,11,2,1
6480bb9e502d7987de08e5d5,2012,,,1,AC Thomas,M Manhas,29,15,0,3,1,12,9,0,1,16,6,0,2
6480bb949f5853dfe76c99d9,2017,,,2,DA Warner,KS Williamson,29,26,1,1,1,8,12,0,0,21,14,1,1
6480bba28257fe87dd859e3e,2015,,,1,GJ Maxwell,M Vijay,29,20,5,0,1,12,9,2,0,17,11,3,0
6480bba1c0aa361f3c6e454c,2015,,,2,F du Plessis,SK Raina,29,26,3,1,1,11,13,2,0,17,13,1,1
6480bb9b4b74852492343291,2007/08,,,1,Misbah-ul-Haq,SP Goswami,29,25,3,0,1,5,7,0,0,23,18,3,0
6480bb974086cbea889134af,2021,,,2,RR Pant,S Dhawan,29,18,5,0,1,7,8,1,0,20,10,4,0
6480bb9442c4889bcbb4a784,2017,,,2,MK Tiwary,RA Tripathi,29,20,4,1,1,8,9,1,0,20,11,3,1
6480bb9824c4678d005d7aeb,2022,,,2,SS Iyer,VR Iyer,29,15,1,2,1,21,8,1,2,6,7,0,0
6480bb941ab79050c3c90ee5,2018,,,1,N Rana,RV Uthappa,29,17,2,2,1,16,14,2,0,13,3,0,2
6480bb95af5853799812b0f6,2019,,,1,MK Pandey,V Shankar,29,15,3,1,0,8,5,1,0,20,10,2,1
6480bb94f06c6048c8088194,2018,,,1,RA Tripathi,SV Samson,29,26,2,0,1,17,15,2,0,11,11,0,0
6480bb999424dd02cf40772a,2022,,,1,MK Lomror,RM Patidar,29,17,4,0,1,14,9,2,0,13,8,2,0
6480bb967d799ced7fe5d8e9,2020/21,,,1,CH Gayle,KL Rahul,29,30,2,1,1,20,20,2,1,7,10,0,0
6480bb9db0ecec8acdd30619,2011,,,1,SS Tiwary,V Kohli,29,11,1,3,1,10,4,1,1,18,7,0,2
6480bb976344f6d667dfd965,2021,,,2,KD Karthik,N Rana,29,20,2,2,1,12,14,2,0,17,6,0,2
6480bb9ca5c1d511ad78e92d,2009,,,1,JH Kallis,LRPL Taylor,29,15,1,3,1,3,3,0,0,25,12,1,3
6480bb98cbaaf700d226941a,2022,,,2,KA Pollard,M Ashwin,29,22,3,1,1,18,14,2,1,6,8,1,0
6480bba2c5a614e0fd10cd19,2016,,,2,CA Lynn,YK Pathan,29,16,4,0,0,10,8,0,0,19,8,4,0
6480bba1de7febd9f1f0138e,2014,,,1,F du Plessis,R Ashwin,29,29,1,0,1,14,13,0,0,14,16,1,0
6480bb9b72f6a46338302131,2009,,,1,AC Gilchrist,TL Suman,29,23,2,2,1,7,10,1,0,20,13,1,2
6480bb981f136a7564719d7f,2022,,,1,LS Livingstone,M Shahrukh Khan,29,13,3,2,1,14,6,3,0,15,7,0,2
6480bba107ba9f7f041862c1,2014,,,1,BB McCullum,MS Dhoni,29,23,1,1,1,14,12,0,1,13,11,1,0
6480bb9bb070eb19f9ac8a76,2007/08,,,1,DPMD Jayawardene,PP Chawla,29,15,1,2,0,11,6,0,1,16,9,1,1
6480bb98323919fff9902666,2022,,,1,JM Bairstow,MA Agarwal,29,24,3,0,1,11,11,1,0,15,13,2,0
6480bb958e752648ab95362b,2019,,,1,AD Russell,HF Gurney,29,21,3,2,0,27,16,3,2,1,5,0,0
6480bb9d967f5a4cfbd8c74d,2011,,,1,JR Hopes,V Sehwag,29,28,3,1,1,5,11,0,0,23,17,3,1
6480bb94009d0662ee94f07b,2018,,,2,DJ Hooda,YK Pathan,29,28,2,0,1,15,14,0,0,14,14,2,0
6480bb96c95abb10156a6055,2020/21,,,1,HH Pandya,SS Tiwary,29,19,2,2,1,13,8,0,2,16,11,2,0
6480bb9ff2e0b1df0c3972c9,2012,,,2,DJ Hussey,PP Chawla,29,26,2,1,1,19,12,2,1,10,14,0,0
6480bb9ea75f51e7a33e90ed,2012,,,2,Azhar Mahmood,Mandeep Singh,29,23,0,2,1,18,12,0,2,10,11,0,0
6480bb99e909d98c8193bac5,2023,,,2,AU Rashid,Abdul Samad,29,20,1,1,1,18,13,1,1,6,7,0,0
6480bba16796f9a72374865f,2015,,,2,AP Tare,RG Sharma,29,21,4,1,1,7,7,1,0,21,14,3,1
6480bb9e2c96ab2b87d9466a,2011,,,2,IK Pathan,JR Hopes,29,19,5,0,1,22,15,4,0,6,4,1,0
6480bb975156c246a0ee40b1,2021,,,2,MK Pandey,Mohammad Nabi,29,18,2,1,1,12,7,0,1,14,11,2,0
6480bb9746dfc5c467942a84,2021,,,2,KA Pollard,SS Tiwary,29,23,3,1,1,15,14,1,1,13,9,2,0
6480bb994aafcf67cd092a7d,2023,,,1,DA Warner,PP Shaw,29,16,3,0,1,12,11,2,0,7,5,1,0
6480bb9516b0dbc1972e5c3c,2018,,,1,AD Russell,KD Karthik,29,18,1,3,1,19,13,1,2,9,5,0,1
6480bb9f955d5c84cde78f58,2012,,,1,AM Rahane,R Dravid,29,27,5,0,1,6,7,1,0,21,20,4,0
6480bba2563745309ee2bdfb,2016,,,1,Ishan Kishan,JP Faulkner,29,28,2,0,1,20,15,2,0,9,13,0,0
6480bb9da3dc1406b000cc98,2011,,,1,MD Mishra,Yuvraj Singh,29,23,1,1,1,7,11,0,0,21,12,1,1
6480bb9f210b6e50fb2072ae,2013,,,2,G Gambhir,MK Tiwary,29,21,2,1,1,12,9,0,1,17,12,2,0
6480bb9b82dc3ec84c520466,2009,,,1,KP Pietersen,V Kohli,29,18,2,1,1,8,6,1,0,19,12,1,1
6480bb9dd10e35e6145534dc,2011,,,1,JP Duminy,KC Sangakkara,29,19,4,0,1,7,9,0,0,20,10,4,0
6480bba1bd00c57fb3301f04,2014,,,2,DA Miller,WP Saha,29,12,3,2,0,1,1,0,0,27,11,3,2
6480bb97a42828c5a5ebef1c,2020/21,,,2,AR Patel,K Rabada,29,26,2,1,1,12,12,0,1,15,14,2,0
6480bb9f955d5c84cde78f58,2012,,,2,AD Mathews,SPD Smith,29,24,3,0,1,8,9,0,0,21,15,3,0
6480bba28724848c0f3ef034,2015,,,1,LMP Simmons,PA Patel,29,26,4,0,1,8,12,1,0,21,14,3,0
6480bb99b35dc0981e512451,2022,,,1,JC Buttler,SV Samson,29,26,4,0,1,15,15,2,0,14,11,2,0
6480bb9b46b4360184dc19f3,2007/08,,,1,AC Gilchrist,DB Ravi Teja,29,16,6,0,1,18,10,4,0,10,6,2,0
6480bb9516b0dbc1972e5c3c,2018,,,1,AD Russell,JPR Scantlebury-Searles,29,15,1,3,1,25,10,1,3,2,5,0,0
6480bb95e25835586d412978,2018,,,1,MA Agarwal,MP Stoinis,29,17,1,2,1,11,7,0,1,17,10,1,1
6480bb9da398a7c3c645732c,2011,,,1,R Dravid,SR Watson,29,27,2,1,1,12,13,2,0,12,14,0,1
6480bba1670ace74604a420f,2015,,,1,F du Plessis,RA Jadeja,29,25,2,1,1,15,14,1,0,13,11,1,1
6480bb9cf1471ad233c7b0af,2009,,,2,MM Patel,SK Trivedi,29,18,5,0,0,23,10,5,0,5,8,0,0
6480bba03b6f98689b851317,2013,,,2,DJ Hussey,M Vohra,29,20,3,1,1,10,9,1,0,19,11,2,1
6480bb9e32ed1b9e077b8c11,2011,,,1,AM Rahane,J Botha,29,22,2,1,1,17,10,1,1,11,12,1,0
6480bb949a2d28d1ad7d367f,2018,,,2,DA Miller,MP Stoinis,29,20,2,0,0,6,5,0,0,22,15,2,0
6480bb9e83b8575f74b8e962,2012,,,1,DJ Bravo,JA Morkel,29,8,2,3,1,1,1,0,0,28,7,2,3
6480bb958e752648ab95362b,2019,,,1,AD Russell,PP Chawla,29,32,2,2,1,21,19,2,1,8,13,0,1
6480bb95b84f125c6212267a,2019,,,1,DA Warner,YK Pathan,29,15,2,1,0,22,9,2,1,6,6,0,0
6480bb9d5cca30c933d4baf4,2011,,,2,SR Watson,STR Binny,29,21,4,0,1,23,14,4,0,5,7,0,0
6480bb948f3284f793b2763c,2018,,,1,HH Pandya,RG Sharma,29,10,2,3,1,13,4,0,2,15,6,2,1
6480bba2e680f2464af841ae,2015,,,2,DA Warner,S Dhawan,29,23,3,1,1,16,13,1,1,13,10,2,0
6480bb9c442caaabe9eb2275,2009,,,2,PR Shah,SR Tendulkar,29,30,2,0,1,10,16,0,0,15,14,2,0
6480bb966c197bad273f91f1,2020/21,,,1,KH Pandya,SA Yadav,29,28,2,1,1,12,17,0,1,16,11,2,0
6480bb9bcc2f6123673672d0,2007/08,,,2,RV Uthappa,SM Pollock,29,21,4,0,1,12,6,2,0,16,15,2,0
6480bba1a6882d256a926a8b,2014,,,2,MK Tiwary,R Shukla,29,21,4,0,1,13,9,2,0,14,12,2,0
6480bb9c17dcdfd5b06984f0,2009/10,,,2,CH Gayle,DJ Hussey,29,23,2,1,1,16,12,1,1,11,11,1,0
6480bba107ba9f7f041862c1,2014,,,1,MS Dhoni,RA Jadeja,29,16,1,2,0,9,6,0,1,17,10,1,1
6480bba3e9fa951efcfc8bfb,2016,,,1,AR Patel,DA Miller,29,11,1,2,0,16,5,0,2,11,6,1,0
6480bb96e76ccde6082d7564,2020/21,,,2,KL Rahul,N Pooran,29,18,3,1,1,13,8,1,0,16,10,2,1
6480bba2aecb4103bab63c15,2016,,,2,SA Yadav,Shakib Al Hasan,29,22,1,2,1,23,13,1,2,3,9,0,0
6480bba1af51ddc81185931d,2014,,,1,VH Zol,YV Takawale,29,24,4,1,1,11,8,0,1,18,16,4,0
6480bb94351a8b10e20d14d9,2017,,,2,DR Smith,SK Raina,29,12,3,2,1,14,6,0,2,14,6,3,0
6480bba01893b0faadb9c761,2013,,,1,DR Smith,SR Tendulkar,29,22,5,0,1,4,9,0,0,23,13,5,0
6480bb9f36ad55c3c7fd6548,2012,,,2,R Bhatia,YK Pathan,29,16,4,0,1,12,7,2,0,14,9,2,0
6480bba2a94dd2c01769b3ae,2016,,,2,JP Duminy,SV Samson,29,16,3,1,0,13,7,2,0,15,9,1,1
6480bb960d5042aa46b7776b,2020/21,,,1,JL Pattinson,KA Pollard,29,13,0,4,1,3,4,0,0,26,9,0,4
6480bba26ca6ec72ba377236,2016,,,1,DJ Hooda,MC Henriques,29,11,1,3,1,2,2,0,0,26,9,1,3
6480bba08ffdd4393211d261,2014,,,2,DR Smith,SK Raina,29,19,2,2,1,15,9,1,1,14,10,1,1
6480bb9d716a89dbf5e486d0,2011,,,1,AM Rahane,J Botha,29,26,2,1,1,18,17,1,1,10,9,1,0
6480bb9765a785922ad360fe,2021,,,1,KS Williamson,WP Saha,29,27,2,1,1,6,10,0,0,18,17,2,1
6480bb9c5d0fccb6a3a6d37d,2009,,,2,SK Warne,SM Harwood,29,17,2,1,0,20,10,2,1,6,7,0,0
6480bba140ee53a14fe06e0d,2014,,,2,BB McCullum,DR Smith,29,27,3,1,1,13,11,1,1,14,16,2,0
6480bb96e834e1c16b33f325,2020/21,,,1,GJ Maxwell,N Pooran,29,12,1,3,0,3,4,0,0,25,8,1,3
6480bb9f87652064dab6c573,2013,,,1,DA Miller,DJ Hussey,29,27,1,0,1,19,15,1,0,9,12,0,0
6480bba1af9481df8b4f9f0f,2015,,,2,CH Gayle,V Kohli,29,29,2,1,1,12,14,2,0,13,15,0,1
6480bba2d313234709068efb,2015,,,1,LMP Simmons,PA Patel,29,24,4,0,1,9,13,1,0,19,11,3,0
6480bba2b5d601f8354f5b5a,2016,,,2,M Vohra,SE Marsh,29,28,5,0,1,16,12,3,0,13,16,2,0
6480bb9574ca455ec008e942,2018,,,1,DJ Hooda,Shakib Al Hasan,29,28,3,0,1,10,13,0,0,18,15,3,0
6480bb9f9a70ecf3467829df,2013,,,2,R Dravid,SR Watson,29,23,1,1,1,6,9,0,0,21,14,1,1
6480bb9e300070746cc2eb67,2011,,,1,M Vijay,MS Dhoni,29,20,0,2,1,6,8,0,0,22,12,0,2
6480bb9e9162dceff15dc334,2011,,,1,DPMD Jayawardene,RA Jadeja,29,27,1,2,1,12,9,0,1,17,18,1,1
6480bb9c7a11e1cbeea46b0e,2009/10,,,2,AD Mascarenhas,P Dogra,28,12,2,2,1,4,4,0,0,23,8,2,2
6480bba3aa840e4e9450a200,2016,,,2,STR Binny,V Kohli,28,19,2,0,0,16,11,2,0,7,8,0,0
6480bb9c8c6c106c6ffbeae4,2009/10,,,1,DW Steyn,V Kohli,28,15,3,1,1,8,9,1,0,16,6,2,1
6480bb9834c7569d5fa64353,2022,,,2,D Padikkal,JC Buttler,28,12,5,1,1,0,1,0,0,28,11,5,1
6480bb9d03ce4b87b32b91f5,2009/10,,,2,MEK Hussey,SK Raina,28,19,0,2,1,8,11,0,0,18,8,0,2
6480bba0cdc200ad3ab8fbf5,2014,,,1,BB McCullum,MS Dhoni,28,19,2,1,0,10,8,1,0,14,11,1,1
6480bb9a21e416835389fd53,2023,,,1,DP Conway,MM Ali,28,13,5,0,1,17,7,3,0,10,6,2,0
6480bb98f01e4672b988c112,2022,,,1,R Parag,SO Hetmyer,28,9,0,4,1,8,4,0,1,20,5,0,3
6480bb9de80788b3c3ebe4e1,2009/10,,,1,AA Jhunjhunwala,AC Voges,28,25,1,0,1,13,13,0,0,14,12,1,0
6480bb9e93f969bcc8a79433,2011,,,1,JH Kallis,MK Tiwary,28,24,3,0,0,12,12,1,0,15,12,2,0
6480bba37e4fcb8af147f79b,2016,,,2,CH Morris,NM Coulter-Nile,28,10,3,2,0,26,7,3,2,2,3,0,0
6480bb9b724406459cd357c9,2007/08,,,2,MV Boucher,R Dravid,28,29,2,0,1,13,17,1,0,15,12,1,0
6480bba388682c5ca10ff37a,2016,,,2,DA Warner,Yuvraj Singh,28,22,3,1,1,8,9,1,0,19,13,2,1
6480bba2c5a614e0fd10cd19,2016,,,1,JC Buttler,RG Sharma,28,24,4,0,1,15,15,2,0,13,9,2,0
6480bb95e435367dc64d9844,2019,,,1,BCJ Cutting,HH Pandya,28,14,3,1,1,6,6,1,0,20,8,2,1
6480bb94f1c027945eeb8b10,2017,,,1,S Dhawan,V Shankar,28,22,1,0,0,12,10,0,0,15,12,1,0
6480bb96f8379d02d3435ceb,2020/21,,,1,RA Tripathi,SP Narine,28,17,2,1,1,10,8,1,0,17,9,1,1
6480bb9c761c43b2dfb9767d,2009,,,1,KC Sangakkara,S Sohal,28,14,1,3,1,2,7,0,0,24,7,1,3
6480bb9e38040b358f5a34d8,2012,,,1,DJ Harris,S Dhawan,28,29,6,0,1,19,17,4,0,9,12,2,0
6480bb9da3dc1406b000cc98,2011,,,1,GC Smith,JD Ryder,28,24,2,2,1,12,14,2,0,15,10,0,2
6480bb9da398a7c3c645732c,2011,,,2,Harpreet Singh,M Manhas,28,32,1,0,1,12,17,0,0,16,15,1,0
6480bba048fb3d33ea0711e7,2013,,,2,PA Patel,S Dhawan,28,25,3,1,1,12,11,1,1,15,14,2,0
6480bb9df57ec21d17310ad2,2011,,,2,B Chipli,JP Duminy,28,20,2,1,1,19,12,2,1,6,8,0,0
6480bb9ea49fe0f895bf242a,2012,,,1,RE Levi,TL Suman,28,21,2,2,1,16,11,2,1,10,10,0,1
6480bb9774a44376e3b5eb6f,2021,,,2,KL Rahul,M Shahrukh Khan,28,17,3,1,1,12,9,2,0,16,8,1,1
6480bb958c7b985a2b586a02,2018,,,2,RV Uthappa,SP Narine,28,20,4,1,1,6,8,1,0,20,12,3,1
6480bba140ee53a14fe06e0d,2014,,,1,AP Tare,CJ Anderson,28,11,2,2,1,9,5,2,0,18,6,0,2
6480bb99d43295fa2d82c9dc,2023,,,1,GJ Maxwell,MK Lomror,28,15,0,3,1,16,8,0,2,11,7,0,1
6480bb9d22388e966342dba8,2009/10,,,2,AT Rayudu,KA Pollard,28,11,3,2,1,1,2,0,0,27,9,3,2
6480bb9c9685addc4a78d7d0,2009/10,,,2,CH Gayle,SC Ganguly,28,18,5,0,1,14,12,3,0,8,6,2,0
6480bb9553f3fc8903579544,2018,,,2,CA Lynn,RV Uthappa,28,22,3,2,1,21,15,3,1,7,7,0,1
6480bb95f214d4f82ab97ee5,2018,,,2,AD Russell,KD Karthik,28,16,4,1,0,11,5,2,0,16,11,2,1
6480bb9c1e676472f4841aa9,2009/10,,,2,JA Morkel,R Ashwin,28,22,2,1,1,15,12,1,1,11,10,1,0
6480bb99d43295fa2d82c9dc,2023,,,2,DA Warner,MK Pandey,28,20,5,0,1,18,9,4,0,10,11,1,0
6480bb945460b25d997060fb,2018,,,1,KD Karthik,N Rana,28,17,3,1,1,19,10,2,1,8,7,1,0
6480bba2c3207713bd927ce5,2015,,,1,KL Rahul,KV Sharma,28,16,1,2,0,17,9,1,1,11,7,0,1
6480bb9ee4565d108b29626f,2012,,,2,G Gambhir,MK Tiwary,28,22,3,0,1,14,9,2,0,13,13,1,0
6480bb9c89f35f11aae1f2d0,2009/10,,,2,AA Jhunjhunwala,NV Ojha,28,17,4,1,1,2,4,0,0,26,13,4,1
6480bb9baccf501985a56d64,2007/08,,,1,AD Mascarenhas,SR Watson,28,19,1,2,1,9,8,0,1,16,11,1,1
6480bba23ed328dbb847b4e7,2016,,,2,CA Lynn,G Gambhir,28,22,1,1,1,15,12,0,1,11,10,1,0
6480bb9b4b74852492343291,2007/08,,,1,Misbah-ul-Haq,Z Khan,28,7,2,3,0,24,6,1,3,4,1,1,0
6480bba287d112bccc55ccd2,2015,,,1,AR Patel,GJ Bailey,28,19,2,1,1,16,12,1,1,11,7,1,0
6480bb966f48b8ee03e6dff5,2020/21,,,1,SM Curran,SN Thakur,28,36,0,1,1,17,16,0,1,11,20,0,0
6480bb9d54ae15d3d0ed9e5e,2011,,,2,EJG Morgan,MK Tiwary,28,21,3,1,1,26,14,3,1,1,7,0,0
6480bba07e219ed95b7b06df,2013,,,1,BJ Rohrer,DA Warner,28,21,2,1,1,13,13,1,0,14,8,1,1
6480bba27b4786f36f706f8e,2016,,,1,Harbhajan Singh,R Vinay Kumar,28,21,3,1,1,15,10,3,0,12,11,0,1
6480bb963d224b9be17f2c75,2019,,,1,DA Warner,KS Williamson,28,23,2,0,1,13,9,0,0,13,14,2,0
6480bba1670ace74604a420f,2015,,,1,MS Dhoni,R Ashwin,28,19,1,2,1,15,11,0,2,12,8,1,0
6480bb94cf431881ac3e9cbf,2018,,,2,AB de Villiers,Mandeep Singh,28,13,3,1,0,10,4,2,0,17,9,1,1
6480bb9dfa7d0510ae3a7b40,2011,,,1,DA Warner,V Sehwag,28,23,6,0,1,16,16,3,0,12,7,3,0
6480bb93d5dc00a79edede9c,2017,,,1,JC Buttler,PA Patel,28,19,5,0,1,14,11,3,0,13,8,2,0
6480bb9eda28fb340ed37b49,2012,,,2,G Gambhir,MS Bisla,28,25,5,0,1,15,12,3,0,10,13,2,0
6480bb9dd4e6757f7ded95e9,2009/10,,,2,MR Marsh,RG Sharma,28,19,2,1,1,15,11,1,1,10,8,1,0
6480bb9a596c087c0396ec2e,2007/08,,,1,AM Nayar,RV Uthappa,28,20,3,0,1,10,9,1,0,15,11,2,0
6480bb9ac9149c73fdf073b3,2023,,,1,MS Dhoni,RA Jadeja,28,11,3,1,0,5,4,0,0,20,7,3,1
6480bba33195e5ebac1da82a,2016,,,1,N Rana,RG Sharma,28,36,0,2,1,17,22,0,2,8,14,0,0
6480bb9fcb2b412c0ebd4afa,2013,,,1,GH Vihari,PA Reddy,28,29,1,0,1,11,16,0,0,13,13,1,0
6480bb96c0ffb76dab723a2b,2019,,,2,SK Raina,SR Watson,28,12,1,3,1,3,3,0,0,24,9,1,3
6480bb9c0dec1a788da66d33,2009/10,,,2,JA Morkel,S Badrinath,28,15,1,3,1,25,9,1,3,2,6,0,0
6480bba29fb420d92aef1d2a,2015,,,1,J Botha,YK Pathan,28,15,3,1,1,12,6,1,1,14,9,2,0
6480bba2a215721aadf7a90a,2015,,,1,DJ Bravo,MS Dhoni,28,15,3,1,0,15,8,2,0,13,7,1,1
6480bb9836af59f8283f4081,2022,,,1,JC Buttler,SV Samson,28,18,2,2,1,10,11,2,0,16,7,0,2
6480bba1587a54176a9badf4,2014,,,2,DJG Sammy,JO Holder,28,18,2,2,1,10,6,0,1,16,12,2,1
6480bb9399a527d39bc17dad,2017,,,1,Ishan Kishan,RA Jadeja,28,18,0,2,1,19,9,0,2,9,9,0,0
6480bb99537b54b870dc74d1,2023,,,1,MW Short,S Dhawan,28,18,6,0,1,18,10,4,0,8,8,2,0
6480bba1d9f266a28a109f29,2015,,,1,AR Patel,GJ Bailey,28,17,1,2,1,13,9,0,1,15,8,1,1
6480bb973d98bfd2d4a5f108,2020/21,,,2,N Rana,Shubman Gill,28,24,2,1,1,9,14,1,0,18,10,1,1
6480bb97cca23939859c422e,2021,,,2,KS Williamson,Virat Singh,28,34,3,0,1,23,20,3,0,4,14,0,0
6480bb9e19dd5297ba8ca5f7,2011,,,1,CJ Ferguson,Yuvraj Singh,28,20,3,1,1,11,13,1,0,17,7,2,1
6480bb9a8cf29e28434bb1d5,2023,,,2,HH Pandya,R Tewatia,28,15,0,3,1,8,8,0,0,20,7,0,3
6480bb98cce4ab46512c2c03,2022,,,1,RD Gaikwad,RV Uthappa,28,15,3,1,1,1,4,0,0,21,11,3,1
6480bb97cca23939859c422e,2021,,,2,JM Bairstow,KS Williamson,28,14,3,2,1,16,6,1,2,11,8,2,0
6480bb9718a9b89de407178b,2021,,,2,MP Stoinis,RR Pant,28,16,2,1,1,22,11,2,1,4,5,0,0
6480bb9ca5c1d511ad78e92d,2009,,,2,AB de Villiers,KD Karthik,28,27,2,0,1,18,16,2,0,10,11,0,0
6480bba38056992b92414bab,2016,,,2,DA Warner,S Dhawan,28,21,1,2,1,18,16,1,1,10,5,0,1
6480bb95085c25712f29bd36,2019,,,2,DJ Bravo,MS Dhoni,28,15,1,2,1,5,4,0,0,22,11,1,2
6480bba2f3ed8323f852acfa,2016,,,2,DA Miller,SE Marsh,28,21,3,1,1,9,11,1,0,19,10,2,1
6480bba328f7475f4b87d3ff,2016,,,1,RA Jadeja,SK Raina,28,22,4,0,0,11,10,1,0,17,12,3,0
6480bb9cd6fe6fad0d6efbd9,2009/10,,,2,KD Karthik,M Manhas,28,28,2,0,0,13,18,1,0,11,10,1,0
6480bb9eb2690fb1ed356b42,2011,,,2,DT Christian,S Dhawan,28,24,2,0,1,8,10,0,0,18,14,2,0
6480bb99f33a7dd80eb0a544,2023,,,2,Atharva Taide,P Simran Singh,28,17,4,1,1,16,7,2,1,8,10,2,0
6480bba3aa840e4e9450a200,2016,,,2,SR Watson,V Kohli,28,29,1,1,1,14,18,0,1,14,11,1,0
6480bb9d29051b8e40c07d52,2011,,,2,BB McCullum,RA Jadeja,28,20,3,0,1,19,13,2,0,8,7,1,0
6480bb9c620c92d09ba1b6b9,2009,,,1,A Symonds,RG Sharma,28,22,1,1,1,21,13,1,1,7,9,0,0
6480bb99773871f8e2ddc4b1,2022,,,2,JM Bairstow,S Dhawan,28,18,5,0,1,23,15,5,0,5,3,0,0
6480bb9b7557e68b433167d5,2007/08,,,2,Kamran Akmal,YK Pathan,28,14,4,1,1,22,9,3,1,6,5,1,0
6480bb9a61edc0c77bc4bc86,2007/08,,,2,CK Kapugedera,MS Dhoni,28,24,1,0,1,8,8,0,0,18,16,1,0
6480bb9c7b7d7712bdc663de,2009/10,,,2,A Symonds,RG Sharma,28,24,2,0,1,15,11,2,0,11,13,0,0
6480bb995f3db9699a1f794d,2022,,,2,R Ashwin,YBK Jaiswal,28,21,0,2,1,13,11,0,1,14,10,0,1
6480bb97b97c36ac8be3582f,2021,,,1,Shahbaz Ahmed,V Kohli,28,20,2,1,1,14,10,0,1,13,10,2,0
6480bb97cca23939859c422e,2021,,,2,DA Warner,JM Bairstow,28,20,2,2,1,6,8,0,0,22,12,2,2
6480bb993e44f97eccb361fe,2023,,,2,Harpreet Singh,MW Short,28,22,3,1,1,5,7,1,0,21,15,2,1
6480bb99b4febfb641fddd39,2023,,,1,SA Yadav,Tilak Varma,28,21,2,1,1,12,11,1,0,16,10,1,1
6480bb9c89e2e8ecb04f94cb,2009/10,,,1,A Symonds,HH Gibbs,28,27,0,2,1,14,13,0,1,14,14,0,1
6480bb971c9e4a3ef11759f3,2021,,,2,EJG Morgan,KD Karthik,28,15,3,1,0,16,9,1,1,12,6,2,0
6480bba1e64915b9e7c849ca,2014,,,2,AR Patel,GJ Bailey,28,21,3,1,1,22,14,3,1,6,7,0,0
6480bba10e78f50f124b406a,2015,,,1,KD Karthik,V Kohli,28,26,2,1,1,10,11,1,0,17,15,1,1
6480bba35038a60ea566794a,2016,,,2,DA Warner,Yuvraj Singh,28,25,3,1,1,20,12,2,1,8,13,1,0
6480bb9a1a3ab2ab8297871d,2007/08,,,1,A Symonds,AS Yadav,28,12,5,0,1,9,3,2,0,16,9,3,0
6480bb96f8379d02d3435ceb,2020/21,,,2,MS Dhoni,SM Curran,28,20,2,1,1,10,10,1,0,17,10,1,1
6480bba01a3f8444c7a33ba6,2014,,,1,DS Kulkarni,R Bhatia,28,25,1,1,1,10,13,0,0,17,12,1,1
6480bb9fe8f5df13fc8d1bc3,2012,,,1,DB Das,LR Shukla,28,13,2,2,1,17,7,2,1,9,6,0,1
6480bb9e34659755628e7471,2012,,,1,JD Ryder,SC Ganguly,28,24,3,0,1,7,6,0,0,20,18,3,0
6480bb97372fc5d5ef4c436a,2021,,,1,CR Woakes,TK Curran,28,21,3,0,1,13,9,2,0,15,12,1,0
6480bb976344f6d667dfd965,2021,,,1,R Ashwin,RR Pant,28,22,3,0,1,9,8,1,0,18,14,2,0
6480bba2f36e449a59f4a812,2015,,,1,KM Jadhav,MA Agarwal,28,34,2,0,1,18,18,2,0,9,16,0,0
6480bba1af9481df8b4f9f0f,2015,,,1,MK Pandey,SA Yadav,28,17,5,0,1,17,8,3,0,11,9,2,0
6480bba3fc9599eca1b87a77,2016,,,2,BB McCullum,RA Jadeja,28,19,4,1,1,9,8,2,0,18,11,2,1
6480bba0da054e3d917f71fb,2013,,,2,DJ Bravo,RA Jadeja,28,16,4,0,0,23,11,4,0,4,5,0,0
6480bb9d29051b8e40c07d52,2011,,,2,BJ Hodge,RA Jadeja,28,11,3,2,0,11,7,2,0,17,4,1,2
6480bb95a09b947e0837a38a,2019,,,2,Q de Kock,SD Lad,28,22,3,1,1,13,9,2,0,15,13,1,1
6480bba0f401cc6b6bc6ed10,2013,,,2,DJG Sammy,S Dhawan,28,28,1,1,1,14,16,0,1,13,12,1,0
6480bb95430629e254bbc4fd,2018,,,2,CA Lynn,Shubman Gill,28,17,5,0,1,17,13,4,0,7,4,1,0
6480bba2f39653e2f61baca2,2015,,,2,KM Jadhav,Yuvraj Singh,28,28,2,1,1,15,13,0,1,13,15,2,0
6480bb95833c06e6c5119173,2019,,,2,CA Lynn,SP Narine,28,12,4,0,1,11,4,2,0,10,8,2,0
6480bba11eff9b230a172302,2014,,,1,G Gambhir,JH Kallis,28,32,2,0,1,14,15,1,0,13,17,1,0
6480bb9a51ee1ef33a5b2dbb,2007/08,,,1,JR Hopes,SE Marsh,28,23,5,0,1,18,12,4,0,9,11,1,0
6480bb95a09b947e0837a38a,2019,,,2,Q de Kock,SA Yadav,28,24,4,0,1,7,9,0,0,21,15,4,0
6480bb97b945155c90dccd3d,2021,,,2,F du Plessis,MM Ali,28,19,3,1,1,10,8,1,0,18,11,2,1
6480bba1de7febd9f1f0138e,2014,,,1,MS Dhoni,RA Jadeja,28,13,0,2,0,17,7,0,1,11,6,0,1
6480bb9d93cca4d1a7635fba,2011,,,1,SS Tiwary,TM Dilshan,28,15,3,1,0,16,10,3,0,11,5,0,1
6480bb9c8cbb5dec60b7d50a,2009/10,,,2,RG Sharma,TL Suman,28,26,1,1,1,18,11,1,1,9,15,0,0
6480bba1af51ddc81185931d,2014,,,2,F du Plessis,SK Raina,28,31,3,0,1,10,13,1,0,18,18,2,0
6480bba141bcb000fa6fe2a4,2015,,,1,AM Rahane,SV Samson,28,28,4,0,1,10,12,1,0,17,16,3,0
6480bba2c56d0ef7222ee3b8,2015,,,1,KD Karthik,SN Khan,28,16,4,0,1,9,7,1,0,17,9,3,0
6480bb942efd740a6ffc47df,2017,,,1,KA Pollard,RG Sharma,28,22,3,0,1,17,13,2,0,10,9,1,0
6480bb9a07d46704efe103ef,2007/08,,,1,DB Ravi Teja,Y Venugopal Rao,28,15,2,2,1,7,7,1,0,20,8,1,2
6480bb96f8379d02d3435ceb,2020/21,,,2,KM Jadhav,RA Jadeja,28,17,4,1,0,7,9,1,0,21,8,3,1
6480bb9834c7569d5fa64353,2022,,,2,JC Buttler,R Ashwin,28,19,3,2,1,20,11,3,1,8,8,0,1
6480bb9d69cb9046a72d8fbe,2009/10,,,2,A Symonds,B Sumanth,28,19,3,0,1,12,9,2,0,10,10,1,0
6480bba0b5eabeb0a150b93f,2013,,,2,AJ Finch,Yuvraj Singh,28,24,5,0,1,18,15,4,0,10,9,1,0
6480bb96e2809aa0bc35c7e9,2019,,,1,HH Pandya,Q de Kock,28,19,2,1,1,18,10,1,1,10,9,1,0
6480bb9a3d3f26063faa9f71,2007/08,,,2,MV Boucher,P Kumar,28,11,4,1,0,24,9,3,1,4,2,1,0
6480bb9ed74d222a3da56dfa,2012,,,1,HV Patel,R Vinay Kumar,28,22,1,1,1,10,9,1,0,14,13,0,1
6480bba26ca6ec72ba377236,2016,,,1,DA Warner,S Dhawan,28,22,4,0,1,16,11,2,0,11,11,2,0
6480bba0f401cc6b6bc6ed10,2013,,,2,DJG Sammy,NLTC Perera,28,10,1,3,1,15,5,0,2,11,5,1,1
6480bb9cc5312f3d7cfb650e,2009/10,,,2,JH Kallis,MK Pandey,28,26,3,0,1,9,10,1,0,18,16,2,0
6480bb9e502d7987de08e5d5,2012,,,1,MK Pandey,SC Ganguly,28,17,2,2,1,13,11,1,1,12,6,1,1
6480bb9aa030c8ebcbcc19c9,2007/08,,,1,SM Pollock,ST Jayasuriya,28,31,3,0,1,14,20,1,0,14,11,2,0
6480bb9b46b4360184dc19f3,2007/08,,,1,SB Bangar,Y Venugopal Rao,28,14,1,3,1,2,4,0,0,26,10,1,3
6480bb976344f6d667dfd965,2021,,,2,Shubman Gill,VR Iyer,28,27,2,1,1,13,12,0,1,14,15,2,0
6480bb9f022f0e8cd6e9cdeb,2012,,,1,UBT Chand,Y Venugopal Rao,28,16,4,1,1,17,9,2,1,11,7,2,0
6480bba1743abcb135a6a4c7,2015,,,1,AR Patel,DA Miller,28,27,3,1,1,4,6,0,0,23,21,3,1
6480bba23b270561e8026bd2,2015,,,1,KL Rahul,MC Henriques,28,23,3,0,1,19,16,2,0,6,7,1,0
6480bb9aded509be64de3bfb,2007/08,,,2,LR Shukla,Mohammad Hafeez,28,31,2,0,1,15,15,1,0,12,16,1,0
6480bb97aabcd4374e076d04,2021,,,2,F du Plessis,MM Ali,28,27,2,0,1,11,10,0,0,17,17,2,0
6480bb96c3293977af83acbf,2019,,,2,PP Shaw,S Dhawan,28,19,3,0,1,8,7,1,0,16,12,2,0
6480bb9e28b7a946a6921fa6,2011,,,1,AB de Villiers,SS Tiwary,28,23,0,1,0,18,11,0,1,8,12,0,0
6480bb9c1e676472f4841aa9,2009/10,,,1,JH Kallis,MK Pandey,28,29,5,0,1,19,17,4,0,8,12,1,0
6480bba286cca051953c976a,2015,,,1,MS Dhoni,SK Raina,28,19,3,1,1,12,10,0,1,14,9,3,0
6480bb950ddd55d8aed7d015,2019,,,1,RA Tripathi,SPD Smith,28,23,2,0,1,6,8,0,0,19,15,2,0
6480bb98de3641699db2c5a1,2021,,,1,F du Plessis,RD Gaikwad,28,16,3,0,1,10,8,2,0,7,8,1,0
6480bb983ad1bab18d1d8774,2022,,,1,CV Varun,UT Yadav,27,26,4,1,1,10,16,2,0,17,10,2,1
6480bb9abfe839459b1a28f6,2007/08,,,1,HH Gibbs,VVS Laxman,27,22,3,0,1,7,9,0,0,18,13,3,0
6480bb982f070b023b901b3e,2021,,,2,RR Pant,SS Iyer,27,25,3,0,1,19,19,3,0,7,6,0,0
6480bb9d1f9a3cf1fa86e11c,2011,,,2,SS Tiwary,V Kohli,27,27,2,0,1,7,10,0,0,19,17,2,0
6480bb9cb881721acc1bab60,2009,,,2,BB McCullum,SC Ganguly,27,27,2,1,1,20,18,1,1,5,9,1,0
6480bb9eb2690fb1ed356b42,2011,,,1,SR Tendulkar,TL Suman,27,25,1,2,1,10,12,1,0,14,13,0,2
6480bb9eb35365cccf73d55c,2011,,,1,CJ Ferguson,SC Ganguly,27,30,2,0,1,16,16,2,0,9,14,0,0
6480bb991a4f7e5f59dd1afc,2023,,,1,H Klaasen,HC Brook,27,11,3,1,0,16,6,2,1,10,5,1,0
6480bb9e713e850d3dd0cba9,2012,,,1,AL Menaria,OA Shah,27,15,4,1,1,10,8,2,0,17,7,2,1
6480bb9a596c087c0396ec2e,2007/08,,,1,AM Nayar,SM Pollock,27,12,2,2,1,10,5,0,1,17,7,2,1
6480bb9ee4565d108b29626f,2012,,,1,MEK Hussey,SK Raina,27,20,2,1,1,16,13,2,0,10,7,0,1
6480bba0404171e13faa181e,2013,,,1,G Gambhir,YK Pathan,27,8,3,2,1,6,2,0,1,19,6,3,1
6480bb9f00ef088221497043,2013,,,1,DB Das,MK Tiwary,27,28,0,2,1,19,15,0,2,8,13,0,0
6480bba0c3cc8c51bc6c1c3a,2013,,,1,R Dravid,SV Samson,27,23,4,0,1,3,7,0,0,22,16,4,0
6480bb960d5042aa46b7776b,2020/21,,,1,Q de Kock,SA Yadav,27,13,3,2,1,17,5,1,2,10,8,2,0
6480bb9a0474602f26069e45,2007/08,,,2,S Badrinath,SK Raina,27,18,5,0,1,15,14,3,0,11,4,2,0
6480bb97fb920d483d0da2af,2020/21,,,2,KL Rahul,N Pooran,27,14,1,3,1,0,4,0,0,25,10,1,3
6480bba01a3f8444c7a33ba6,2014,,,1,AM Rahane,SV Samson,27,23,1,2,1,11,10,1,0,16,13,0,2
6480bb99f649ea7a6d79892f,2023,,,2,HC Brook,MA Agarwal,27,23,6,0,1,13,14,3,0,14,9,3,0
6480bba2f05e90a9005771d2,2015,,,2,DJ Bravo,P Negi,27,22,2,1,1,12,11,1,0,15,11,1,1
6480bba2aecb4103bab63c15,2016,,,1,MS Dhoni,R Bhatia,27,11,2,1,0,22,10,2,1,1,1,0,0
6480bb977453ebef15f59e25,2021,,,1,AD Russell,KD Karthik,27,20,1,2,1,13,10,0,1,14,10,1,1
6480bb993e61058e682e2ff4,2023,,,1,B Sai Sudharsan,Shubman Gill,27,27,3,0,1,20,19,2,0,6,8,1,0
6480bb9c121ee402b7b2eda6,2009,,,1,LRPL Taylor,MK Pandey,27,16,4,1,1,1,4,0,0,26,12,4,1
6480bb995193664eda3e9e10,2022,,,1,AM Rahane,N Rana,27,28,3,0,1,16,14,2,0,10,14,1,0
6480bb9d5d93b08a19c16313,2009/10,,,2,AD Mathews,LR Shukla,27,15,0,2,1,4,5,0,0,17,10,0,2
6480bba140ee53a14fe06e0d,2014,,,2,DR Smith,SK Raina,27,20,3,0,1,6,9,0,0,19,11,3,0
6480bb98a95cb1650c81c926,2022,,,2,F du Plessis,RM Patidar,27,28,3,1,1,23,21,3,1,2,7,0,0
6480bb9eb35365cccf73d55c,2011,,,1,RV Uthappa,SC Ganguly,27,23,1,1,1,11,15,1,0,9,8,0,1
6480bba01a3f8444c7a33ba6,2014,,,2,M Manhas,RA Jadeja,27,22,2,0,1,10,10,1,0,12,12,1,0
6480bb9fd9db46138a9bb209,2013,,,2,AB de Villiers,KB Arun Karthik,27,13,2,1,1,22,8,2,1,5,5,0,0
6480bb9eee740f701b0ee154,2011,,,1,M Vijay,S Badrinath,27,29,3,0,1,13,14,1,0,14,15,2,0
6480bb975156c246a0ee40b1,2021,,,1,KD Karthik,Shakib Al Hasan,27,14,2,1,1,22,9,2,1,3,5,0,0
6480bb9fd26b695cee9d8761,2013,,,1,AJ Finch,Yuvraj Singh,27,30,1,1,1,14,16,1,0,12,14,0,1
6480bb9e1d754facf4fad618,2012,,,2,MK Pandey,SC Ganguly,27,15,3,1,1,13,6,0,1,14,9,3,0
6480bb98bd3ca4df44cf9d8f,2022,,,2,RR Pant,SN Thakur,27,9,1,3,1,19,7,1,2,7,2,0,1
6480bb9affc08d6384ac3992,2023,,,1,Abhishek Sharma,RA Tripathi,27,25,4,1,1,11,14,2,0,15,11,2,1
6480bb984f0f3dc0df6d4531,2022,,,2,B Sai Sudharsan,HH Pandya,27,18,3,1,1,14,11,1,1,12,7,2,0
6480bba11a59d64bb4aa66f4,2014,,,2,BJ Hodge,JP Faulkner,27,10,2,2,1,24,8,2,2,3,2,0,0
6480bb9e8dfd9ba30b93cbd8,2012,,,2,DJ Bravo,RA Jadeja,27,15,2,1,1,4,4,0,0,22,11,2,1
6480bb9bc74c35e494cec477,2007/08,,,2,AC Gilchrist,SB Styris,27,26,1,1,1,14,15,1,0,13,11,0,1
6480bb9d038ed22e46cbeccb,2011,,,1,A Mishra,DW Steyn,27,20,3,0,1,17,11,3,0,4,9,0,0
6480bb9a1032ce724214f6dd,2007/08,,,2,KD Karthik,Shoaib Malik,27,23,3,0,1,20,15,3,0,6,8,0,0
6480bba07fa24b891b818984,2013,,,2,AP Tare,AT Rayudu,27,20,2,2,1,22,12,2,2,5,8,0,0
6480bb9f895e5780080c8059,2012,,,2,DA Warner,Y Venugopal Rao,27,23,4,0,1,21,14,4,0,5,9,0,0
6480bb963c729ccbcb9446f8,2020/21,,,2,DA Warner,V Shankar,27,23,1,0,1,15,13,1,0,7,10,0,0
6480bb984a44a355b856fd1a,2022,,,1,SS Prabhudessai,Shahbaz Ahmed,27,25,2,0,1,14,15,1,0,5,10,1,0
6480bb9b17739118ee6c3bd0,2007/08,,,2,M Kaif,SR Watson,27,24,2,1,1,5,9,0,0,19,15,2,1
6480bba0bc196f7168b3d989,2013,,,1,MEK Hussey,WP Saha,27,23,2,1,1,9,5,1,0,18,18,1,1
6480bb9c37b72d7a51019794,2009/10,,,2,AA Jhunjhunwala,SR Watson,27,16,1,1,1,11,8,1,0,14,8,0,1
6480bb9bcf9df9e7ae0416ba,2009,,,2,GC Smith,NV Ojha,27,34,4,0,1,20,22,4,0,7,12,0,0
6480bb94ee669473878c11c2,2017,,,1,CR Woakes,SA Yadav,27,30,4,0,1,18,21,3,0,9,9,1,0
6480bb9d80536875f41bc605,2011,,,2,RG Sharma,TL Suman,27,20,1,2,1,7,12,0,0,20,8,1,2
6480bb969d80bbba2884b855,2020/21,,,2,Abhishek Sharma,JO Holder,27,10,1,3,1,6,2,0,1,19,8,1,2
6480bb9c4934a2adde9d76ce,2009/10,,,1,R Sathish,SR Tendulkar,27,16,3,0,0,21,11,3,0,6,5,0,0
6480bb9866dd8ba9b48863c2,2022,,,2,A Badoni,MP Stoinis,27,18,2,1,1,9,10,1,0,16,8,1,1
6480bb97af05ebd5c4f575c4,2021,,,1,Ishan Kishan,Q de Kock,27,32,1,0,1,8,14,0,0,17,18,1,0
6480bb97b97c36ac8be3582f,2021,,,1,GJ Maxwell,KA Jamieson,27,15,5,0,1,14,6,3,0,12,9,2,0
6480bba3caa5150f2db7a1dc,2016,,,2,AJ Finch,RA Jadeja,27,24,2,0,1,9,11,0,0,18,13,2,0
6480bb9b0b09749af4aa32dd,2009,,,1,DPMD Jayawardene,PP Chawla,27,16,2,1,0,21,10,2,1,3,6,0,0
6480bb9ab49fc97bbb30576f,2023,,,2,R Tewatia,Shubman Gill,27,10,0,3,0,4,5,0,0,19,5,0,3
6480bb99d43295fa2d82c9dc,2023,,,2,AR Patel,MK Pandey,27,21,3,0,1,21,14,3,0,5,7,0,0
6480bba35038a60ea566794a,2016,,,2,DA Warner,MC Henriques,27,18,5,0,1,15,12,3,0,11,6,2,0
6480bb98de3641699db2c5a1,2021,,,2,S Dhawan,SS Iyer,27,20,2,2,1,25,13,2,2,2,7,0,0
6480bb9a807eb5f39489408a,2023,,,2,AR Patel,RV Patel,27,20,2,1,1,21,12,2,1,4,8,0,0
6480bb9d91920239b62f48ad,2009/10,,,1,KP Pietersen,R Dravid,27,20,3,0,1,10,9,1,0,16,11,2,0
6480bb9b69f390d624466843,2007/08,,,1,LR Shukla,WP Saha,27,16,2,0,0,9,7,1,0,15,9,1,0
6480bb99efa58b95852be382,2023,,,2,Shubman Gill,V Shankar,27,17,2,1,1,12,5,1,1,13,12,1,0
6480bb9a58bc8710c38f4c1c,2023,,,2,C Green,TH David,27,15,0,2,0,4,6,0,0,17,9,0,2
6480bb94ca3c1b1eac5e8dd3,2018,,,2,AT Rayudu,SR Watson,27,22,3,1,1,11,8,2,0,16,14,1,1
6480bb946efcc4cd9aa80399,2018,,,1,Mandeep Singh,SN Khan,27,22,3,0,1,20,12,3,0,6,10,0,0
6480bb9d6919e7181371271f,2011,,,2,AM Nayar,Sunny Singh,27,15,5,0,1,10,9,2,0,12,6,3,0
6480bb932d6ccb8870dcd72d,2017,,,1,HM Amla,M Vohra,27,17,3,1,1,11,8,2,0,14,9,1,1
6480bba2563745309ee2bdfb,2016,,,2,DA Miller,M Vijay,27,26,2,0,1,13,14,1,0,13,12,1,0
6480bba0c1c8569f19cc70f0,2013,,,2,RV Uthappa,Yuvraj Singh,27,19,3,1,1,12,8,2,0,15,11,1,1
6480bb9552e25b3867e5c38a,2019,,,2,KM Jadhav,SK Raina,27,22,3,2,1,10,9,1,1,16,13,2,1
6480bba234aac105851964b1,2015,,,1,MS Dhoni,P Negi,27,14,1,1,1,11,8,1,0,12,6,0,1
6480bba0f858e6c12b25d8c3,2014,,,2,GJ Bailey,V Sehwag,27,24,3,0,1,11,15,1,0,16,9,2,0
6480bb9506d56930505d45ae,2019,,,2,CA Ingram,SS Iyer,27,20,4,0,1,19,9,4,0,6,11,0,0
6480bb9341152e168005ccc9,2017,,,1,AB de Villiers,V Kohli,27,22,3,1,1,13,11,1,1,14,11,2,0
6480bba107ba9f7f041862c1,2014,,,2,RV Uthappa,SA Yadav,27,25,2,0,1,17,12,2,0,8,13,0,0
6480bb950c59218964b27cc0,2018,,,1,JC Buttler,K Gowtham,27,17,3,1,1,18,11,3,0,8,6,0,1
6480bb9ddfb0f2f6f8e813e5,2011,,,1,BJ Hodge,RA Jadeja,27,21,3,0,1,13,11,1,0,14,10,2,0
6480bb9ee0795047740de5a7,2011,,,1,R Dravid,SR Watson,27,22,2,0,1,20,16,2,0,5,6,0,0
6480bba210201df0f7975000,2016,,,1,JC Buttler,RG Sharma,27,16,3,1,1,9,6,1,0,18,10,2,1
6480bb9480627b50308b7903,2017,,,1,Ishan Kishan,RA Jadeja,27,18,2,1,1,6,4,1,0,20,14,1,1
6480bb95f37ebb69ffb216e0,2019,,,2,PP Shaw,S Dhawan,27,16,4,1,1,11,8,2,0,16,8,2,1
6480bb9b52b93b56f5a16e52,2007/08,,,1,KD Karthik,TM Dilshan,27,21,4,0,1,10,12,1,0,15,9,3,0
6480bb9e21655ee16a96b2c3,2012,,,1,AB de Villiers,V Kohli,27,22,2,0,1,6,9,0,0,18,13,2,0
6480bb9d918bd358d046889d,2011,,,1,JR Hopes,NV Ojha,27,19,1,2,1,10,9,1,0,16,10,0,2
6480bba3ebbd8e4867dfa673,2016,,,1,CR Brathwaite,JP Duminy,27,13,1,3,1,20,8,0,3,7,5,1,0
6480bba1b8e3071cc513602a,2014,,,1,KK Nair,SV Samson,27,21,4,1,1,12,9,3,0,14,12,1,1
6480bb9814efd9a91e8c911f,2021,,,2,JD Unadkat,R Tewatia,27,14,4,1,1,6,5,1,0,21,9,3,1
6480bb981f136a7564719d7f,2022,,,1,Arshdeep Singh,RD Chahar,27,13,3,1,0,10,5,1,0,17,8,2,1
6480bb9ce93a7b4315d8fa30,2009,,,2,AB de Villiers,KD Karthik,27,19,4,0,1,18,10,3,0,8,9,1,0
6480bb9d038ed22e46cbeccb,2011,,,1,KC Sangakkara,S Dhawan,27,23,4,0,1,11,9,1,0,16,14,3,0
6480bb9e59fe7a0f48b7f9b9,2012,,,1,IK Pathan,V Sehwag,27,17,1,1,1,15,11,0,1,9,6,1,0
6480bb9b95eac8df5d0180b0,2007/08,,,2,JR Hopes,Yuvraj Singh,27,11,1,3,1,3,3,0,0,23,8,1,3
6480bb9516b0dbc1972e5c3c,2018,,,1,CA Lynn,KD Karthik,27,26,4,0,1,11,14,1,0,16,12,3,0
6480bb9c58b62383739c022e,2009,,,1,AM Nayar,SR Tendulkar,27,14,3,0,1,6,6,0,0,16,8,3,0
6480bb94351a8b10e20d14d9,2017,,,2,KD Karthik,RA Jadeja,27,12,2,1,0,18,6,2,1,7,6,0,0
6480bb98bd3ca4df44cf9d8f,2022,,,1,GJ Maxwell,V Kohli,27,23,5,0,1,19,12,4,0,8,11,1,0
6480bb96ec01f8fb3504bc36,2020/21,,,1,JC Buttler,SPD Smith,27,16,4,1,1,22,11,3,1,5,5,1,0
6480bba255079696d5cfa453,2015,,,1,AB de Villiers,SN Khan,27,14,3,1,0,15,7,2,1,11,7,1,0
6480bb9822eeb0c1c117f221,2021,,,1,AR Patel,PP Shaw,27,25,3,0,1,10,11,1,0,17,14,2,0
6480bb9894cc2d00f057a1f1,2021,,,1,SO Hetmyer,SS Iyer,27,20,0,2,1,17,10,0,2,7,10,0,0
6480bba3d3dc891a3092643e,2016,,,2,DA Miller,Gurkeerat Singh,27,11,1,3,1,3,3,0,0,24,8,1,3
6480bb96b56e8d513b451da1,2020/21,,,1,Kuldeep Yadav,LH Ferguson,27,26,2,0,1,8,10,1,0,19,16,1,0
6480bb9dfa7d0510ae3a7b40,2011,,,2,CL White,DT Christian,27,24,1,1,1,18,13,1,1,8,11,0,0
6480bb945460b25d997060fb,2018,,,1,CA Lynn,N Rana,27,20,1,2,1,5,7,0,0,22,13,1,2
6480bba22daffa649f339a05,2016,,,1,DJ Bravo,SK Raina,27,18,4,0,1,13,6,3,0,13,12,1,0
6480bb9cd0eb4289b2222e37,2009/10,,,2,MJ Lumb,NV Ojha,27,31,2,0,1,8,13,1,0,16,18,1,0
6480bb94b9d954a885cc531b,2017,,,2,MS Dhoni,SPD Smith,27,27,1,1,1,10,13,1,0,16,14,0,1
6480bb9a21e416835389fd53,2023,,,1,DP Conway,RA Jadeja,27,18,3,0,1,15,8,3,0,12,10,0,0
6480bba26ca6ec72ba377236,2016,,,2,KM Jadhav,Parvez Rasool,27,17,1,2,1,16,8,0,2,10,9,1,0
6480bb9e28b7a946a6921fa6,2011,,,2,RG Sharma,SR Tendulkar,27,17,4,0,1,4,6,0,0,22,11,4,0
6480bba19052ba503c5f7c27,2015,,,2,AM Rahane,STR Binny,27,24,3,0,1,17,13,3,0,10,11,0,0
6480bb990942cd416cf5f447,2022,,,1,HH Pandya,Shubman Gill,27,29,2,0,1,11,13,0,0,16,16,2,0
6480bb980b5b26e8c4335a4b,2022,,,1,LS Livingstone,S Dhawan,27,11,2,2,1,19,7,1,2,7,4,1,0
6480bb99409885bcc7b67109,2023,,,2,AM Rahane,RD Gaikwad,27,20,2,0,1,14,11,0,0,13,9,2,0
6480bb9b52b93b56f5a16e52,2007/08,,,2,SR Watson,YK Pathan,27,14,2,2,1,8,5,1,0,18,9,1,2
6480bba3caa5150f2db7a1dc,2016,,,1,DJ Hooda,S Dhawan,27,20,3,0,1,18,12,2,0,7,8,1,0
6480bba00be5cdbaf6648462,2013,,,2,M Vijay,MS Dhoni,27,13,2,2,1,21,10,1,2,6,3,1,0
6480bb9ee7a29c9b96ed61e5,2011,,,2,JP Duminy,S Dhawan,27,17,3,1,1,12,10,0,1,15,7,3,0
6480bb99bb362e3714226928,2022,,,1,JDS Neesham,R Parag,27,21,2,1,1,13,11,2,0,14,10,0,1
6480bba177ab201442a0e3c8,2015,,,1,AB de Villiers,SA Abbott,27,14,3,1,1,10,6,2,0,14,8,1,1
6480bb9ed74d222a3da56dfa,2012,,,1,DL Vettori,SS Tiwary,27,16,3,1,1,20,12,3,1,5,4,0,0
6480bba2db1e2def1b597ed3,2015,,,2,DA Miller,GJ Bailey,27,27,4,0,1,7,11,1,0,18,16,3,0
6480bba3412663673a969a24,2016,,,2,AM Rahane,NLTC Perera,27,14,2,2,1,13,6,1,1,14,8,1,1
6480bba26c6e47258e0c7d24,2015,,,2,JP Duminy,Yuvraj Singh,27,15,0,3,1,16,8,0,2,11,7,0,1
6480bb9ca21b98f1be8254e2,2009/10,,,2,JH Kallis,KP Pietersen,27,35,0,1,1,10,16,0,0,16,19,0,1
6480bb96c3293977af83acbf,2019,,,1,R Parag,S Gopal,27,36,2,0,1,15,22,2,0,12,14,0,0
6480bb9894cc2d00f057a1f1,2021,,,2,N Rana,Shubman Gill,27,22,0,2,1,13,12,0,1,14,10,0,1
6480bb99773871f8e2ddc4b1,2022,,,2,LS Livingstone,PN Mankad,27,7,3,2,0,22,6,2,2,4,1,1,0
6480bb95b1f28cf5bcf5e167,2018,,,2,F du Plessis,SN Thakur,27,8,4,1,0,11,3,1,1,15,5,3,0
6480bb94ce8e0a620532955b,2018,,,1,AT Rayudu,SR Watson,27,16,4,0,1,13,9,2,0,12,7,2,0
6480bba133267f04941acf7d,2014,,,1,NV Ojha,S Dhawan,27,25,4,0,1,9,12,1,0,15,13,3,0
6480bb958f737f809dfb65e1,2019,,,2,MK Pandey,V Shankar,27,30,1,0,1,10,13,0,0,15,17,1,0
6480bb9cafc843037dc1e863,2009,,,1,A Kumble,MV Boucher,27,16,2,1,0,7,6,1,0,19,10,1,1
6480bb9c21492b9a562c6f46,2009/10,,,2,BJ Hodge,SC Ganguly,27,21,3,0,1,9,8,1,0,17,13,2,0
6480bb97220be892fbfc2a36,2021,,,1,HH Pandya,RG Sharma,27,25,2,1,1,11,15,1,0,16,10,1,1
6480bba2704d23da78c3eb15,2016,,,1,AD Russell,YK Pathan,27,19,1,1,1,16,10,1,1,8,9,0,0
6480bb961ee814aee7b674ac,2020/21,,,1,K Rabada,MP Stoinis,27,6,3,2,1,0,0,0,0,25,6,3,2
6480bb99537b54b870dc74d1,2023,,,1,MW Short,PBB Rajapaksa,27,20,2,1,1,18,14,2,1,5,6,0,0
6480bb9c9e328ac30bcaf6b0,2009/10,,,1,M Vijay,ML Hayden,27,24,3,0,1,14,17,2,0,6,7,1,0
6480bb96fb897a6ff486ffe4,2020/21,,,1,AT Rayudu,SM Curran,27,27,2,1,1,12,14,2,0,14,13,0,1
6480bb9a7194d8b20952afae,2007/08,,,2,JH Kallis,MV Boucher,27,21,3,0,1,13,9,2,0,13,12,1,0
6480bb95945c5e5dc4d8c7d6,2019,,,2,MM Ali,PA Patel,27,20,3,1,1,13,7,1,1,14,13,2,0
6480bb9561509a2f4f139254,2019,,,1,HH Pandya,Q de Kock,27,13,2,1,1,11,5,0,1,15,8,2,0
6480bb99ed38bcb4025b8d86,2023,,,2,Akash Deep,DJ Willey,27,19,3,1,1,17,8,2,1,10,11,1,0
6480bb9574ca455ec008e942,2018,,,2,PP Chawla,Shubman Gill,27,21,2,1,1,12,12,0,1,14,9,2,0
6480bb977f55a1c473670850,2021,,,1,E Lewis,YBK Jaiswal,27,22,4,1,1,14,13,1,1,12,9,3,0
6480bba22daffa649f339a05,2016,,,2,AM Rahane,F du Plessis,27,23,5,0,1,21,17,4,0,6,6,1,0
6480bb98960cf9374ee9420d,2022,,,1,KL Rahul,Q de Kock,27,24,3,1,1,17,15,3,0,10,9,0,1
6480bb9abfe839459b1a28f6,2007/08,,,1,AC Gilchrist,VVS Laxman,27,20,4,0,1,6,6,0,0,21,14,4,0
6480bba2965d1d15aa6f723e,2016,,,1,CH Morris,P Negi,27,17,3,0,0,23,13,3,0,3,4,0,0
6480bb9a0a8baa96f94e8db9,2023,,,2,K Gowtham,MP Stoinis,27,22,1,2,1,22,12,1,2,5,10,0,0
6480bba17bce347084729c56,2015,,,2,GJ Bailey,MG Johnson,27,17,2,1,0,22,10,2,1,3,7,0,0
6480bb98291bb8b3f3e8145d,2022,,,2,AD Russell,Rasikh Salam,27,20,4,0,1,20,15,3,0,7,5,1,0
6480bb97ce981c1918dce924,2021,,,1,KA Pollard,SA Yadav,27,22,3,0,1,8,10,0,0,16,12,3,0
6480bb973d98bfd2d4a5f108,2020/21,,,1,AJ Finch,V Kohli,27,28,1,0,1,14,14,1,0,11,14,0,0
6480bb975156c246a0ee40b1,2021,,,2,Abdul Samad,MK Pandey,27,12,0,3,0,19,8,0,2,8,4,0,1
6480bb99bbae76f3f761d060,2023,,,2,AD Russell,RK Singh,27,13,3,1,1,9,6,0,1,15,7,3,0
6480bba21bbf76a62abea528,2016,,,2,KL Rahul,V Kohli,27,22,3,1,1,7,10,1,0,19,12,2,1
6480bba234aac105851964b1,2015,,,2,KD Karthik,SN Khan,27,17,4,0,1,10,7,2,0,16,10,2,0
6480bb95b98d000799e11963,2018,,,1,C de Grandhomme,Mandeep Singh,27,15,1,2,1,23,9,1,2,4,6,0,0
6480bb9be2940d96c1f903ca,2007/08,,,2,B Akhil,P Kumar,27,17,3,1,1,6,6,1,0,21,11,2,1
6480bb9d3ab782f83ce3e381,2011,,,1,CL White,S Dhawan,27,26,2,0,1,13,13,1,0,13,13,1,0
6480bb98f01e4672b988c112,2022,,,2,KH Pandya,Q de Kock,27,21,2,0,1,22,14,2,0,5,7,0,0
6480bba0f1ebf9ff255e1c91,2013,,,2,A Ashish Reddy,DJG Sammy,27,22,2,0,1,14,11,1,0,12,11,1,0
6480bba000b91f6c5cf57fdb,2013,,,2,KK Cooper,PV Tambe,27,15,3,1,1,24,10,3,1,2,5,0,0
6480bba10e78f50f124b406a,2015,,,1,D Wiese,V Kohli,26,16,2,1,1,4,4,0,0,22,12,2,1
6480bb976344f6d667dfd965,2021,,,2,N Rana,SP Narine,26,14,1,2,1,2,4,0,0,21,10,1,2
6480bb99efa58b95852be382,2023,,,2,R Tewatia,Rashid Khan,26,8,2,2,0,11,5,1,1,10,3,1,1
6480bba2e3610f863b52b887,2016,,,1,AP Tare,S Dhawan,26,26,2,0,1,8,14,1,0,14,12,1,0
6480bb9cc5312f3d7cfb650e,2009/10,,,2,KP Pietersen,MK Pandey,26,17,4,0,1,15,8,3,0,11,9,1,0
6480bba09d6b23c8722fd208,2013,,,2,AT Rayudu,KA Pollard,26,17,1,2,1,5,5,0,0,21,12,1,2
6480bb9b4b74852492343291,2007/08,,,2,MF Maharoof,S Dhawan,26,17,2,2,0,13,8,1,1,12,9,1,1
6480bb9993e6e474a4e37366,2023,,,1,HR Shokeen,PP Chawla,26,18,3,0,0,17,12,3,0,5,6,0,0
6480bb9e8dfd9ba30b93cbd8,2012,,,2,MS Dhoni,RA Jadeja,26,15,1,2,1,7,9,0,0,18,6,1,2
6480bb9dc4ec5a52f8bcc465,2009/10,,,2,JP Duminy,R Sathish,26,24,1,0,1,6,7,0,0,20,17,1,0
6480bb9cd6fe6fad0d6efbd9,2009/10,,,1,A Uniyal,AA Jhunjhunwala,26,17,4,0,0,4,6,0,0,21,11,4,0
6480bb9efe3f9991539e7f6c,2012,,,2,M Manhas,RV Uthappa,26,22,3,0,1,19,16,3,0,6,6,0,0
6480bb982fc21d541267f7b9,2022,,,1,DP Conway,RV Uthappa,26,22,2,2,1,3,8,0,0,22,14,2,2
6480bb98634dba60191637ad,2021,,,1,KL Rahul,MA Agarwal,26,25,3,0,1,21,21,3,0,5,4,0,0
6480bb9763013a01eae041f2,2020/21,,,2,Abdul Samad,Abhishek Sharma,26,16,1,2,1,20,9,1,2,5,7,0,0
6480bb9baa08d0494c0b8dc3,2007/08,,,2,CL White,JH Kallis,26,34,3,0,1,10,16,1,0,13,18,2,0
6480bb9bb7a4f1e16df25c8e,2009,,,1,JA Morkel,JDP Oram,26,23,2,1,1,13,7,1,1,13,16,1,0
6480bb9a6a7169d0e413bcfa,2023,,,2,DJ Hooda,Q de Kock,26,24,0,1,1,11,11,0,0,15,13,0,1
6480bb9809c62ba77e5df472,2021,,,2,N Rana,VR Iyer,26,24,1,1,1,17,13,1,1,8,11,0,0
6480bb981dc3f7250f93bc92,2022,,,2,AR Patel,R Powell,26,19,1,1,1,17,11,0,1,8,8,1,0
6480bb9d03ce4b87b32b91f5,2009/10,,,1,RG Sharma,TL Suman,26,37,2,0,1,8,15,0,0,18,22,2,0
6480bba388682c5ca10ff37a,2016,,,1,AB de Villiers,V Kohli,26,14,2,1,1,4,4,0,0,22,10,2,1
6480bb9d22388e966342dba8,2009/10,,,2,AT Rayudu,SR Tendulkar,26,14,2,1,1,13,5,1,1,11,9,1,0
6480bb95af5853799812b0f6,2019,,,1,DA Warner,V Shankar,26,19,0,2,1,11,10,0,1,14,9,0,1
6480bb9b283b30d0503656f7,2007/08,,,1,MF Maharoof,S Dhawan,26,15,1,2,1,19,11,0,2,5,4,1,0
6480bb96edb3270eba0af1d4,2020/21,,,1,V Kohli,Washington Sundar,26,22,0,2,1,16,12,0,1,10,10,0,1
6480bba03ef1ed797291b091,2013,,,1,DR Smith,SR Tendulkar,26,21,4,0,1,21,17,4,0,4,4,0,0
6480bba0587190387a754733,2013,,,2,CA Pujara,V Kohli,26,19,5,0,1,15,12,3,0,9,7,2,0
6480bb9df46e9f48932124df,2009/10,,,2,A Mishra,AB McDonald,26,31,0,0,1,12,17,0,0,13,14,0,0
6480bba0da054e3d917f71fb,2013,,,1,R Dravid,SR Watson,26,28,2,1,1,13,17,1,0,13,11,1,1
6480bb9e30b7f3c09cfbdabb,2011,,,1,BB McCullum,DPMD Jayawardene,26,11,2,2,1,17,8,1,2,6,3,1,0
6480bba1827557ebdfc70821,2015,,,2,G Gambhir,SA Yadav,26,14,2,2,1,3,4,0,0,23,10,2,2
6480bb9e59fe7a0f48b7f9b9,2012,,,2,JD Ryder,RV Uthappa,26,23,3,1,1,14,10,1,1,10,13,2,0
6480bb99ed38bcb4025b8d86,2023,,,1,Rahmanullah Gurbaz,VR Iyer,26,20,3,0,1,13,13,3,0,3,7,0,0
6480bba0120becd670aec59d,2013,,,1,RV Uthappa,TL Suman,26,25,3,0,1,14,11,2,0,11,14,1,0
6480bba34d78f594b07da1bc,2016,,,2,HM Amla,WP Saha,26,12,5,0,1,2,2,0,0,24,10,5,0
6480bba2a01f4062fc561247,2016,,,1,M Vijay,SE Marsh,26,25,3,0,1,14,12,2,0,12,13,1,0
6480bb98b8bb5b0d2c2f0848,2022,,,1,KA Pollard,Tilak Varma,26,17,2,1,1,14,9,1,1,10,8,1,0
6480bb964592640608a9163c,2020/21,,,1,KS Williamson,MK Pandey,26,18,2,1,1,3,5,0,0,23,13,2,1
6480bb97b945155c90dccd3d,2021,,,2,RA Jadeja,SM Curran,26,10,2,2,1,22,6,2,2,4,4,0,0
6480bb9a0a8baa96f94e8db9,2023,,,2,A Mishra,Naveen-ul-Haq,26,25,3,0,1,9,12,1,0,13,13,2,0
6480bb9c71030f4c6f018f55,2009,,,2,KC Sangakkara,Yuvraj Singh,26,27,2,1,1,7,11,0,0,19,16,2,1
6480bb9aef150645306cc170,2023,,,1,Abhishek Sharma,H Klaasen,26,12,3,1,1,10,5,2,0,13,7,1,1
6480bb9f79be50f1621abcc6,2012,,,1,DJ Hussey,SE Marsh,26,12,5,1,1,8,6,2,0,18,6,3,1
6480bba1d21281c7385d5ce4,2014,,,1,AB de Villiers,JA Morkel,26,10,0,3,1,7,2,0,1,16,8,0,2
6480bb9fe489b0d429e97599,2012,,,1,AB de Villiers,MA Agarwal,26,10,2,2,1,7,4,1,0,18,6,1,2
6480bb9ab34d149420eae546,2023,,,2,RK Singh,Rahmanullah Gurbaz,26,22,1,0,1,16,14,1,0,7,8,0,0
6480bb9f02801d2090cdba0d,2012,,,2,KD Karthik,SL Malinga,26,22,2,1,1,10,8,1,0,14,14,1,1
6480bb9399a527d39bc17dad,2017,,,1,AJ Tye,Ishan Kishan,26,12,2,2,1,5,5,0,0,20,7,2,2
6480bb9f146f5849bb759148,2013,,,1,GH Vihari,NLTC Perera,26,21,1,1,1,5,7,0,0,21,14,1,1
6480bb9359a2cade3b5213d3,2017,,,2,KA Pollard,N Rana,26,32,1,1,1,14,16,0,1,11,16,1,0
6480bb9814efd9a91e8c911f,2021,,,1,EJG Morgan,KD Karthik,26,17,1,1,0,13,11,1,1,4,6,0,0
6480bb9a07d46704efe103ef,2007/08,,,2,JH Kallis,Misbah-ul-Haq,26,26,4,0,1,16,14,3,0,8,12,1,0
6480bba0fbf5f1671e1e557e,2013,,,1,DJ Hussey,Gurkeerat Singh,26,20,4,0,1,8,7,1,0,18,13,3,0
6480bb9553f3fc8903579544,2018,,,1,BCJ Cutting,KH Pandya,26,9,1,3,1,23,8,1,3,2,1,0,0
6480bb96fb897a6ff486ffe4,2020/21,,,2,BA Stokes,RV Uthappa,26,18,3,0,1,19,11,3,0,2,7,0,0
6480bb97752fcb9cd9f23692,2021,,,2,R Tewatia,SV Samson,26,11,3,1,1,2,4,0,0,22,7,3,1
6480bb9d59f2ded94f736145,2011,,,1,R Vinay Kumar,RA Jadeja,26,30,2,0,1,17,16,2,0,7,14,0,0
6480bb95014388d3e8c62904,2019,,,1,MP Stoinis,V Kohli,26,28,0,1,1,15,17,0,1,11,11,0,0
6480bb9d76ba2d9dd45c74a8,2011,,,2,DPMD Jayawardene,VVS Laxman,26,21,3,0,1,12,11,2,0,8,10,1,0
6480bb94aa9b082aa58a3822,2017,,,2,CJ Anderson,K Rabada,26,33,1,1,1,14,17,0,1,11,16,1,0
6480bb9d716a89dbf5e486d0,2011,,,1,AG Paunikar,R Dravid,26,20,3,0,1,5,8,1,0,11,12,2,0
6480bb9c9f9d5376b4227724,2009/10,,,2,A Symonds,TL Suman,26,25,1,0,1,16,16,1,0,9,9,0,0
6480bb9c266a85f1960d87e9,2009,,,1,AB de Villiers,TM Dilshan,26,23,2,0,1,11,11,1,0,8,12,1,0
6480bb99ecbdaaf953b8eee5,2023,,,2,A Badoni,N Pooran,26,16,0,2,1,10,7,0,0,15,9,0,2
6480bba0295edd6084b9503b,2014,,,1,DJG Sammy,KL Rahul,26,22,1,1,1,6,10,0,0,18,12,1,1
6480bb99d2bd76016d47896d,2023,,,2,AR Patel,Kuldeep Yadav,26,19,1,1,1,15,9,1,1,6,10,0,0
6480bb94283e3f5a1a95839f,2018,,,1,AT Rayudu,SR Watson,26,26,2,1,1,14,15,1,1,12,11,1,0
6480bb9fc28e897b3c53f359,2012,,,2,KA Pollard,SL Malinga,26,23,2,1,1,14,13,1,1,8,10,1,0
6480bb9c7a11e1cbeea46b0e,2009/10,,,2,AA Jhunjhunwala,YK Pathan,26,17,1,2,1,12,6,1,1,14,11,0,1
6480bb94d8ce46258c13e90e,2017,,,1,KV Sharma,RG Sharma,26,19,3,1,1,11,10,0,1,15,9,3,0
6480bb95ff5da0069bc5274e,2018,,,2,AJ Finch,AR Patel,26,18,2,1,1,6,7,0,0,19,11,2,1
6480bb96a43476c5d9a56c4e,2020/21,,,2,AR Patel,S Dhawan,26,10,0,3,0,21,5,0,3,3,5,0,0
6480bba0a4e7c61a5656729e,2014,,,2,JA Morkel,Yuvraj Singh,26,24,1,1,1,15,14,0,1,10,10,1,0
6480bb96e29253678ca02869,2020/21,,,1,GJ Maxwell,SN Khan,26,16,3,0,0,11,7,1,0,14,9,2,0
6480bb951677500061c85592,2019,,,2,DJ Hooda,Mohammad Nabi,26,26,1,1,1,12,14,1,0,11,12,0,1
6480bb9a3d3f26063faa9f71,2007/08,,,1,DJ Hussey,SC Ganguly,26,24,2,1,1,12,7,1,1,14,17,1,0
6480bb9f36da1a646c80be45,2013,,,1,AT Rayudu,RG Sharma,26,10,2,2,1,24,8,2,2,2,2,0,0
6480bb9b8860198955e581d8,2007/08,,,1,JA Morkel,MS Dhoni,26,15,1,1,0,7,6,0,0,16,9,1,1
6480bb9a6e44b0c8da00ca72,2007/08,,,1,KC Sangakkara,Yuvraj Singh,26,17,1,1,1,8,8,0,0,18,9,1,1
6480bb94fc240a33621b10a6,2018,,,1,KD Karthik,Shubman Gill,26,12,4,0,1,11,6,2,0,12,6,2,0
6480bb96a43476c5d9a56c4e,2020/21,,,2,AM Rahane,S Dhawan,26,23,4,0,1,8,10,1,0,18,13,3,0
6480bba119569fcc2d7859a4,2014,,,1,DA Warner,NV Ojha,26,22,0,2,1,13,10,0,1,12,12,0,1
6480bb99fe078839da40e7ab,2023,,,2,DA Warner,MK Pandey,26,30,2,0,1,12,14,1,0,13,16,1,0
6480bba20130c44ed20c9bcf,2016,,,2,AD Nath,AJ Finch,26,23,1,1,1,12,11,1,0,14,12,0,1
6480bb9993e6e474a4e37366,2023,,,1,C Green,Ishan Kishan,26,16,3,0,1,9,6,1,0,17,10,2,0
6480bba1af9481df8b4f9f0f,2015,,,2,CH Gayle,DJG Sammy,26,22,0,2,1,19,13,0,2,7,9,0,0
6480bba154ce29a67e4752df,2015,,,1,CH Gayle,MS Bisla,26,31,3,1,1,3,15,0,0,20,16,3,1
6480bb9993e6e474a4e37366,2023,,,1,TH David,Tilak Varma,26,23,1,1,1,8,9,0,0,16,14,1,1
6480bba29fb420d92aef1d2a,2015,,,2,EJG Morgan,MC Henriques,26,20,1,2,1,5,11,0,0,21,9,1,2
6480bb9c50838010977c168c,2009,,,2,LA Pomersbach,SM Katich,26,30,2,1,1,20,19,1,1,6,11,1,0
6480bba3de527604cd2f96f3,2016,,,2,B Kumar,NV Ojha,26,15,2,1,1,13,7,2,0,12,8,0,1
6480bb9623a26d3fbfe59f25,2020/21,,,2,S Dube,Washington Sundar,26,28,1,1,1,12,12,0,1,13,16,1,0
6480bba07b5396a7b65684d3,2013,,,1,KD Karthik,MG Johnson,26,9,1,2,0,10,3,1,1,10,6,0,1
6480bb9a6935abf34d88ca97,2007/08,,,2,ML Hayden,PA Patel,26,17,5,0,1,9,7,2,0,15,10,3,0
6480bb9f36ad55c3c7fd6548,2012,,,1,HH Gibbs,SR Tendulkar,26,36,3,0,1,13,24,1,0,11,12,2,0
6480bb9c37b72d7a51019794,2009/10,,,1,AC Gilchrist,VVS Laxman,26,15,3,1,1,16,6,2,1,6,9,1,0
6480bb95481ab7c06b86419b,2018,,,1,RR Pant,V Shankar,26,5,2,3,0,26,5,2,3,0,0,0,0
6480bb9bdde9db92f880e40d,2007/08,,,2,KC Sangakkara,Yuvraj Singh,26,14,2,2,1,19,10,2,1,7,4,0,1
6480bb93d9581d69657887c3,2017,,,1,CH Gayle,SR Watson,26,20,5,0,1,6,8,1,0,18,12,4,0
6480bba2d324f0342e6af689,2016,,,1,RA Jadeja,SK Raina,26,22,1,0,1,14,14,0,0,10,8,1,0
6480bba2c04b3acd88a50839,2015,,,1,PP Chawla,YK Pathan,26,19,1,2,1,10,9,0,1,13,10,1,1
6480bb996c324f07ab7f763c,2023,,,2,RK Singh,VR Iyer,26,16,3,1,1,3,6,0,0,22,10,3,1
6480bb974e2f8e7f41c506dc,2021,,,2,KA Pollard,Q de Kock,26,11,3,1,0,16,8,2,1,6,3,1,0
6480bb9800ba03eb1f9437d2,2022,,,1,Abhishek Sharma,KS Williamson,26,17,3,0,1,10,9,2,0,5,8,1,0
6480bba1ece63aa1c77a954e,2015,,,2,DJ Bravo,DR Smith,26,17,2,1,1,8,8,1,0,18,9,1,1
6480bb9b17739118ee6c3bd0,2007/08,,,2,GC Smith,Sohail Tanvir,26,20,3,1,1,13,12,2,0,13,8,1,1
6480bba1bd00c57fb3301f04,2014,,,1,MK Pandey,Shakib Al Hasan,26,12,3,1,1,13,5,1,1,12,7,2,0
6480bb938ed49c6d5c211429,2017,,,2,Bipul Sharma,NV Ojha,26,17,2,1,0,21,14,2,1,4,3,0,0
6480bb9a40966b9b90fcdf2e,2023,,,2,JJ Roy,N Rana,26,16,5,0,1,17,8,4,0,9,8,1,0
6480bb9d109617dfa089c2c6,2011,,,1,AG Paunikar,R Dravid,26,27,4,0,1,9,15,2,0,12,12,2,0
6480bb950c59218964b27cc0,2018,,,2,AD Nath,KL Rahul,26,32,3,0,1,9,13,1,0,17,19,2,0
6480bba19701e99975ce7c59,2015,,,1,KK Nair,SPD Smith,26,25,0,1,1,16,14,0,1,10,11,0,0
6480bb9a6e44b0c8da00ca72,2007/08,,,2,SM Pollock,SS Tiwary,26,19,2,2,1,13,11,1,1,13,8,1,1
6480bb97aa725a640d0f8e2f,2021,,,2,AB de Villiers,GJ Maxwell,26,7,4,1,0,4,1,1,0,22,6,3,1
6480bb9c6f1c8ea3dc73226f,2009/10,,,1,A Mishra,MF Maharoof,26,13,2,2,1,2,2,0,0,24,11,2,2
6480bba3412663673a969a24,2016,,,2,AM Rahane,UT Khawaja,26,14,4,1,1,10,8,2,0,16,6,2,1
6480bb93ec7e3351941d3b5b,2017,,,2,SR Watson,STR Binny,26,19,1,2,1,15,9,1,1,11,10,0,1
6480bb953aab41e7ed166b9d,2019,,,1,KMA Paul,RR Pant,26,10,2,2,1,3,5,0,0,21,5,2,2
6480bba3caa5150f2db7a1dc,2016,,,1,DA Warner,S Dhawan,26,19,1,2,1,24,17,1,2,1,2,0,0
6480bb9e692eaa193a417426,2012,,,1,AB de Villiers,MA Agarwal,26,25,1,1,1,10,10,0,0,16,15,1,1
6480bb99f816e64203e3c687,2023,,,1,JM Sharma,S Dhawan,26,15,1,2,1,21,11,1,2,4,4,0,0
6480bb9f60d58ee39ba047b9,2013,,,1,DPMD Jayawardene,V Sehwag,26,23,3,1,1,12,14,1,1,12,9,2,0
6480bb950ddd55d8aed7d015,2019,,,2,RV Uthappa,Shubman Gill,26,18,0,2,0,15,8,0,2,6,10,0,0
6480bb994877788ec5b187ff,2023,,,1,MM Ali,RA Jadeja,26,14,0,2,1,11,6,0,1,10,8,0,1
6480bba1de7febd9f1f0138e,2014,,,2,AM Rahane,SR Watson,26,17,1,2,1,4,7,0,0,22,10,1,2
6480bb94cb5adf24f5ad15c3,2017,,,1,KH Pandya,PA Patel,26,20,2,0,1,15,11,2,0,6,9,0,0
6480bb9f146f5849bb759148,2013,,,1,KC Sangakkara,PA Reddy,26,27,3,0,1,15,16,2,0,11,11,1,0
6480bb9525ace33768e8b671,2019,,,2,DJ Hooda,JM Bairstow,26,26,1,0,1,13,16,1,0,11,10,0,0
6480bb99bb362e3714226928,2022,,,1,R Ashwin,TA Boult,26,14,3,0,0,9,5,1,0,17,9,2,0
6480bb9b7b8617115de9683b,2007/08,,,2,PA Patel,SP Fleming,26,20,5,0,1,10,11,2,0,14,9,3,0
6480bb9f9a70ecf3467829df,2013,,,2,BJ Hodge,STR Binny,26,15,2,1,0,9,6,1,0,16,9,1,1
6480bb945f95e767a8a9cc10,2017,,,2,KD Karthik,RA Jadeja,26,19,3,0,1,6,7,0,0,19,12,3,0
6480bba0e883438915efc1e6,2013,,,1,B Kumar,KW Richardson,26,26,1,1,1,17,19,1,1,8,7,0,0
6480bb9ab83a3072124dda22,2023,,,1,AK Markram,Anmolpreet Singh,26,19,3,1,1,15,9,1,1,11,10,2,0
6480bba03a099a1a2e9c3dc5,2013,,,1,Azhar Mahmood,SE Marsh,26,24,2,0,1,9,13,1,0,13,11,1,0
6480bb9ec07aa72ec89917f0,2012,,,2,F du Plessis,SK Raina,26,18,3,1,1,15,11,3,0,9,7,0,1
6480bb95d4da0397e79acffa,2019,,,2,CH Gayle,MA Agarwal,26,16,4,1,1,10,8,1,1,14,8,3,0
6480bb9619eaed447b2a05d4,2020/21,,,1,Gurkeerat Singh,Washington Sundar,26,16,3,0,0,14,10,2,0,10,6,1,0
6480bb99bb362e3714226928,2022,,,1,D Padikkal,YBK Jaiswal,26,15,4,1,1,24,10,4,1,2,5,0,0
6480bb988b447f26d7a96c0c,2022,,,2,FA Allen,KA Pollard,26,13,2,2,1,8,7,1,0,18,6,1,2
6480bb9541caaeddc9ddaac3,2019,,,2,BA Stokes,K Gowtham,26,17,0,2,1,17,9,0,1,9,8,0,1
6480bb9834c7569d5fa64353,2022,,,2,R Parag,SO Hetmyer,26,14,3,1,1,5,6,1,0,20,8,2,1
6480bb9435048f20502ba1e1,2018,,,2,JP Duminy,KA Pollard,26,23,1,0,1,4,10,0,0,13,13,1,0
6480bb9a596c087c0396ec2e,2007/08,,,1,RV Uthappa,ST Jayasuriya,26,12,4,1,1,3,3,0,0,22,9,4,1
6480bb9c757dbd7f92b1130a,2009/10,,,2,R McLaren,SR Tendulkar,26,21,3,0,1,11,11,1,0,14,10,2,0
6480bba0e883438915efc1e6,2013,,,1,AJ Finch,RV Uthappa,26,18,2,2,1,15,9,2,1,9,9,0,1
6480bb9b69f8ace7659e486d,2009,,,2,RA Jadeja,RJ Quiney,26,24,3,0,1,8,13,0,0,16,11,3,0
6480bb9f70156528a31bb270,2013,,,2,KD Karthik,RG Sharma,26,23,3,0,1,15,12,2,0,11,11,1,0
6480bb9bfcaabf33b5687e32,2007/08,,,2,RR Raje,YV Takawale,26,9,4,1,0,1,2,0,0,24,7,4,1
6480bba0d2cdb40c68c4739c,2013,,,1,MM Sharma,MS Dhoni,26,14,2,2,0,0,2,0,0,23,12,2,2
6480bb9c37b72d7a51019794,2009/10,,,1,Anirudh Singh,RG Sharma,26,22,3,1,1,9,12,1,0,17,10,2,1
6480bba3caa5150f2db7a1dc,2016,,,1,S Dhawan,Yuvraj Singh,26,28,3,0,1,21,14,3,0,5,14,0,0
6480bb9836af59f8283f4081,2022,,,1,D Padikkal,JC Buttler,26,27,4,0,1,15,15,3,0,10,12,1,0
6480bb94fbd0b904d63e0e07,2017,,,1,M Vohra,MJ Guptill,26,14,4,1,1,3,3,0,0,23,11,4,1
6480bb99f33a7dd80eb0a544,2023,,,2,JM Sharma,SM Curran,26,12,2,1,1,11,6,0,1,11,6,2,0
6480bba3de527604cd2f96f3,2016,,,1,CR Brathwaite,KK Nair,26,13,2,2,1,10,7,2,0,13,6,0,2
6480bb9cdf6c63fec90a42df,2009/10,,,1,SC Ganguly,WP Saha,26,21,5,0,1,2,8,0,0,22,13,5,0
6480bba2c04b3acd88a50839,2015,,,2,JP Duminy,KM Jadhav,25,14,1,2,1,15,8,1,1,10,6,0,1
6480bba1017a98eead1ec861,2015,,,1,AM Rahane,KK Nair,25,13,3,0,1,8,6,1,0,16,7,2,0
6480bb9498a98d52f9285b52,2017,,,1,DA Warner,S Dhawan,25,25,2,1,1,6,13,0,0,19,12,2,1
6480bb9b09e6c98206422ae5,2009,,,1,BB McCullum,CH Gayle,25,24,1,2,1,3,9,0,0,20,15,1,2
6480bb97f56e9d700b27a098,2021,,,1,AB de Villiers,Washington Sundar,25,19,1,1,1,19,10,1,1,6,9,0,0
6480bb9b72f6a46338302131,2009,,,1,AC Gilchrist,RG Sharma,25,25,0,2,1,13,14,0,1,12,11,0,1
6480bba2f3ed8323f852acfa,2016,,,1,EJG Morgan,S Dhawan,25,24,3,0,1,8,8,1,0,17,16,2,0
6480bb98c0ad46409044aad2,2022,,,1,DJ Bravo,RA Jadeja,25,12,2,1,1,8,5,1,0,13,7,1,1
6480bb9765a785922ad360fe,2021,,,1,Abdul Samad,Rashid Khan,25,20,2,1,1,13,7,1,1,11,13,1,0
6480bb9b2de4e62ee60b7e5c,2009,,,1,JH Kallis,R Dravid,25,29,2,0,1,15,16,2,0,10,13,0,0
6480bb9ddfb0f2f6f8e813e5,2011,,,1,R Vinay Kumar,RA Jadeja,25,16,1,2,1,11,8,0,1,14,8,1,1
6480bba0c63a6317296391b7,2013,,,1,AP Tare,GJ Maxwell,25,20,0,3,1,2,3,0,0,23,17,0,3
6480bba136257b71aa9952cf,2014,,,1,MS Dhoni,R Ashwin,25,24,0,1,1,14,13,0,1,10,11,0,0
6480bba0d4b2f9be71a5f230,2014,,,1,Shakib Al Hasan,YK Pathan,25,16,3,0,1,13,8,2,0,11,8,1,0
6480bba19052ba503c5f7c27,2015,,,1,DA Warner,S Dhawan,25,24,5,0,1,14,12,3,0,10,12,2,0
6480bb9480627b50308b7903,2017,,,1,Ishan Kishan,SK Raina,25,14,4,1,1,24,11,4,1,1,3,0,0
6480bba326249b668a4713d6,2016,,,2,BB McCullum,SK Raina,25,14,2,2,1,19,9,1,2,6,5,1,0
6480bb9f70156528a31bb270,2013,,,1,CH Gayle,V Kohli,25,15,4,1,1,0,1,0,0,24,14,4,1
6480bb99e520ec7a66b73adb,2022,,,2,Ishan Kishan,RG Sharma,25,32,2,2,1,22,19,2,2,2,13,0,0
6480bb99ecbdaaf953b8eee5,2023,,,1,AT Rayudu,RA Jadeja,25,13,1,2,1,20,7,1,2,3,6,0,0
6480bb9d80e97e178e5f68de,2011,,,2,LR Shukla,MK Tiwary,25,13,2,2,1,12,8,2,0,13,5,0,2
6480bb987c720def5fbaf218,2022,,,2,JD Unadkat,SA Yadav,25,15,1,2,1,4,4,0,0,21,11,1,2
6480bb9a8053274c083224d9,2023,,,2,DP Conway,S Dube,25,22,0,2,1,7,8,0,0,18,14,0,2
6480bb98c0ad46409044aad2,2022,,,1,RD Gaikwad,RV Uthappa,25,19,3,0,1,10,8,2,0,15,11,1,0
6480bb94d8aa9021808a4760,2017,,,1,DA Warner,S Dhawan,25,26,3,0,1,13,13,2,0,11,13,1,0
6480bb9c8cbb5dec60b7d50a,2009/10,,,2,RG Sharma,WPUJC Vaas,25,27,0,1,1,15,14,0,1,8,13,0,0
6480bb9db9ed29ce1ee8764f,2011,,,2,AC Gilchrist,PC Valthaty,25,23,1,3,1,10,13,1,1,14,10,0,2
6480bb95d675b7da24db1a57,2019,,,2,S Dhawan,SS Iyer,25,16,5,0,1,19,10,4,0,6,6,1,0
6480bb984f0f3dc0df6d4531,2022,,,1,Ishan Kishan,SA Yadav,25,18,0,2,1,12,7,0,1,13,11,0,1
6480bb977453ebef15f59e25,2021,,,1,N Rana,Shubman Gill,25,22,2,1,1,15,12,1,1,10,10,1,0
6480bba2f05e90a9005771d2,2015,,,1,EJG Morgan,GH Vihari,25,14,2,1,1,17,9,1,1,8,5,1,0
6480bb9836af59f8283f4081,2022,,,1,R Ashwin,SO Hetmyer,25,12,3,1,1,21,9,3,1,3,3,0,0
6480bb971ffe5345804e7f32,2020/21,,,2,R Tewatia,RV Uthappa,25,25,2,0,1,9,11,1,0,14,14,1,0
6480bba1d21281c7385d5ce4,2014,,,2,DA Miller,GJ Maxwell,25,12,1,2,1,5,4,0,0,19,8,1,2
6480bb9a4de9fe3e7319ce39,2007/08,,,2,GC Smith,YK Pathan,25,16,5,0,1,4,4,0,0,21,12,5,0
6480bb93575636076d81e4c5,2017,,,1,DA Warner,S Dhawan,25,30,1,0,1,5,15,0,0,15,15,1,0
6480bb9825eb960aded1ff64,2022,,,1,MM Ali,RD Gaikwad,25,18,3,1,1,1,3,0,0,22,15,3,1
6480bb9e565ef5f11c5c8f55,2011,,,1,AC Gilchrist,PC Valthaty,25,23,2,1,1,1,6,0,0,20,17,2,1
6480bb973d64aa91e60b4088,2021,,,1,F du Plessis,RD Gaikwad,25,23,2,1,1,15,10,1,1,10,13,1,0
6480bb9e34659755628e7471,2012,,,2,Bipul Sharma,JP Faulkner,25,14,2,1,1,21,10,2,1,3,4,0,0
6480bb9fe3bc767415c60bfa,2012,,,1,DPMD Jayawardene,Y Venugopal Rao,25,26,2,0,1,14,12,2,0,10,14,0,0
6480bb9908b154f78b12b8fb,2023,,,2,DJ Willey,Vijaykumar Vyshak,25,15,1,1,0,9,7,1,0,13,8,0,1
6480bb954e496ec9b12aa120,2019,,,1,JC Archer,S Gopal,25,10,3,1,0,6,3,1,0,19,7,2,1
6480bb964c4bea88164f168d,2020/21,,,1,EJG Morgan,KL Nagarkoti,25,12,1,1,0,14,7,0,1,8,5,1,0
6480bba097818bcc0db9555d,2014,,,1,GJ Bailey,GJ Maxwell,25,15,1,2,1,2,2,0,0,22,13,1,2
6480bb94b882fb725e3f98e5,2018,,,1,AJ Finch,CH Gayle,25,14,1,2,0,14,6,1,1,11,8,0,1
6480bba097818bcc0db9555d,2014,,,2,IK Pathan,KL Rahul,25,20,1,1,1,5,9,0,0,17,11,1,1
6480bb9e80233e83b9d1be1f,2012,,,1,AT Rayudu,RG Sharma,25,24,4,0,1,4,11,0,0,20,13,4,0
6480bb9ca21b98f1be8254e2,2009/10,,,2,CL White,JH Kallis,25,22,4,0,1,4,11,0,0,20,11,4,0
6480bb9ade063258af41163b,2007/08,,,2,A Symonds,AC Gilchrist,25,23,2,2,1,5,9,1,0,19,14,1,2
6480bb9bee2e48d9c41b1e23,2009,,,1,JA Morkel,MS Dhoni,25,12,4,0,0,4,5,0,0,20,7,4,0
6480bb9bc80883a975281815,2009,,,1,B Akhil,R Dravid,25,23,3,0,1,9,9,1,0,14,14,2,0
6480bba31cc11024436836b5,2016,,,2,JP Duminy,RR Pant,25,21,3,0,1,9,9,1,0,15,12,2,0
6480bb9edbd8851db7e06741,2012,,,1,BJ Hodge,DH Yagnik,25,10,3,1,0,15,7,1,1,9,3,2,0
6480bba250b404cdcbff22c8,2015,,,2,AT Rayudu,KA Pollard,25,16,2,1,1,10,8,1,0,13,8,1,1
6480bb9d918bd358d046889d,2011,,,1,JR Hopes,MS Wade,25,20,3,0,1,17,11,3,0,8,9,0,0
6480bb954e496ec9b12aa120,2019,,,1,BA Stokes,R Parag,25,25,2,0,1,8,11,0,0,16,14,2,0
6480bba0b2a9d600114a43d7,2013,,,2,KD Karthik,SR Tendulkar,25,26,3,0,1,7,13,0,0,15,13,3,0
6480bb9a8ac627a1ebf8dacf,2007/08,,,1,JH Kallis,LRPL Taylor,25,19,2,1,1,14,10,2,0,11,9,0,1
6480bb93575636076d81e4c5,2017,,,1,DA Warner,MC Henriques,25,25,1,1,1,15,9,1,1,9,16,0,0
6480bb9ba6cd609c32579bde,2009,,,2,GR Napier,JP Duminy,25,25,1,0,1,15,16,1,0,8,9,0,0
6480bb9c454e9eefca545bde,2009/10,,,2,FY Fazal,MJ Lumb,25,23,3,0,1,3,6,0,0,20,17,3,0
6480bb98cbaaf700d226941a,2022,,,2,Anmolpreet Singh,Ishan Kishan,25,14,3,1,1,5,4,1,0,19,10,2,1
6480bb988545a7776b8c9306,2022,,,2,KD Karthik,Mohammed Siraj,25,10,1,2,1,21,8,1,2,0,2,0,0
6480bb9e05381e16815803e9,2011,,,1,PC Valthaty,SE Marsh,25,22,2,1,1,2,6,0,0,22,16,2,1
6480bb95085c25712f29bd36,2019,,,2,MS Dhoni,RA Jadeja,25,21,0,1,1,12,9,0,1,11,12,0,0
6480bb9cff4ec2f71cdf18d1,2009/10,,,1,R Sathish,SS Tiwary,25,12,3,1,1,13,7,2,0,12,5,1,1
6480bba26bb69626041c4ba1,2015,,,2,AD Russell,RN ten Doeschate,25,11,2,2,1,13,5,1,1,12,6,1,1
6480bb9f02801d2090cdba0d,2012,,,2,RJ Peterson,SR Tendulkar,25,18,2,0,1,10,10,1,0,9,8,1,0
6480bb96c10dfe3d8c259db3,2020/21,,,1,D Padikkal,JR Philippe,25,25,2,0,1,12,8,1,0,12,17,1,0
6480bb95945c5e5dc4d8c7d6,2019,,,1,HH Pandya,M Markande,25,13,3,1,1,18,8,2,1,6,5,1,0
6480bb99ecbdaaf953b8eee5,2023,,,2,MP Stoinis,N Pooran,25,20,2,1,1,8,11,0,0,17,9,2,1
6480bba0d2cdb40c68c4739c,2013,,,2,Harbhajan Singh,KA Pollard,25,16,5,0,1,14,8,3,0,10,8,2,0
6480bb9e34659755628e7471,2012,,,2,AM Nayar,DJ Hussey,25,19,2,0,1,13,8,2,0,10,11,0,0
6480bba1ff55936e203ca5a6,2014,,,1,DA Miller,V Sehwag,25,24,3,0,1,8,11,0,0,17,13,3,0
6480bba0a3e806f41a4dab41,2013,,,2,AB de Villiers,MC Henriques,25,16,1,1,1,15,7,1,1,10,9,0,0
6480bb9c89f35f11aae1f2d0,2009/10,,,1,G Gambhir,PD Collingwood,25,13,3,1,1,7,5,1,0,16,8,2,1
6480bb973e3a3dbbb7ae3707,2020/21,,,1,PP Shaw,S Dhawan,25,20,3,1,1,7,11,1,0,16,9,2,1
6480bba0c1c8569f19cc70f0,2013,,,1,STR Binny,SV Samson,25,13,2,1,1,15,7,0,1,10,6,2,0
6480bb9b724406459cd357c9,2007/08,,,2,CL White,R Dravid,25,28,1,0,1,10,14,0,0,14,14,1,0
6480bb9ccba48a6bb44ccc21,2009,,,2,JP Duminy,SR Tendulkar,25,29,0,1,1,13,15,0,1,11,14,0,0
6480bba2c04b3acd88a50839,2015,,,1,SA Yadav,YK Pathan,25,15,2,1,1,6,6,0,0,19,9,2,1
6480bb9439fcd1191cf17a90,2017,,,1,Basil Thampi,KD Karthik,25,20,2,0,0,11,10,1,0,10,10,1,0
6480bb9e9162dceff15dc334,2011,,,2,AC Gilchrist,PC Valthaty,25,17,2,2,1,6,7,1,0,17,10,1,2
6480bba2c04b3acd88a50839,2015,,,1,MK Pandey,RV Uthappa,25,27,2,1,1,16,13,1,1,9,14,1,0
6480bb9b09e6c98206422ae5,2009,,,2,AS Raut,SK Warne,25,12,1,2,0,20,10,1,2,2,2,0,0
6480bb9a9514379c05d59c38,2023,,,2,C Green,SA Yadav,25,14,3,1,1,3,4,0,0,22,10,3,1
6480bb9aa64355ce98da1141,2007/08,,,2,DPMD Jayawardene,SE Marsh,25,23,3,0,1,15,15,2,0,8,8,1,0
6480bb9b7557e68b433167d5,2007/08,,,1,JA Morkel,MS Dhoni,25,16,4,0,1,13,8,2,0,12,8,2,0
6480bb9439fcd1191cf17a90,2017,,,2,AR Patel,MP Stoinis,25,21,2,0,1,17,12,2,0,7,9,0,0
6480bb9b9d7aa6d8e47576d7,2007/08,,,1,PA Patel,SK Raina,25,22,2,0,1,17,15,2,0,7,7,0,0
6480bb98825d8ceb716e3f3c,2022,,,2,N Pooran,Shashank Singh,25,20,1,1,1,10,6,0,1,15,14,1,0
6480bb97493381c4d7dc7bf4,2021,,,1,S Dube,SV Samson,25,17,3,1,1,6,7,1,0,18,10,2,1
6480bb9fa236b26050f19633,2012,,,2,V Sehwag,Y Nagar,25,18,4,0,1,15,10,3,0,7,8,1,0
6480bb9558345af5a1bb044d,2019,,,2,KH Pandya,SA Yadav,25,30,3,0,1,8,16,1,0,16,14,2,0
6480bb9cdf6c63fec90a42df,2009/10,,,1,I Sharma,M Kartik,25,31,2,0,1,6,15,0,0,19,16,2,0
6480bb94605dacb25c83dc35,2018,,,2,G Gambhir,PP Shaw,25,15,4,0,1,2,5,0,0,22,10,4,0
6480bb9e156723e64d6bd26b,2012,,,2,KD Karthik,RG Sharma,25,15,1,2,1,7,6,1,0,17,9,0,2
6480bba15f6842352b6338ae,2014,,,2,MS Dhoni,RA Jadeja,25,16,0,2,0,15,12,0,1,9,4,0,1
6480bb9f7258f976eb8fe943,2012,,,1,BJ Hodge,STR Binny,25,10,3,1,1,1,2,0,0,21,8,3,1
6480bb9936b7698da2c2030c,2023,,,1,Dhruv Jurel,SO Hetmyer,25,16,1,2,1,4,6,0,0,20,10,1,2
6480bb9f0f1f6c03d8e2f039,2013,,,1,AD Mathews,MR Marsh,25,27,2,1,1,11,14,1,0,14,13,1,1
6480bba08cc4182f0127f2e2,2013,,,2,B Laughlin,RA Jadeja,25,16,2,0,1,4,8,0,0,15,8,2,0
6480bba133267f04941acf7d,2014,,,1,DJG Sammy,IK Pathan,25,29,2,0,1,7,16,0,0,17,13,2,0
6480bb98b00f767943bb8415,2022,,,2,Lalit Yadav,RR Pant,25,10,1,2,1,3,3,0,0,20,7,1,2
6480bb97752fcb9cd9f23692,2021,,,2,M Vohra,SV Samson,25,17,4,1,1,12,8,1,1,12,9,3,0
6480bb9f1faffe780b407e67,2013,,,1,AM Nayar,MR Marsh,25,16,2,1,1,9,8,1,0,15,8,1,1
6480bba1d3b4ddc36050e3f3,2014,,,1,DA Miller,WP Saha,25,25,1,1,1,6,10,0,0,18,15,1,1
6480bb9be88c31fc563da86f,2009,,,1,R Bishnoi,SP Goswami,25,23,1,2,1,18,14,1,2,6,9,0,0
6480bb96ec01f8fb3504bc36,2020/21,,,2,AJ Finch,D Padikkal,25,15,3,1,1,8,7,2,0,17,8,1,1
6480bba09d1874eb9ded0204,2013,,,2,DA Warner,DPMD Jayawardene,25,29,4,0,1,13,18,2,0,12,11,2,0
6480bba069c0322e91e50958,2013,,,2,G Gambhir,MS Bisla,25,27,3,0,1,5,9,0,0,15,18,3,0
6480bb99f816e64203e3c687,2023,,,1,SM Curran,Sikandar Raza,25,20,0,2,1,14,11,0,1,10,9,0,1
6480bb9d5cca30c933d4baf4,2011,,,2,AL Menaria,AS Raut,25,25,2,0,1,7,9,0,0,18,16,2,0
6480bb9a365c63af4b3de24c,2023,,,1,M Shahrukh Khan,P Simran Singh,25,13,3,1,1,1,1,0,0,24,12,3,1
6480bb93182304739a535742,2017,,,1,MS Dhoni,R Bhatia,25,25,0,2,1,10,11,0,1,15,14,0,1
6480bb9e05381e16815803e9,2011,,,1,AC Gilchrist,PC Valthaty,25,24,4,0,1,3,8,0,0,21,16,4,0
6480bb99f33a7dd80eb0a544,2023,,,2,LS Livingstone,SM Curran,25,14,1,2,1,14,9,1,1,10,5,0,1
6480bba2256bfaaf14c57ead,2015,,,2,Shakib Al Hasan,UT Yadav,25,11,4,1,1,1,2,0,0,22,9,4,1
6480bb974e2f8e7f41c506dc,2021,,,1,SV Samson,YBK Jaiswal,25,13,3,1,1,16,7,3,0,9,6,0,1
6480bb9774a44376e3b5eb6f,2021,,,1,KD Karthik,N Rana,25,11,1,2,1,5,4,0,0,20,7,1,2
6480bb96a467817b9b68ca94,2020/21,,,1,SM Curran,SR Watson,25,15,2,2,1,22,9,2,2,2,6,0,0
6480bb987b6845947f7ca137,2022,,,1,R Parag,SV Samson,25,23,1,2,1,19,12,1,2,5,11,0,0
6480bba27b4786f36f706f8e,2016,,,1,Harbhajan Singh,MJ McClenaghan,25,8,4,1,0,23,6,4,1,2,2,0,0
6480bba1017a98eead1ec861,2015,,,2,AR Patel,MG Johnson,25,13,2,0,0,11,6,1,0,13,7,1,0
6480bb9802d8f5ec4413766d,2022,,,2,KS Williamson,N Pooran,25,18,1,1,1,15,10,1,1,8,8,0,0
6480bb9f68a0a232d83c338c,2012,,,2,AT Rayudu,KD Karthik,25,25,2,0,1,16,19,1,0,7,6,1,0
6480bb954e496ec9b12aa120,2019,,,2,MS Dhoni,RA Jadeja,25,12,1,1,1,14,8,1,0,9,4,0,1
6480bb99c6aa5989a16174d1,2023,,,2,Dhruv Jurel,R Ashwin,25,11,2,1,1,13,5,0,1,12,6,2,0
6480bba2f05e90a9005771d2,2015,,,1,EJG Morgan,NV Ojha,25,19,3,1,1,4,7,0,0,20,12,3,1
6480bb966c9efd5bf35d10b9,2019,,,2,R Parag,S Gopal,25,17,5,0,1,7,8,1,0,18,9,4,0
6480bb9ef7c6084992b7cdf8,2012,,,2,DT Christian,PA Patel,25,18,1,1,1,12,10,1,0,11,8,0,1
6480bb9fcbbfd8053f253537,2012,,,1,IK Pathan,Y Nagar,25,16,3,0,1,15,9,2,0,10,7,1,0
6480bba1603d86b7d278a366,2015,,,2,P Negi,RA Jadeja,25,12,4,0,1,21,11,4,0,0,1,0,0
6480bb95085c25712f29bd36,2019,,,1,MP Stoinis,PA Patel,25,18,2,1,1,12,10,0,1,13,8,2,0
6480bb970127afddc00607cc,2021,,,2,RA Jadeja,SK Raina,25,21,4,0,0,7,6,1,0,17,15,3,0
6480bb9ab49fc97bbb30576f,2023,,,2,Shubman Gill,WP Saha,25,18,4,0,1,8,4,2,0,12,14,2,0
6480bb96c40b697b63d08717,2019,,,1,MJ Guptill,MK Pandey,25,20,3,1,1,13,9,1,1,12,11,2,0
6480bb94b9d954a885cc531b,2017,,,2,MK Tiwary,SPD Smith,25,18,2,1,1,7,8,1,0,17,10,1,1
6480bb9eeeaf037e5e41ab86,2012,,,2,DJ Hussey,Mandeep Singh,25,20,2,0,1,13,10,1,0,11,10,1,0
6480bb948a69b3d86293b12b,2017,,,1,Ishan Kishan,SK Raina,25,16,3,1,1,18,11,2,1,6,5,1,0
6480bb93f866249511c76dbc,2017,,,2,BA Stokes,SPD Smith,25,21,1,1,1,11,8,0,1,14,13,1,0
6480bb99fa79383bdc7df827,2022,,,1,JM Bairstow,PBB Rajapaksa,25,11,1,3,1,23,8,1,3,1,3,0,0
6480bb9c121ee402b7b2eda6,2009,,,2,A Symonds,HH Gibbs,25,19,1,1,1,16,12,1,1,7,7,0,0
6480bb94605dacb25c83dc35,2018,,,1,KK Nair,Yuvraj Singh,25,31,2,0,1,11,14,1,0,14,17,1,0
6480bb9f7ff1377c4d13a645,2013,,,2,TL Suman,Yuvraj Singh,25,17,5,0,1,23,15,5,0,1,2,0,0
6480bba19e29de4f208211ac,2014,,,1,BR Dunk,CM Gautam,25,19,3,0,1,15,14,2,0,6,5,1,0
6480bba273adb498d96b27a9,2016,,,2,RV Uthappa,YK Pathan,25,19,3,0,1,14,10,2,0,10,9,1,0
6480bb9e5de755887230bb00,2012,,,1,JD Ryder,MN Samuels,25,26,2,0,1,15,11,2,0,8,15,0,0
6480bb9651b51fdcda05e4c8,2020/21,,,2,R Tewatia,S Gopal,25,24,1,1,1,19,13,1,1,6,11,0,0
6480bb97af05ebd5c4f575c4,2021,,,2,Abdul Samad,V Shankar,25,17,1,2,1,7,8,1,0,18,9,0,2
6480bba0dcd1149b9b0b501f,2013,,,1,AD Mathews,MR Marsh,25,19,0,2,1,20,11,0,2,5,8,0,0
6480bb9d02d996f85dd5e945,2011,,,1,BJ Hodge,RA Jadeja,25,12,1,2,0,8,6,1,0,16,6,0,2
6480bb984f6c41cd28aa0353,2022,,,2,Abhishek Sharma,KS Williamson,25,21,2,1,1,8,5,1,0,16,16,1,1
6480bb95cf9d446747bd74fe,2019,,,2,KM Jadhav,SK Raina,25,22,2,1,1,14,15,2,0,11,7,0,1
6480bba0587190387a754733,2013,,,1,DPMD Jayawardene,V Sehwag,25,19,5,0,1,19,13,4,0,6,6,1,0
6480bb9d105fba311a23a588,2011,,,2,AB de Villiers,AUK Pathan,25,6,3,2,0,12,2,0,2,12,4,3,0
6480bba0ad06ad631cf7665f,2014,,,2,JP Duminy,KD Karthik,25,23,1,0,1,15,14,0,0,10,9,1,0
6480bb9439fcd1191cf17a90,2017,,,1,KD Karthik,RA Jadeja,25,18,2,0,1,14,11,1,0,9,7,1,0
6480bba0ddcc30675d83403c,2013,,,2,CL White,S Dhawan,25,17,4,0,1,2,3,0,0,19,14,4,0
6480bb9bd918d2e963f0218a,2009,,,2,RG Sharma,Y Venugopal Rao,25,17,0,2,1,17,7,0,2,8,10,0,0
6480bb9e4bb50b724830b249,2011,,,1,JH Kallis,RN ten Doeschate,25,9,0,3,1,19,5,0,3,4,4,0,0
6480bb9c7bc1dc527c14f1ac,2009/10,,,1,AD Mathews,MK Tiwary,25,18,2,0,1,12,8,1,0,13,10,1,0
6480bb9813fa79617f791851,2022,,,2,SE Rutherford,Shahbaz Ahmed,25,22,1,1,1,5,10,0,0,14,12,1,1
6480bba141bcb000fa6fe2a4,2015,,,2,AJ Finch,PA Patel,24,21,4,0,1,10,14,2,0,14,7,2,0
6480bb9df46e9f48932124df,2009/10,,,1,SR Tendulkar,SS Tiwary,24,24,1,0,1,12,11,1,0,12,13,0,0
6480bba1827557ebdfc70821,2015,,,1,GJ Bailey,Gurkeerat Singh,24,21,0,2,1,13,11,0,1,11,10,0,1
6480bb9e83b8575f74b8e962,2012,,,2,SS Tiwary,V Kohli,24,10,1,2,1,8,6,1,0,15,4,0,2
6480bb9ef18c54e7aafdd223,2012,,,2,Harmeet Singh,PP Chawla,24,10,3,1,1,14,6,3,0,10,4,0,1
6480bb958c7b985a2b586a02,2018,,,2,SP Narine,Shubman Gill,24,14,4,1,1,12,8,1,1,12,6,3,0
6480bb9cafc843037dc1e863,2009,,,1,MV Boucher,R Vinay Kumar,24,25,0,0,1,15,13,0,0,7,12,0,0
6480bb9e1a26096ce68e9ca3,2012,,,1,OA Shah,R Dravid,24,23,2,1,1,10,15,0,1,13,8,2,0
6480bb9eb14c6138aebfbf98,2012,,,1,AC Gilchrist,PC Valthaty,24,18,2,0,1,14,10,1,0,8,8,1,0
6480bba23ed328dbb847b4e7,2016,,,2,SA Yadav,YK Pathan,24,10,3,1,0,10,5,2,0,14,5,1,1
6480bba0b46cf5430edef3f5,2014,,,1,AP Tare,MEK Hussey,24,28,2,1,1,21,15,2,1,3,13,0,0
6480bb9bdde9db92f880e40d,2007/08,,,2,JR Hopes,SE Marsh,24,19,2,0,1,13,10,2,0,5,9,0,0
6480bba1551dc12c8f2a7038,2014,,,1,JP Duminy,KD Karthik,24,17,2,1,1,6,8,0,0,18,9,2,1
6480bba0404171e13faa181e,2013,,,1,JH Kallis,MK Tiwary,24,22,2,0,1,16,15,1,0,8,7,1,0
6480bb9b1fc007965b68d4d9,2009,,,2,DJ Bravo,Harbhajan Singh,24,12,3,1,1,10,7,2,0,13,5,1,1
6480bb9802d8f5ec4413766d,2022,,,1,MS Wade,Shubman Gill,24,14,2,0,1,5,5,1,0,7,9,1,0
6480bb9df46e9f48932124df,2009/10,,,2,AB McDonald,PJ Sangwan,24,18,0,1,0,18,13,0,1,6,5,0,0
6480bb95014388d3e8c62904,2019,,,1,AB de Villiers,V Kohli,24,24,1,1,1,17,16,1,1,5,8,0,0
6480bba2f3ed8323f852acfa,2016,,,1,DJ Hooda,EJG Morgan,24,17,1,1,1,5,5,0,0,17,12,1,1
6480bb9f0f1f6c03d8e2f039,2013,,,2,BB Samantray,KV Sharma,24,26,2,0,1,16,13,2,0,7,13,0,0
6480bb94d8aa9021808a4760,2017,,,1,V Shankar,Yuvraj Singh,24,19,3,1,1,15,10,1,1,9,9,2,0
6480bb98d2cd0fa3ed0ffc21,2022,,,2,SS Iyer,VR Iyer,24,15,4,0,1,21,9,4,0,2,6,0,0
6480bb97220be892fbfc2a36,2021,,,1,KH Pandya,RD Chahar,24,12,3,0,1,14,7,3,0,6,5,0,0
6480bb94fbd0b904d63e0e07,2017,,,2,KS Williamson,Yuvraj Singh,24,17,3,0,1,9,5,1,0,15,12,2,0
6480bb997d1393ca85856ec2,2022,,,1,HH Pandya,WP Saha,24,19,1,1,1,13,12,0,1,10,7,1,0
6480bb9c13817091131f76e3,2009/10,,,2,DPMD Jayawardene,RS Bopara,24,16,4,0,1,14,9,3,0,10,7,1,0
6480bb9b9614f21d90333e15,2007/08,,,2,NK Patel,Younis Khan,24,20,4,0,1,20,13,4,0,3,7,0,0
6480bb962fbc99d08dc59f56,2020/21,,,1,V Kohli,Washington Sundar,24,24,1,0,1,11,10,0,0,13,14,1,0
6480bb9e591b94e62772e66a,2012,,,2,AT Rayudu,KA Pollard,24,14,2,1,1,8,6,1,0,16,8,1,1
6480bb9619eaed447b2a05d4,2020/21,,,1,D Padikkal,V Kohli,24,21,3,0,1,15,7,3,0,9,14,0,0
6480bb9c54a72690027ba3d4,2009/10,,,2,R Sathish,SR Tendulkar,24,23,0,1,1,5,9,0,0,18,14,0,1
6480bb9da398a7c3c645732c,2011,,,2,JD Ryder,MK Pandey,24,18,4,0,1,18,12,3,0,6,6,1,0
6480bb9b332c16fba9cd28bc,2009,,,1,JH Kallis,W Jaffer,24,18,4,0,1,14,10,3,0,7,8,1,0
6480bba1553f17c77d5f1ca2,2014,,,1,DA Warner,NV Ojha,24,7,2,2,0,16,4,2,1,7,3,0,1
6480bb9737b1d7284b5297c1,2021,,,1,CA Lynn,RG Sharma,24,24,2,1,1,5,9,1,0,19,15,1,1
6480bb9c757dbd7f92b1130a,2009/10,,,2,S Dhawan,SR Tendulkar,24,21,5,0,1,8,12,2,0,15,9,3,0
6480bba18e95c84faca0bdb6,2015,,,2,AM Rahane,KK Nair,24,16,3,0,1,3,4,0,0,20,12,3,0
6480bb9e93f969bcc8a79433,2011,,,1,G Gambhir,JH Kallis,24,29,3,0,1,16,19,2,0,8,10,1,0
6480bb95ea40317152ed9ca5,2018,,,1,PP Shaw,SS Iyer,24,25,1,1,1,17,17,1,1,3,8,0,0
6480bb9aa030c8ebcbcc19c9,2007/08,,,1,AM Nayar,SM Pollock,24,18,2,1,1,5,7,0,0,17,11,2,1
6480bb99cbb648c5c0ecb205,2023,,,1,Rahmanullah Gurbaz,SN Thakur,24,13,1,3,1,24,9,1,3,0,4,0,0
6480bba29fb420d92aef1d2a,2015,,,1,MK Pandey,RV Uthappa,24,28,0,1,1,15,16,0,1,9,12,0,0
6480bb94640655c49683aee1,2018,,,2,AM Rahane,SV Samson,24,20,3,0,1,10,11,1,0,14,9,2,0
6480bb98b8bb5b0d2c2f0848,2022,,,1,SA Yadav,Tilak Varma,24,27,1,1,1,14,13,0,1,10,14,1,0
6480bb9574ca455ec008e942,2018,,,1,Shakib Al Hasan,WP Saha,24,16,4,0,1,10,9,1,0,14,7,3,0
6480bba1ebb63d1bd8c60b9d,2014,,,2,JP Duminy,KP Pietersen,24,18,4,0,1,8,8,1,0,16,10,3,0
6480bb958f77e7d3929d28e3,2018,,,2,F du Plessis,SK Raina,24,19,5,0,1,12,10,3,0,10,9,2,0
6480bb96c40b697b63d08717,2019,,,2,C Munro,RR Pant,24,19,1,2,1,14,13,1,1,10,6,0,1
6480bb99fe078839da40e7ab,2023,,,2,DA Warner,MR Marsh,24,17,5,0,1,21,8,5,0,2,9,0,0
6480bb9938b659481e3ab6dc,2022,,,1,JC Buttler,R Parag,24,9,1,2,1,19,6,1,2,4,3,0,0
6480bba0adee98d459585bed,2014,,,1,JP Duminy,KP Pietersen,24,18,2,1,1,5,8,0,0,19,10,2,1
6480bb9932735ca83d38f6e7,2022,,,2,Abhishek Sharma,RA Tripathi,24,18,1,2,1,14,6,0,2,9,12,1,0
6480bb94c2dcb1007bf6788b,2017,,,1,P Negi,S Badree,24,20,1,0,1,11,12,1,0,8,8,0,0
6480bba37e4fcb8af147f79b,2016,,,2,KK Nair,SV Samson,24,31,1,0,1,14,18,1,0,10,13,0,0
6480bb96fed7a7ee65076e4a,2020/21,,,1,JC Buttler,SPD Smith,24,20,2,0,1,9,10,0,0,15,10,2,0
6480bb948211fe47e65f2e77,2018,,,1,KS Williamson,MK Pandey,24,16,4,0,1,7,5,1,0,16,11,3,0
6480bb9f6b144f2a6d105b32,2013,,,2,KD Karthik,RG Sharma,24,17,2,1,1,14,7,1,1,8,10,1,0
6480bb9eb14c6138aebfbf98,2012,,,1,DJ Hussey,SE Marsh,24,27,1,0,1,9,13,0,0,15,14,1,0
6480bb9e59fe7a0f48b7f9b9,2012,,,1,NV Ojha,Y Nagar,24,11,3,1,1,7,2,0,1,17,9,3,0
6480bb94ca3c1b1eac5e8dd3,2018,,,2,KM Jadhav,RA Jadeja,24,21,1,1,1,10,8,0,1,12,13,1,0
6480bb97aed297ca9686c94a,2021,,,2,F du Plessis,RD Gaikwad,24,30,1,1,1,14,14,1,1,5,16,0,0
6480bba0c3cc8c51bc6c1c3a,2013,,,2,MC Henriques,V Kohli,24,22,2,1,1,9,11,0,1,13,11,2,0
6480bb9a17692bfb5bd3894c,2007/08,,,2,AB de Villiers,G Gambhir,24,19,1,1,1,13,11,1,0,11,8,0,1
6480bb93d5dc00a79edede9c,2017,,,2,DJ Hooda,S Dhawan,24,18,2,0,1,9,9,1,0,13,9,1,0
6480bb9435048f20502ba1e1,2018,,,1,C de Grandhomme,UT Yadav,24,8,0,3,0,21,6,0,3,1,2,0,0
6480bb9bd918d2e963f0218a,2009,,,1,P Kumar,V Kohli,24,12,2,2,1,13,5,0,2,10,7,2,0
6480bb9d0f6794fbf429449b,2011,,,1,JH Kallis,MS Bisla,24,21,2,0,1,6,9,0,0,14,12,2,0
6480bb98f01e4672b988c112,2022,,,2,MP Stoinis,PVD Chameera,24,12,2,1,1,9,5,0,1,13,7,2,0
6480bb95085c25712f29bd36,2019,,,1,MM Ali,P Negi,24,15,3,0,1,16,9,3,0,5,6,0,0
6480bb976344f6d667dfd965,2021,,,2,N Rana,Shubman Gill,24,31,1,1,1,12,13,1,0,11,18,0,1
6480bb957ae1619e0d648dec,2019,,,1,DA Warner,Mohammad Nabi,24,16,2,0,1,12,9,2,0,12,7,0,0
6480bb9bf2869505c9393b7d,2009,,,1,AC Gilchrist,HH Gibbs,24,17,4,0,1,13,11,2,0,11,6,2,0
6480bba1d3370c13ea1f79f3,2014,,,2,JP Duminy,KP Pietersen,24,16,0,2,1,19,9,0,2,5,7,0,0
6480bb98aae066234fd8f11e,2022,,,2,Mandeep Singh,PP Shaw,24,18,4,0,1,18,13,4,0,5,5,0,0
6480bb964c4bea88164f168d,2020/21,,,2,R Tewatia,TK Curran,24,19,0,1,1,13,9,0,1,11,10,0,0
6480bba0587190387a754733,2013,,,1,UBT Chand,V Sehwag,24,13,5,0,1,11,9,2,0,12,4,3,0
6480bb9bd918d2e963f0218a,2009,,,1,KP Pietersen,R Dravid,24,19,3,0,1,2,5,0,0,20,14,3,0
6480bb99695e001cdaca81e0,2022,,,2,DR Sams,RG Sharma,24,16,4,0,1,0,2,0,0,18,14,4,0
6480bb9d8f5769d3a514fd88,2009/10,,,1,JH Kallis,R Dravid,24,16,5,0,1,11,9,2,0,13,7,3,0
6480bb95430629e254bbc4fd,2018,,,1,HH Pandya,KH Pandya,24,15,3,1,1,10,4,2,0,14,11,1,1
6480bb95b1f28cf5bcf5e167,2018,,,2,F du Plessis,SK Raina,24,16,4,0,1,1,3,0,0,22,13,4,0
6480bba24f6e6e2c212c7469,2016,,,2,MA Agarwal,Q de Kock,24,14,2,1,1,6,4,1,0,17,10,1,1
6480bb98634dba60191637ad,2021,,,2,KM Jadhav,WP Saha,24,26,0,0,1,12,12,0,0,11,14,0,0
6480bba01a3f8444c7a33ba6,2014,,,2,DR Smith,SK Raina,24,12,4,1,1,22,6,4,1,2,6,0,0
6480bb94ebff9a116f68560b,2018,,,1,CA Lynn,SP Narine,24,18,2,1,1,12,8,1,1,9,10,1,0
6480bba11a59d64bb4aa66f4,2014,,,1,M Vohra,V Sehwag,24,14,4,1,1,4,6,1,0,18,8,3,1
6480bb9fe31a789bcb52d583,2012,,,1,AP Majumdar,CJ Ferguson,24,31,0,0,1,12,16,0,0,11,15,0,0
6480bb9b4fc6889967a3cd54,2007/08,,,2,AM Nayar,RV Uthappa,24,25,1,0,1,9,9,1,0,7,16,0,0
6480bb9d54ae15d3d0ed9e5e,2011,,,1,M Klinger,PA Patel,24,22,4,0,1,3,6,0,0,21,16,4,0
6480bba0da054e3d917f71fb,2013,,,2,M Vijay,RA Jadeja,24,27,1,0,1,15,18,1,0,8,9,0,0
6480bb956e3f7f62e4b24c01,2019,,,1,AM Rahane,STR Binny,24,17,2,0,1,4,4,0,0,19,13,2,0
6480bba2704d23da78c3eb15,2016,,,2,AR Patel,Gurkeerat Singh,24,11,1,2,1,21,7,1,2,3,4,0,0
6480bb9bbb0ec0266749f518,2007/08,,,1,MV Boucher,R Dravid,24,25,2,0,1,16,14,2,0,7,11,0,0
6480bba2bbd9d85769220a68,2015,,,1,AM Rahane,JP Faulkner,24,10,2,1,0,15,6,1,1,8,4,1,0
6480bb9a40966b9b90fcdf2e,2023,,,1,LS Livingstone,S Dhawan,24,13,4,0,1,15,9,3,0,7,4,1,0
6480bb9bc74c35e494cec477,2007/08,,,1,GC Smith,M Kaif,24,17,3,0,1,5,4,1,0,14,13,2,0
6480bb97493381c4d7dc7bf4,2021,,,1,R Tewatia,S Dube,24,12,3,1,1,17,8,2,1,5,4,1,0
6480bb9a1032ce724214f6dd,2007/08,,,1,SM Pollock,SS Tiwary,24,20,3,0,1,15,10,2,0,9,10,1,0
6480bb943565d22d24ec0ae8,2017,,,2,C de Grandhomme,SP Jackson,24,18,1,1,1,17,12,1,1,6,6,0,0
6480bb95085c25712f29bd36,2019,,,2,MS Dhoni,SN Thakur,24,6,1,3,1,24,6,1,3,0,0,0,0
6480bb98de3641699db2c5a1,2021,,,2,PP Shaw,S Dhawan,24,15,4,0,1,18,12,3,0,4,3,1,0
6480bba2f39653e2f61baca2,2015,,,2,AD Mathews,Yuvraj Singh,24,26,1,1,1,12,10,0,1,12,16,1,0
6480bb9ca21b98f1be8254e2,2009/10,,,2,JH Kallis,RV Uthappa,24,15,0,2,1,12,6,0,1,12,9,0,1
6480bb9c89e2e8ecb04f94cb,2009/10,,,2,KD Karthik,Y Nagar,24,12,3,1,1,21,8,3,1,0,4,0,0
6480bb9384cbae8edee3707f,2017,,,1,KA Pollard,KH Pandya,24,27,1,0,1,3,11,0,0,17,16,1,0
6480bb9b283b30d0503656f7,2007/08,,,1,S Dhawan,TM Dilshan,24,13,2,1,1,8,7,0,0,16,6,2,1
6480bb9b17739118ee6c3bd0,2007/08,,,1,DB Das,SC Ganguly,24,17,0,2,1,19,11,0,2,5,6,0,0
6480bb9d1ed71a4f47892d00,2009/10,,,2,AC Voges,AJ Finch,24,19,1,1,1,8,7,1,0,16,12,0,1
6480bb9fe3bc767415c60bfa,2012,,,1,DA Warner,V Sehwag,24,12,1,1,1,7,6,0,1,10,6,1,0
6480bba250b404cdcbff22c8,2015,,,1,DJ Bravo,F du Plessis,24,20,2,1,1,19,13,2,1,5,7,0,0
6480bba35038a60ea566794a,2016,,,1,DJ Bravo,RA Jadeja,24,12,4,0,1,20,10,4,0,2,2,0,0
6480bb962a1612c936d161ba,2019,,,1,Q de Kock,RG Sharma,24,16,2,1,1,15,9,1,1,8,7,1,0
6480bba1c67d2c9c1279a4c8,2014,,,2,DA Warner,DJG Sammy,24,18,0,2,1,13,10,0,1,8,8,0,1
6480bba2b341a081c069198d,2015,,,2,AM Rahane,KK Nair,24,24,3,0,1,11,11,1,0,12,13,2,0
6480bb96fed7a7ee65076e4a,2020/21,,,1,R Parag,SPD Smith,24,16,2,1,1,20,11,2,1,4,5,0,0
6480bb96e18d7a1b3e62552d,2019,,,2,KL Rahul,N Pooran,24,13,2,2,1,3,3,0,0,21,10,2,2
6480bb93182304739a535742,2017,,,1,AM Rahane,MA Agarwal,24,18,1,0,1,10,9,0,0,12,9,1,0
6480bba0ddcc30675d83403c,2013,,,2,A Mishra,S Dhawan,24,30,2,0,1,15,21,2,0,7,9,0,0
6480bba2b7be71a15b2bb3de,2015,,,2,MM Sharma,RA Jadeja,24,10,1,2,0,21,7,1,2,3,3,0,0
6480bb9f87652064dab6c573,2013,,,1,AC Gilchrist,Mandeep Singh,24,23,4,0,1,7,12,1,0,16,11,3,0
6480bba2bae80e615447f251,2015,,,2,AB de Villiers,V Kohli,24,17,5,0,1,21,14,5,0,3,3,0,0
6480bb9ec90f99c5ea40b014,2012,,,1,MK Tiwary,MS Bisla,24,24,0,1,1,14,11,0,1,9,13,0,0
6480bb975ea60ce128803d60,2021,,,2,CV Varun,PJ Cummins,24,13,1,1,1,0,1,0,0,17,12,1,1
6480bb99bbae76f3f761d060,2023,,,2,JJ Roy,N Rana,24,7,1,3,1,19,4,0,3,5,3,1,0
6480bb94f27c8167d1685878,2017,,,1,KK Nair,SV Samson,24,17,2,1,1,12,11,2,0,9,6,0,1
6480bba2f05e90a9005771d2,2015,,,1,EJG Morgan,S Dhawan,24,18,2,1,1,10,10,0,1,13,8,2,0
6480bb95fbd4f1b7f3d8dfc0,2019,,,1,CH Gayle,SN Khan,24,25,1,1,1,7,12,0,0,15,13,1,1
6480bb9bf2869505c9393b7d,2009,,,2,BJ Hodge,MC Henriques,24,19,3,0,1,18,12,3,0,6,7,0,0
6480bb9558345af5a1bb044d,2019,,,2,HH Pandya,KA Pollard,24,7,2,2,0,22,7,2,2,0,0,0,0
6480bb9eb261c1057830912e,2011,,,1,DA Warner,NV Ojha,24,22,1,2,1,19,10,1,2,3,12,0,0
6480bb9ee0795047740de5a7,2011,,,1,AS Raut,J Botha,24,20,1,1,1,19,14,1,1,5,6,0,0
6480bb9a8053274c083224d9,2023,,,2,AT Rayudu,DP Conway,24,23,0,1,1,12,11,0,1,12,12,0,0
6480bb9d03ce4b87b32b91f5,2009/10,,,2,M Vijay,SK Raina,24,19,4,0,1,3,3,0,0,21,16,4,0
6480bb9d3c4dfa9f054aa47f,2011,,,2,AG Paunikar,SR Watson,24,23,4,0,1,12,10,2,0,11,13,2,0
6480bb9e5ad1f3182858e7c9,2012,,,2,DA Miller,SE Marsh,24,12,0,2,0,5,5,0,0,17,7,0,2
6480bb9fc524f8142f0b3461,2012,,,1,AD Mathews,SPD Smith,24,25,1,0,1,11,12,0,0,12,13,1,0
6480bba0208e8fbb34afdc50,2013,,,2,AC Gilchrist,SE Marsh,24,15,4,0,1,13,11,2,0,8,4,2,0
6480bb997d1393ca85856ec2,2022,,,2,GJ Maxwell,KD Karthik,24,12,4,0,0,21,10,4,0,2,2,0,0
6480bb97ce981c1918dce924,2021,,,1,PP Chawla,SA Yadav,24,11,4,1,1,0,2,0,0,23,9,4,1
6480bb9e5de755887230bb00,2012,,,2,F du Plessis,SK Raina,24,18,3,0,1,8,7,1,0,14,11,2,0
6480bb9d716a89dbf5e486d0,2011,,,2,AJ Finch,DA Warner,24,26,2,1,1,11,14,1,1,10,12,1,0
6480bb9754755bb7a7427d52,2021,,,1,N Rana,Shubman Gill,24,34,2,0,1,11,15,1,0,11,19,1,0
6480bb9ccba48a6bb44ccc21,2009,,,1,ML Hayden,SK Raina,24,22,2,2,1,3,10,0,0,20,12,2,2
6480bb9e1a26096ce68e9ca3,2012,,,1,GB Hogg,STR Binny,24,19,2,0,1,13,11,1,0,11,8,1,0
6480bb9c620c92d09ba1b6b9,2009,,,2,NV Ojha,SA Asnodkar,24,24,3,0,1,16,14,2,0,8,10,1,0
6480bba01893b0faadb9c761,2013,,,2,KB Arun Karthik,SS Tiwary,24,17,0,2,1,12,8,0,1,11,9,0,1
6480bba0a3e806f41a4dab41,2013,,,2,AB de Villiers,CH Gayle,24,27,0,0,1,13,15,0,0,10,12,0,0
6480bb9baccf501985a56d64,2007/08,,,2,AB de Villiers,KD Karthik,24,21,1,0,1,8,9,0,0,12,12,1,0
6480bb95f2e3c32afe233820,2018,,,2,M Vohra,PA Patel,24,17,4,0,1,3,4,0,0,20,13,4,0
6480bb9ade063258af41163b,2007/08,,,1,DJ Hussey,LR Shukla,24,15,1,2,0,18,9,1,2,4,6,0,0
6480bba2f3ed8323f852acfa,2016,,,2,NS Naik,SE Marsh,24,21,1,1,1,9,8,1,0,13,13,0,1
6480bb973e451a92813d78cc,2020/21,,,1,DA Warner,JM Bairstow,24,24,1,1,1,19,14,1,1,5,10,0,0
6480bb9a7f7a862ba0b2c59e,2007/08,,,2,AC Gilchrist,HH Gibbs,24,25,3,1,1,13,15,2,0,10,10,1,1
6480bb9c89f35f11aae1f2d0,2009/10,,,1,DA Warner,V Sehwag,24,19,3,1,1,4,8,0,0,19,11,3,1
6480bb9d3c4dfa9f054aa47f,2011,,,2,AL Menaria,LRPL Taylor,24,17,1,1,1,14,8,1,1,6,9,0,0
6480bb9ff2e0b1df0c3972c9,2012,,,2,Mandeep Singh,SE Marsh,24,19,5,0,1,8,4,2,0,13,15,3,0
6480bb9506d56930505d45ae,2019,,,2,PP Shaw,S Dhawan,24,19,3,1,1,13,11,1,1,11,8,2,0
6480bb9e591b94e62772e66a,2012,,,2,Harbhajan Singh,SL Malinga,24,19,3,0,1,12,8,2,0,10,11,1,0
6480bb962fbc99d08dc59f56,2020/21,,,1,AJ Finch,V Kohli,24,14,4,0,1,5,5,1,0,17,9,3,0
6480bba2aecb4103bab63c15,2016,,,1,AM Rahane,F du Plessis,24,24,2,1,1,20,15,2,1,4,9,0,0
6480bba2e8614b1263627c1b,2015,,,1,JP Faulkner,SV Samson,24,17,2,1,1,12,10,2,0,9,7,0,1
6480bb9f00ef088221497043,2013,,,2,MEK Hussey,R Ashwin,24,27,4,0,1,11,14,2,0,11,13,2,0
6480bba10e78f50f124b406a,2015,,,1,AB de Villiers,V Kohli,24,19,1,2,1,14,10,0,2,10,9,1,0
6480bb9eee740f701b0ee154,2011,,,2,CA Ingram,DA Warner,24,26,3,0,1,7,12,1,0,12,14,2,0
6480bba0ad06ad631cf7665f,2014,,,2,JDS Neesham,KD Karthik,24,17,3,0,1,18,10,2,0,6,7,1,0
6480bb9b62eb35d78fcd7df0,2007/08,,,2,A Mishra,TM Dilshan,24,22,4,0,1,6,11,0,0,18,11,4,0
6480bb97fb920d483d0da2af,2020/21,,,1,Abhishek Sharma,KS Williamson,24,10,2,2,1,12,6,1,1,12,4,1,1
6480bb9e65a802582c071438,2012,,,2,KA Pollard,RG Sharma,24,17,1,1,1,3,7,0,0,19,10,1,1
6480bba1568e0f3990191600,2014,,,2,KK Nair,SPD Smith,24,15,2,1,1,15,10,2,0,9,5,0,1
6480bb98d8f59b81335f4a3d,2021,,,2,MS Dhoni,SK Raina,24,15,3,1,0,11,9,2,0,12,6,1,1
6480bb9c0dec1a788da66d33,2009/10,,,2,M Vijay,ML Hayden,24,22,1,1,1,5,8,0,0,19,14,1,1
6480bb9d61e9b86b0f0aae49,2009/10,,,2,R Vinay Kumar,RV Uthappa,24,11,0,2,1,4,4,0,0,17,7,0,2
6480bba0be153677ce53c58e,2014,,,1,MS Dhoni,SK Raina,24,14,2,0,1,14,6,2,0,10,8,0,0
6480bb962831291a868490e7,2020/21,,,1,N Rana,RA Tripathi,24,23,3,0,1,11,11,2,0,13,12,1,0
6480bba119569fcc2d7859a4,2014,,,1,AJ Finch,NV Ojha,24,15,1,1,1,10,7,1,0,12,8,0,1
6480bb9ddcbb8fbbad6614c8,2009/10,,,2,DPMD Jayawardene,KC Sangakkara,24,26,2,0,1,11,12,1,0,12,14,1,0
6480bb9fe8f5df13fc8d1bc3,2012,,,2,DJ Bravo,MS Dhoni,24,13,2,1,1,5,5,0,0,19,8,2,1
6480bb97668d35800fa74139,2021,,,1,CH Gayle,MA Agarwal,24,23,3,0,1,13,11,2,0,11,12,1,0
6480bb9f022f0e8cd6e9cdeb,2012,,,1,DPMD Jayawardene,Y Venugopal Rao,24,23,1,1,1,9,14,0,0,15,9,1,1
6480bb9dd4e6757f7ded95e9,2009/10,,,2,B Sumanth,RG Sharma,24,9,2,1,0,6,3,1,0,17,6,1,1
6480bb99a620a7afdb3217fe,2023,,,1,Dhruv Jurel,SO Hetmyer,24,9,0,3,0,8,3,0,1,16,6,0,2
6480bb96267b63eb2c6747b0,2019,,,1,RR Pant,SS Iyer,24,15,1,2,1,7,7,1,0,17,8,0,2
6480bba250b404cdcbff22c8,2015,,,2,KA Pollard,RG Sharma,24,12,0,3,1,15,5,0,2,9,7,0,1
6480bba18a431be2cc738de0,2014,,,1,JP Duminy,KD Karthik,24,32,0,0,1,11,17,0,0,11,15,0,0
6480bb9439fcd1191cf17a90,2017,,,1,KD Karthik,SK Raina,24,20,3,0,1,19,12,3,0,5,8,0,0
6480bb95ea40317152ed9ca5,2018,,,2,AT Rayudu,SK Raina,24,19,2,1,1,19,11,2,1,5,8,0,0
6480bb94cb5adf24f5ad15c3,2017,,,1,HH Pandya,PA Patel,24,19,2,1,1,14,10,1,1,10,9,1,0
6480bba107ba9f7f041862c1,2014,,,2,RV Uthappa,YK Pathan,23,25,1,1,1,5,8,0,0,18,17,1,1
6480bba3b830360cf7031278,2016,,,1,AT Rayudu,KH Pandya,23,15,3,1,1,6,6,1,0,17,9,2,1
6480bb9aef150645306cc170,2023,,,1,Abhishek Sharma,RA Tripathi,23,13,2,1,1,12,7,2,0,10,6,0,1
6480bb9774dd8e44bbeeb5a4,2021,,,1,Harpreet Brar,MA Agarwal,23,6,3,1,0,4,2,1,0,15,4,2,1
6480bb9abfe839459b1a28f6,2007/08,,,1,RG Sharma,Shahid Afridi,23,17,2,1,1,10,10,1,0,13,7,1,1
6480bb96c3293977af83acbf,2019,,,2,RR Pant,SE Rutherford,23,10,1,2,1,11,4,1,1,11,6,0,1
6480bba2e3610f863b52b887,2016,,,1,B Kumar,S Dhawan,23,9,3,1,1,21,8,3,1,0,1,0,0
6480bb96ee2a21f0d9b9f37f,2020/21,,,2,KD Karthik,N Rana,23,17,1,1,1,6,7,0,0,16,10,1,1
6480bb99f816e64203e3c687,2023,,,1,M Shahrukh Khan,SM Curran,23,13,2,1,0,11,7,2,0,12,6,0,1
6480bba19cc161a3fb8a8795,2014,,,1,M Vohra,V Sehwag,23,13,2,2,1,5,2,1,0,17,11,1,2
6480bb9dd89d4266d59a4592,2011,,,2,PC Valthaty,SE Marsh,23,15,4,0,1,18,9,4,0,4,6,0,0
6480bb9ba9d43057d652a5fe,2009,,,1,KC Sangakkara,Yuvraj Singh,23,24,2,0,1,11,11,1,0,10,13,1,0
6480bb964a4d5a1709db428e,2020/21,,,2,CJ Jordan,DJ Hooda,23,15,3,0,1,13,8,2,0,10,7,1,0
6480bba1ece63aa1c77a954e,2015,,,2,DR Smith,SK Raina,23,19,2,1,1,19,11,2,1,4,8,0,0
6480bb9ed6aefcc9cd13d851,2012,,,1,CL White,S Dhawan,23,27,3,0,1,9,9,1,0,13,18,2,0
6480bb9836d24b9817a35f7d,2022,,,2,A Manohar,R Tewatia,23,13,5,0,0,15,7,3,0,8,6,2,0
6480bb9a58bc8710c38f4c1c,2023,,,1,KH Pandya,Q de Kock,23,23,1,1,1,13,14,1,0,9,9,0,1
6480bb99d43295fa2d82c9dc,2023,,,2,A Nortje,Kuldeep Yadav,23,15,4,0,0,15,9,3,0,7,6,1,0
6480bb9aded509be64de3bfb,2007/08,,,2,AB Agarkar,LR Shukla,23,17,1,1,1,11,9,1,0,9,8,0,1
6480bb954714437843ab3647,2019,,,2,DA Warner,RK Bhui,23,22,2,0,1,15,10,2,0,7,12,0,0
6480bb954e496ec9b12aa120,2019,,,1,BA Stokes,JC Archer,23,20,1,0,1,16,11,1,0,7,9,0,0
6480bb96acacf3be646d300a,2020/21,,,2,RR Pant,SS Iyer,23,28,1,1,1,16,16,1,1,7,12,0,0
6480bb956b439141409fd739,2018,,,2,CH Gayle,KL Rahul,23,20,5,0,1,8,11,2,0,14,9,3,0
6480bb9eae43aed76989151b,2011,,,1,AB de Villiers,M Kaif,23,18,2,0,1,6,5,1,0,15,13,1,0
6480bb9d038ed22e46cbeccb,2011,,,1,DT Christian,KC Sangakkara,23,23,0,1,1,16,13,0,1,7,10,0,0
6480bba0f858e6c12b25d8c3,2014,,,2,AR Patel,R Dhawan,23,25,2,0,1,7,10,0,0,16,15,2,0
6480bb945901306d3cb2b759,2018,,,2,JD Unadkat,S Gopal,23,17,3,0,1,16,10,3,0,7,7,0,0
6480bb9371e90dbd44ee19a3,2017,,,2,AR Patel,DA Miller,23,19,1,1,1,11,9,0,1,12,10,1,0
6480bb9d967f5a4cfbd8c74d,2011,,,2,MK Tiwary,YK Pathan,23,18,0,2,1,17,10,0,2,5,8,0,0
6480bb9de80788b3c3ebe4e1,2009/10,,,1,AC Voges,YK Pathan,23,20,1,1,1,13,12,1,0,10,8,0,1
6480bb93c1cc671d66c471ba,2017,,,1,KH Pandya,N Rana,23,14,3,1,1,11,6,2,0,12,8,1,1
6480bb9ddcbb8fbbad6614c8,2009/10,,,1,A Mishra,M Manhas,23,20,1,0,1,6,7,0,0,15,13,1,0
6480bb988545a7776b8c9306,2022,,,2,KD Karthik,Shahbaz Ahmed,23,14,2,0,1,7,4,1,0,14,10,1,0
6480bba120182b9ca0b70004,2014,,,1,AT Rayudu,BR Dunk,23,19,4,0,1,7,5,1,0,15,14,3,0
6480bb98a95cb1650c81c926,2022,,,1,R Parag,YS Chahal,23,8,2,2,0,23,8,2,2,0,0,0,0
6480bba1f2392e6761d39d66,2014,,,1,BB McCullum,SK Raina,23,16,1,2,1,14,11,0,2,7,5,1,0
6480bb97aa725a640d0f8e2f,2021,,,1,E Lewis,SV Samson,23,17,2,1,1,12,9,2,0,10,8,0,1
6480bb977f55a1c473670850,2021,,,2,Ishan Kishan,RG Sharma,23,20,1,2,1,1,7,0,0,22,13,1,2
6480bba1bd00c57fb3301f04,2014,,,2,M Vohra,V Sehwag,23,22,3,0,1,15,12,2,0,7,10,1,0
6480bb97cca23939859c422e,2021,,,2,J Suchith,KS Williamson,23,9,3,1,0,14,6,2,1,5,3,1,0
6480bb9b166300b6298fc71a,2009,,,1,KC Sangakkara,SM Katich,23,24,4,0,1,10,11,2,0,10,13,2,0
6480bb9ce7891d47a7fe9c12,2009/10,,,2,DPMD Jayawardene,KC Sangakkara,23,16,2,1,1,12,9,1,1,9,7,1,0
6480bb94009d0662ee94f07b,2018,,,1,BCJ Cutting,SA Yadav,23,16,2,1,1,9,9,1,0,14,7,1,1
6480bba280f09c38002cf14b,2015,,,1,AD Russell,J Botha,23,11,1,2,1,20,8,1,2,2,3,0,0
6480bba19e29de4f208211ac,2014,,,2,AB de Villiers,V Kohli,23,17,4,0,1,9,7,2,0,14,10,2,0
6480bba1d21281c7385d5ce4,2014,,,2,DA Miller,GJ Bailey,23,17,3,1,1,22,10,3,1,1,7,0,0
6480bb987c52e15a2cac0697,2022,,,1,JM Bairstow,P Simran Singh,23,13,4,0,1,11,7,2,0,12,6,2,0
6480bba1f2392e6761d39d66,2014,,,2,CJ Anderson,LMP Simmons,23,15,1,2,1,20,10,1,2,3,5,0,0
6480bb9b8cc888fe3f01f2a4,2009,,,2,BB McCullum,CH Gayle,23,28,3,0,1,4,11,0,0,17,17,3,0
6480bb98aae066234fd8f11e,2022,,,2,R Powell,RR Pant,23,15,2,1,1,13,6,1,1,10,9,1,0
6480bb9b72f6a46338302131,2009,,,1,DR Smith,RG Sharma,23,20,1,1,1,16,12,1,1,6,8,0,0
6480bb9f87652064dab6c573,2013,,,2,R Bhatia,YK Pathan,23,10,1,2,1,16,6,0,2,7,4,1,0
6480bb9442c4889bcbb4a784,2017,,,1,NM Coulter-Nile,SA Yadav,23,11,2,2,1,6,5,0,1,17,6,2,1
6480bba37e4fcb8af147f79b,2016,,,2,CH Morris,JP Duminy,23,23,1,0,1,12,13,1,0,9,10,0,0
6480bb99ecbdaaf953b8eee5,2023,,,2,KH Pandya,MP Stoinis,23,16,0,2,1,9,9,0,1,13,7,0,1
6480bb945f95e767a8a9cc10,2017,,,2,AJ Finch,BB McCullum,23,11,1,2,1,13,6,1,1,9,5,0,1
6480bb97a4220e27710e38de,2021,,,2,N Rana,Shubman Gill,23,11,2,2,1,1,2,0,0,21,9,2,2
6480bb9e21655ee16a96b2c3,2012,,,1,M Kaif,SS Tiwary,23,22,1,1,1,11,12,1,0,12,10,0,1
6480bb9e28b7a946a6921fa6,2011,,,2,AC Blizzard,SR Tendulkar,23,21,4,0,1,10,11,2,0,13,10,2,0
6480bba071a7a0cbb02d505a,2013,,,1,DA Warner,V Sehwag,23,22,2,1,1,7,8,1,0,14,14,1,1
6480bb9d8f5769d3a514fd88,2009/10,,,1,KP Pietersen,R Dravid,23,21,2,0,1,19,14,2,0,3,7,0,0
6480bb99349f00f851e8d2fd,2023,,,2,SA Yadav,TH David,23,13,1,2,1,13,7,1,1,10,6,0,1
6480bb97f56e9d700b27a098,2021,,,2,PP Shaw,S Dhawan,23,15,3,0,1,13,8,2,0,6,7,1,0
6480bb9d105fba311a23a588,2011,,,1,BJ Hodge,RA Jadeja,23,17,1,1,1,12,8,1,0,11,9,0,1
6480bb94bf9a1728b1b12f4d,2018,,,2,AM Rahane,JC Buttler,23,22,1,0,1,13,11,1,0,10,11,0,0
6480bb9a51ee1ef33a5b2dbb,2007/08,,,1,IK Pathan,PP Chawla,23,9,3,1,0,1,2,0,0,21,7,3,1
6480bba1c0aa361f3c6e454c,2015,,,2,DJ Bravo,SK Raina,23,11,2,1,0,13,5,1,1,9,6,1,0
6480bb9a9514379c05d59c38,2023,,,1,SV Samson,YBK Jaiswal,23,16,2,1,1,14,10,1,1,6,6,1,0
6480bb94b882fb725e3f98e5,2018,,,2,KS Williamson,YK Pathan,23,19,3,0,1,3,6,0,0,19,13,3,0
6480bba26ca6ec72ba377236,2016,,,2,KM Jadhav,Sachin Baby,23,15,2,0,1,9,7,0,0,14,8,2,0
6480bba16796f9a72374865f,2015,,,1,G Gambhir,SA Yadav,23,14,2,1,1,11,7,2,0,12,7,0,1
6480bb9827e9fb920cf62809,2021,,,2,Shubman Gill,VR Iyer,23,28,2,0,1,15,14,2,0,8,14,0,0
6480bb9b166300b6298fc71a,2009,,,1,RR Powar,Yuvraj Singh,23,15,1,1,1,4,4,0,0,17,11,1,1
6480bb97aabcd4374e076d04,2021,,,1,JJ Roy,WP Saha,23,21,0,2,1,2,7,0,0,17,14,0,2
6480bba0eb5a345386bdc825,2013,,,2,R Dravid,STR Binny,23,15,2,1,1,7,7,0,0,16,8,2,1
6480bba38ce35716815a1845,2016,,,1,MK Pandey,YK Pathan,23,19,1,1,1,16,10,1,1,5,9,0,0
6480bb9ce93a7b4315d8fa30,2009,,,2,AB de Villiers,G Gambhir,23,21,1,1,1,15,11,1,1,7,10,0,0
6480bb9ce93a7b4315d8fa30,2009,,,2,KD Karthik,PJ Sangwan,23,5,1,2,0,18,5,1,2,0,0,0,0
6480bb9c89f35f11aae1f2d0,2009/10,,,2,P Dogra,S Narwal,23,16,2,1,1,10,7,0,1,12,9,2,0
6480bb94f46306dbde97aa5c,2017,,,1,KA Pollard,KH Pandya,23,13,3,0,0,9,7,1,0,11,6,2,0
6480bb99b4febfb641fddd39,2023,,,2,GJ Maxwell,V Kohli,23,5,1,3,0,12,3,0,2,10,2,1,1
6480bba255079696d5cfa453,2015,,,2,AR Patel,Sandeep Sharma,23,18,2,1,1,16,9,1,1,7,9,1,0
6480bba0ddcc30675d83403c,2013,,,1,MS Dhoni,SK Raina,23,24,3,0,1,16,19,2,0,7,5,1,0
6480bba29fb420d92aef1d2a,2015,,,2,MC Henriques,S Dhawan,23,23,4,0,1,8,8,1,0,15,15,3,0
6480bb98aae066234fd8f11e,2022,,,1,DA Miller,R Tewatia,23,13,2,1,1,8,5,1,0,14,8,1,1
6480bb972a7d4e1071ea662e,2021,,,2,Lalit Yadav,SO Hetmyer,23,17,2,0,0,6,8,0,0,14,9,2,0
6480bb949f5853dfe76c99d9,2017,,,1,BA Stokes,MS Dhoni,23,18,1,1,1,10,9,1,0,13,9,0,1
6480bb95af5853799812b0f6,2019,,,2,AD Russell,N Rana,23,17,2,1,1,3,4,0,0,19,13,2,1
6480bba0dcd1149b9b0b501f,2013,,,2,EJG Morgan,G Gambhir,23,28,1,0,1,15,15,1,0,8,13,0,0
6480bb99d43295fa2d82c9dc,2023,,,2,Abishek Porel,MK Pandey,23,19,2,0,1,5,8,0,0,18,11,2,0
6480bba287d112bccc55ccd2,2015,,,2,AB de Villiers,Mandeep Singh,23,12,3,0,1,5,4,1,0,16,8,2,0
6480bb96c10dfe3d8c259db3,2020/21,,,2,AM Rahane,SS Iyer,23,22,0,0,1,14,13,0,0,7,9,0,0
6480bb952f20835ddd6e533f,2019,,,1,N Pooran,SN Khan,23,20,2,0,1,12,14,1,0,9,6,1,0
6480bb95d4da0397e79acffa,2019,,,2,MA Agarwal,SN Khan,23,19,2,0,1,10,6,0,0,13,13,2,0
6480bb98cce4ab46512c2c03,2022,,,1,RA Jadeja,S Dube,23,12,2,1,1,13,7,2,0,10,5,0,1
6480bb97aabcd4374e076d04,2021,,,1,PK Garg,WP Saha,23,27,0,0,1,7,10,0,0,13,17,0,0
6480bb956b439141409fd739,2018,,,1,JD Unadkat,S Gopal,23,17,3,0,1,6,7,0,0,17,10,3,0
6480bba065b341458c934986,2013,,,1,DPMD Jayawardene,V Sehwag,23,22,3,0,1,5,7,0,0,17,15,3,0
6480bb973d98bfd2d4a5f108,2020/21,,,2,Shubman Gill,T Banton,23,24,2,0,1,13,12,2,0,8,12,0,0
6480bb971c9e4a3ef11759f3,2021,,,1,CJ Jordan,Mohammed Shami,23,9,1,3,1,23,8,1,3,0,1,0,0
6480bb9fcb2b412c0ebd4afa,2013,,,2,MA Agarwal,MC Henriques,23,18,3,0,1,7,8,0,0,16,10,3,0
6480bb99f816e64203e3c687,2023,,,1,P Simran Singh,S Dhawan,23,12,2,2,1,23,12,2,2,0,0,0,0
6480bba34d78f594b07da1bc,2016,,,2,AR Patel,Gurkeerat Singh,23,14,2,1,1,13,9,1,1,7,5,1,0
6480bb9c07d77f83fb139c41,2009,,,1,HH Gibbs,TL Suman,23,17,1,1,1,4,6,0,0,19,11,1,1
6480bb9e9f1ef9ac02266570,2011,,,2,SC Ganguly,Yuvraj Singh,23,23,2,1,1,20,17,2,1,2,6,0,0
6480bba1827557ebdfc70821,2015,,,1,V Sehwag,WP Saha,23,19,2,1,1,7,8,1,0,15,11,1,1
6480bb9af85f41b4de44ca19,2023,,,1,AT Rayudu,RA Jadeja,23,17,0,1,1,13,8,0,1,10,9,0,0
6480bb97746881ab34c38bf8,2020/21,,,2,Ishan Kishan,Q de Kock,23,26,1,1,1,16,15,1,1,7,11,0,0
6480bba04b49d2ff5f997e02,2013,,,2,B Chipli,DPMD Jayawardene,23,17,2,1,1,12,12,1,1,5,5,1,0
6480bb93d5dc00a79edede9c,2017,,,2,BCJ Cutting,NV Ojha,23,13,3,0,1,16,9,3,0,5,4,0,0
6480bb97ea8bfb43e3f7515f,2020/21,,,2,M Vijay,SR Watson,23,26,2,1,1,9,10,1,0,14,16,1,1
6480bb9c44492d9e5fc4bb60,2009/10,,,2,JH Kallis,P Kumar,23,12,2,1,0,19,7,2,1,3,5,0,0
6480bb99cbb648c5c0ecb205,2023,,,1,AD Russell,D Wiese,23,15,1,2,1,15,9,1,1,8,6,0,1
6480bb99a620a7afdb3217fe,2023,,,1,JC Buttler,R Parag,23,24,0,1,1,15,13,0,1,7,11,0,0
6480bb9435048f20502ba1e1,2018,,,1,BB McCullum,M Vohra,23,22,1,1,1,6,8,1,0,15,14,0,1
6480bb9c442caaabe9eb2275,2009,,,2,AM Rahane,Harbhajan Singh,23,17,2,1,1,12,11,2,0,10,6,0,1
6480bb939b2499e9af6ee18c,2017,,,2,JJ Roy,KD Karthik,23,14,1,1,0,14,7,1,1,8,7,0,0
6480bb9e41b781523bd5aafe,2012,,,1,DB Das,G Gambhir,23,16,0,2,1,18,9,0,2,4,7,0,0
6480bba234aac105851964b1,2015,,,2,CH Gayle,V Kohli,23,25,2,2,1,11,16,1,1,12,9,1,1
6480bb9b17739118ee6c3bd0,2007/08,,,1,DB Das,LR Shukla,23,17,1,1,1,12,9,1,0,11,8,0,1
6480bba0bc196f7168b3d989,2013,,,2,Mandeep Singh,SE Marsh,23,24,3,0,1,10,12,1,0,12,12,2,0
6480bba1abec4894f2f69a35,2014,,,1,RA Jadeja,SK Raina,23,22,0,0,0,10,9,0,0,12,13,0,0
6480bb9814efd9a91e8c911f,2021,,,2,C Sakariya,R Tewatia,23,25,2,1,1,1,5,0,0,21,20,2,1
6480bba1ebb63d1bd8c60b9d,2014,,,2,KP Pietersen,MK Tiwary,23,21,1,0,1,14,10,1,0,8,11,0,0
6480bb94fbd0b904d63e0e07,2017,,,1,SE Marsh,WP Saha,23,12,3,1,1,20,8,3,1,2,4,0,0
6480bb9d038ed22e46cbeccb,2011,,,2,AT Rayudu,SR Tendulkar,23,19,2,0,1,7,6,0,0,13,13,2,0
6480bb99fe078839da40e7ab,2023,,,1,AD Russell,JJ Roy,23,20,1,1,1,13,11,0,1,9,9,1,0
6480bb950ddd55d8aed7d015,2019,,,2,CA Lynn,RV Uthappa,23,14,2,1,1,12,6,1,1,11,8,1,0
6480bb9a7577454a5220c94b,2007/08,,,1,RV Uthappa,YV Takawale,23,16,3,0,1,13,9,2,0,8,7,1,0
6480bb9837deb0fb66704166,2022,,,2,DJ Hooda,KH Pandya,23,19,0,1,1,4,5,0,0,19,14,0,1
6480bb9ce93a7b4315d8fa30,2009,,,2,AB de Villiers,V Sehwag,23,25,1,0,1,11,15,0,0,11,10,1,0
6480bb9802d8f5ec4413766d,2022,,,1,B Sai Sudharsan,MS Wade,23,20,4,0,1,11,9,2,0,12,11,2,0
6480bb9b09e6c98206422ae5,2009,,,1,SB Bangar,SC Ganguly,23,19,3,0,1,2,9,0,0,16,10,3,0
6480bba2fbc243afec641844,2015,,,1,AR Patel,DA Miller,23,24,1,0,1,9,14,0,0,9,10,1,0
6480bba1d9f266a28a109f29,2015,,,2,MA Agarwal,SS Iyer,23,17,4,0,1,15,12,3,0,6,5,1,0
6480bb9ec07aa72ec89917f0,2012,,,2,DJ Bravo,MS Dhoni,23,41,0,0,1,12,23,0,0,11,18,0,0
6480bb96d1b3bea0aa2127e4,2020/21,,,2,AD Russell,EJG Morgan,23,21,2,1,1,11,11,2,0,10,10,0,1
6480bb99537b54b870dc74d1,2023,,,1,PBB Rajapaksa,SM Curran,23,27,0,1,1,4,9,0,0,16,18,0,1
6480bba328f7475f4b87d3ff,2016,,,2,G Gambhir,RV Uthappa,23,19,3,0,1,8,8,1,0,13,11,2,0
6480bba133267f04941acf7d,2014,,,1,DA Warner,NV Ojha,23,17,0,3,1,9,5,0,1,13,12,0,2
6480bb9cafc843037dc1e863,2009,,,1,JH Kallis,V Kohli,23,23,3,0,1,12,10,2,0,8,13,1,0
6480bb9fcb2b412c0ebd4afa,2013,,,1,A Ashish Reddy,GH Vihari,23,18,1,1,1,14,12,0,1,9,6,1,0
6480bb9a17692bfb5bd3894c,2007/08,,,1,PA Patel,SP Fleming,23,22,3,0,1,7,9,1,0,13,13,2,0
6480bb9e173228d1b18e376b,2012,,,1,IK Pathan,Y Nagar,23,11,1,2,1,3,4,0,0,18,7,1,2
6480bb9eee740f701b0ee154,2011,,,2,AB McDonald,IK Pathan,23,13,2,0,1,8,7,0,0,15,6,2,0
6480bb9b2ca4a7b325526f1f,2009,,,1,AC Gilchrist,RG Sharma,23,28,1,1,1,14,19,1,1,6,9,0,0
6480bb9754755bb7a7427d52,2021,,,1,AD Russell,KD Karthik,23,15,2,1,1,9,7,0,1,10,8,2,0
6480bb973e3a3dbbb7ae3707,2020/21,,,1,S Dhawan,SO Hetmyer,23,15,1,1,1,13,9,1,0,10,6,0,1
6480bb9baccf501985a56d64,2007/08,,,1,SK Warne,SR Watson,23,16,2,1,1,11,12,1,0,12,4,1,1
6480bb9404b444be6724e41e,2017,,,2,MK Tiwary,Washington Sundar,23,10,0,2,1,13,7,0,2,5,3,0,0
6480bb99cf7659c6e45bd01d,2023,,,2,AM Rahane,DP Conway,23,22,2,0,1,9,10,0,0,14,12,2,0
6480bb96ed06a5693a66b9f0,2020/21,,,2,AJ Finch,D Padikkal,23,21,0,2,1,14,11,0,2,7,10,0,0
6480bba0ad06ad631cf7665f,2014,,,1,BB McCullum,DR Smith,23,20,3,0,1,9,10,1,0,13,10,2,0
6480bb9db6a011b38afed5dc,2011,,,1,GC Smith,M Manhas,23,24,3,0,1,14,12,2,0,8,12,1,0
6480bb981f136a7564719d7f,2022,,,1,JM Bairstow,S Dhawan,23,17,5,0,1,8,8,2,0,15,9,3,0
6480bb949a2d28d1ad7d367f,2018,,,1,G Gambhir,V Shankar,23,20,1,0,1,9,7,1,0,13,13,0,0
6480bb96a467817b9b68ca94,2020/21,,,2,DA Warner,JM Bairstow,23,21,2,0,1,9,13,0,0,12,8,2,0
6480bba1b85900d7d83de308,2014,,,1,NV Ojha,S Dhawan,23,18,0,1,1,12,9,0,1,6,9,0,0
6480bb9e1a26096ce68e9ca3,2012,,,2,TM Dilshan,V Kohli,23,22,3,0,1,7,6,1,0,16,16,2,0
6480bb95f2e3c32afe233820,2018,,,1,KS Williamson,S Dhawan,23,20,2,0,1,17,11,2,0,5,9,0,0
6480bb9de80788b3c3ebe4e1,2009/10,,,1,AA Jhunjhunwala,FY Fazal,23,21,1,1,1,9,9,0,1,9,12,1,0
6480bba1448ab5c40ac64696,2014,,,2,AT Rayudu,LMP Simmons,23,18,2,1,1,9,9,0,1,11,9,2,0
6480bb964592640608a9163c,2020/21,,,1,DA Warner,JM Bairstow,23,28,1,1,1,7,9,1,0,16,19,0,1
6480bb964a4d5a1709db428e,2020/21,,,1,Q de Kock,RG Sharma,23,17,3,1,1,13,9,1,1,9,8,2,0
6480bb9c121ee402b7b2eda6,2009,,,2,HH Gibbs,TL Suman,23,25,1,0,1,8,13,0,0,12,12,1,0
6480bb99cbb648c5c0ecb205,2023,,,1,N Jagadeesan,Rahmanullah Gurbaz,23,17,4,0,1,19,15,4,0,3,2,0,0
6480bb9836af59f8283f4081,2022,,,2,Ishan Kishan,RG Sharma,23,15,3,1,1,20,10,3,1,2,5,0,0
6480bb981b01a21305fd65d5,2022,,,1,B Sai Sudharsan,DA Miller,23,30,0,0,1,12,16,0,0,11,14,0,0
6480bb9dfa7d0510ae3a7b40,2011,,,2,CL White,S Sohal,23,16,1,1,1,6,7,0,0,16,9,1,1
6480bb955f4b3a84d6973620,2018,,,2,K Gowtham,RA Tripathi,23,12,2,1,1,13,4,1,1,9,8,1,0
6480bb9932735ca83d38f6e7,2022,,,2,AK Markram,Washington Sundar,23,13,0,3,1,21,10,0,3,2,3,0,0
6480bba250b404cdcbff22c8,2015,,,2,LMP Simmons,RG Sharma,23,18,1,1,1,13,11,0,1,10,7,1,0
6480bba15b304732a6212cdf,2015,,,2,DA Warner,RS Bopara,23,20,1,1,1,15,10,1,1,8,10,0,0
6480bb94cb5adf24f5ad15c3,2017,,,1,JJ Bumrah,MJ McClenaghan,23,15,0,2,1,15,10,0,1,8,5,0,1
6480bb9f5867d07199aa832a,2013,,,1,M Vijay,SK Raina,23,24,3,0,1,14,14,2,0,8,10,1,0
6480bb9561509a2f4f139254,2019,,,2,SPD Smith,SV Samson,23,21,2,0,1,10,11,1,0,13,10,1,0
6480bb94457bfc7687322f80,2017,,,1,A Choudhary,S Aravind,23,23,1,0,1,15,12,1,0,6,11,0,0
6480bba1448ab5c40ac64696,2014,,,2,KA Pollard,RG Sharma,23,20,2,0,1,9,10,0,0,14,10,2,0
6480bb9a7f7a862ba0b2c59e,2007/08,,,2,SB Styris,Shahid Afridi,23,11,2,2,0,2,5,0,0,20,6,2,2
6480bb9b7557e68b433167d5,2007/08,,,2,GC Smith,Kamran Akmal,23,17,0,2,1,12,10,0,1,11,7,0,1
6480bb9e1d754facf4fad618,2012,,,1,DJ Bravo,MS Dhoni,23,14,1,1,1,12,8,0,1,10,6,1,0
6480bb9d91920239b62f48ad,2009/10,,,1,LRPL Taylor,V Kohli,23,21,0,1,1,8,10,0,0,15,11,0,1
6480bba23b270561e8026bd2,2015,,,1,A Ashish Reddy,KV Sharma,23,21,0,1,1,17,15,0,1,6,6,0,0
6480bb9ee779ef1e445d0506,2012,,,2,M Kartik,SPD Smith,23,13,3,1,1,13,6,1,1,10,7,2,0
6480bb98bc3569cc8d04101a,2022,,,1,KA Pollard,Tilak Varma,23,5,0,3,0,22,5,0,3,0,0,0,0
6480bba0a4e7c61a5656729e,2014,,,2,MA Starc,VR Aaron,23,28,0,0,1,5,14,0,0,10,14,0,0
6480bb9506d56930505d45ae,2019,,,1,Mandeep Singh,R Ashwin,23,21,2,0,1,14,13,1,0,9,8,1,0
6480bb93d9581d69657887c3,2017,,,2,CH Morris,RR Pant,23,13,1,2,1,4,5,0,0,18,8,1,2
6480bb99349f00f851e8d2fd,2023,,,1,JM Sharma,SM Curran,22,8,2,2,1,13,3,0,2,9,5,2,0
6480bb99695e001cdaca81e0,2022,,,2,TH David,Tilak Varma,22,13,0,2,0,16,7,0,2,6,6,0,0
6480bba2a01f4062fc561247,2016,,,1,GJ Maxwell,SE Marsh,22,16,2,0,1,4,7,0,0,15,9,2,0
6480bba1c0aa361f3c6e454c,2015,,,2,MS Dhoni,SK Raina,22,16,2,1,1,3,6,0,0,17,10,2,1
6480bb988545a7776b8c9306,2022,,,2,JR Hazlewood,Mohammed Siraj,22,16,3,0,0,7,7,0,0,14,9,3,0
6480bb97a42828c5a5ebef1c,2020/21,,,1,Ishan Kishan,SA Yadav,22,25,2,0,1,6,7,0,0,16,18,2,0
6480bb9a51ee1ef33a5b2dbb,2007/08,,,2,Mohammad Hafeez,SC Ganguly,22,17,2,1,1,12,10,1,1,5,7,1,0
6480bba0ddcc30675d83403c,2013,,,2,S Dhawan,X Thalaivan Sargunam,22,22,2,0,0,14,9,2,0,8,13,0,0
6480bb93c1cc671d66c471ba,2017,,,1,KA Pollard,N Rana,22,24,1,1,1,17,17,1,1,5,7,0,0
6480bb9558c0acb502a3b1a9,2019,,,1,MA Agarwal,SN Khan,22,20,3,0,1,5,7,0,0,17,13,3,0
6480bb9b0b09749af4aa32dd,2009,,,2,BJ Hodge,CH Gayle,22,23,0,1,0,10,14,0,0,12,9,0,1
6480bb9b2e179d359c1d446d,2009,,,2,M Manhas,TM Dilshan,22,10,2,1,0,3,2,0,0,17,8,2,1
6480bb9506d56930505d45ae,2019,,,1,Harpreet Brar,R Ashwin,22,16,3,0,1,13,10,2,0,7,6,1,0
6480bb9c21492b9a562c6f46,2009/10,,,1,AC Voges,MM Patel,22,10,0,2,0,16,7,0,2,4,3,0,0
6480bb98de3641699db2c5a1,2021,,,2,RV Patel,S Dhawan,22,24,2,0,1,18,20,2,0,4,4,0,0
6480bba0208e8fbb34afdc50,2013,,,1,CA Pujara,CH Gayle,22,25,3,0,1,19,20,3,0,3,5,0,0
6480bb95481ab7c06b86419b,2018,,,1,RR Pant,SS Iyer,22,22,3,0,1,19,14,3,0,3,8,0,0
6480bba154ce29a67e4752df,2015,,,1,CH Gayle,V Kohli,22,19,1,0,1,7,9,0,0,10,10,1,0
6480bb9a1e358307d26cd50d,2023,,,1,B Sai Sudharsan,HH Pandya,22,14,2,1,1,5,5,1,0,16,9,1,1
6480bb994aafcf67cd092a7d,2023,,,2,Shubman Gill,WP Saha,22,13,4,1,1,8,6,2,0,14,7,2,1
6480bb9ddfb0f2f6f8e813e5,2011,,,1,BJ Hodge,DPMD Jayawardene,22,31,2,0,1,14,14,2,0,7,17,0,0
6480bb9ba6cd609c32579bde,2009,,,1,BJ Hodge,LR Shukla,22,16,0,1,1,14,9,0,1,6,7,0,0
6480bb9c968c81bdfcc6df5b,2009,,,2,AC Gilchrist,HH Gibbs,22,8,5,0,1,20,6,5,0,0,2,0,0
6480bb9da3dc1406b000cc98,2011,,,2,IK Pathan,V Sehwag,22,17,2,0,1,7,8,0,0,15,9,2,0
6480bb9ec90f99c5ea40b014,2012,,,1,G Gambhir,JH Kallis,22,24,3,0,1,11,11,2,0,10,13,1,0
6480bb9c07d77f83fb139c41,2009,,,2,B Lee,DPMD Jayawardene,22,9,1,2,1,3,4,0,0,18,5,1,2
6480bba278153a5979e31ec9,2016,,,2,DR Smith,SK Raina,22,16,3,0,1,17,10,3,0,5,6,0,0
6480bb9dd778cb6c44535092,2009/10,,,2,AT Rayudu,R Sathish,22,13,3,0,1,15,9,2,0,6,4,1,0
6480bb96a43476c5d9a56c4e,2020/21,,,2,AT Carey,S Dhawan,22,15,2,1,1,4,7,0,0,18,8,2,1
6480bb9a8ac627a1ebf8dacf,2007/08,,,2,ML Hayden,PA Patel,22,24,3,0,1,13,19,2,0,7,5,1,0
6480bb9404b444be6724e41e,2017,,,1,A Mishra,KK Nair,22,12,2,1,1,10,6,0,1,11,6,2,0
6480bb97fcc6fccd233157f9,2021,,,2,SV Samson,T Shamsi,22,16,1,1,0,18,12,1,1,2,4,0,0
6480bba065b341458c934986,2013,,,2,B Lee,R Bhatia,22,10,1,2,0,16,6,0,2,6,4,1,0
6480bb9a7d91d721555835e5,2007/08,,,1,SK Warne,YK Pathan,22,13,1,1,1,6,7,0,0,13,6,1,1
6480bb9b9d7aa6d8e47576d7,2007/08,,,2,Kamran Akmal,SA Asnodkar,22,18,3,0,1,6,6,1,0,16,12,2,0
6480bba23b270561e8026bd2,2015,,,1,DW Steyn,P Kumar,22,15,3,0,1,19,11,3,0,2,4,0,0
6480bb9480627b50308b7903,2017,,,2,PA Patel,RG Sharma,22,21,3,0,1,17,8,3,0,5,13,0,0
6480bb9a577cde04d3672225,2023,,,2,RA Jadeja,S Dube,22,13,1,1,0,15,6,1,1,7,7,0,0
6480bb96c0ffb76dab723a2b,2019,,,1,RR Pant,SE Rutherford,22,19,0,1,1,7,7,0,0,10,12,0,1
6480bb94c2dcb1007bf6788b,2017,,,1,Mandeep Singh,V Kohli,22,13,3,1,1,16,7,2,1,6,6,1,0
6480bb9c12f907c7b81b11a9,2009,,,2,NV Ojha,RJ Quiney,22,7,0,3,1,21,5,0,3,1,2,0,0
6480bb9bbb0ec0266749f518,2007/08,,,2,AC Gilchrist,VVS Laxman,22,23,3,0,1,10,11,2,0,10,12,1,0
6480bb9adb5d9ca80cb1c6a0,2023,,,1,SO Hetmyer,SV Samson,22,9,2,1,0,7,5,0,0,14,4,2,1
6480bb988545a7776b8c9306,2022,,,2,Anuj Rawat,GJ Maxwell,22,11,1,2,1,1,3,0,0,21,8,1,2
6480bb9d6919e7181371271f,2011,,,2,P Kumar,R McLaren,22,12,1,1,1,3,5,0,0,16,7,1,1
6480bb932d6ccb8870dcd72d,2017,,,2,BA Stokes,MS Dhoni,22,19,1,1,1,15,8,1,1,5,11,0,0
6480bba15b304732a6212cdf,2015,,,2,KS Williamson,RS Bopara,22,11,0,2,1,6,6,0,0,14,5,0,2
6480bb95ff5da0069bc5274e,2018,,,2,KK Nair,KL Rahul,22,13,0,2,1,3,6,0,0,18,7,0,2
6480bb9341152e168005ccc9,2017,,,1,P Negi,STR Binny,22,10,1,2,1,10,7,0,1,11,3,1,1
6480bba069d61566bb63ac2b,2014,,,2,RV Uthappa,SA Yadav,22,11,0,2,1,10,5,0,1,12,6,0,1
6480bb94988cb8c136ec7e46,2018,,,2,AT Rayudu,M Vijay,22,13,2,1,1,11,6,2,0,11,7,0,1
6480bb96ebf33df82879ad4c,2020/21,,,1,DA Warner,KS Williamson,22,22,3,0,1,13,10,2,0,9,12,1,0
6480bb946efcc4cd9aa80399,2018,,,1,CR Woakes,Mandeep Singh,22,10,2,2,1,5,4,1,0,17,6,1,2
6480bb9d54ae15d3d0ed9e5e,2011,,,1,BJ Hodge,RV Gomez,22,6,2,2,0,21,5,2,2,1,1,0,0
6480bb99315aee6cd9d56504,2023,,,2,DJ Hooda,KL Rahul,22,19,2,0,1,9,10,1,0,8,9,1,0
6480bb9f23c17ccb47aa9e58,2013,,,2,DJ Hussey,R Sathish,22,19,3,0,1,10,7,1,0,11,12,2,0
6480bb9f7258f976eb8fe943,2012,,,1,AM Rahane,SR Watson,22,23,3,0,1,13,12,2,0,5,11,1,0
6480bb97ce981c1918dce924,2021,,,1,NM Coulter-Nile,SA Yadav,22,11,4,0,1,3,3,0,0,19,8,4,0
6480bba20559f15c3489f637,2015,,,2,GH Vihari,RS Bopara,22,18,3,0,1,15,8,3,0,6,10,0,0
6480bb9c12e6c723b248799b,2009,,,1,LRPL Taylor,R Dravid,22,19,2,0,1,15,11,2,0,6,8,0,0
6480bb96c3293977af83acbf,2019,,,2,CA Ingram,RR Pant,22,37,0,0,1,12,23,0,0,10,14,0,0
6480bb98b8bb5b0d2c2f0848,2022,,,2,AT Rayudu,S Dube,22,23,0,2,1,9,9,0,1,13,14,0,1
6480bb9ab655ac367694708c,2007/08,,,2,D Salunkhe,RA Jadeja,22,13,2,1,1,7,6,1,0,13,7,1,1
6480bb9d6ea22feab98beb5b,2011,,,2,AM Rahane,LRPL Taylor,22,18,2,0,1,4,8,0,0,16,10,2,0
6480bba29fb420d92aef1d2a,2015,,,1,PP Chawla,YK Pathan,22,12,3,0,0,9,6,1,0,13,6,2,0
6480bba154ce29a67e4752df,2015,,,1,AB de Villiers,RR Rossouw,22,6,2,2,1,22,5,2,2,0,1,0,0
6480bb9b82dc3ec84c520466,2009,,,1,MV Boucher,RE van der Merwe,22,17,0,2,1,12,8,0,1,9,9,0,1
6480bb9c454e9eefca545bde,2009/10,,,1,RS Bopara,Yuvraj Singh,22,19,0,1,1,5,6,0,0,15,13,0,1
6480bba2ebdcfb98389cee5a,2015,,,2,DJ Bravo,MS Dhoni,22,13,1,2,1,8,8,0,1,13,5,1,1
6480bb9c9f9d5376b4227724,2009/10,,,1,MK Tiwary,SC Ganguly,22,15,2,1,1,5,7,0,0,16,8,2,1
6480bb9aa37f3b44678752d9,2023,,,2,DA Miller,V Shankar,22,14,4,0,1,5,6,1,0,15,8,3,0
6480bb9eda28fb340ed37b49,2012,,,2,DB Das,MK Tiwary,22,16,2,0,0,9,8,1,0,11,8,1,0
6480bba0adee98d459585bed,2014,,,2,AT Rayudu,CJ Anderson,22,20,3,0,1,10,11,1,0,12,9,2,0
6480bb956e3f7f62e4b24c01,2019,,,1,AM Rahane,BA Stokes,22,16,3,0,1,13,8,2,0,8,8,1,0
6480bb95d675b7da24db1a57,2019,,,1,AD Russell,Shubman Gill,22,10,3,1,1,6,5,1,0,15,5,2,1
6480bb9e56c724ba25b94666,2011,,,1,AC Gilchrist,PC Valthaty,22,22,4,0,1,6,8,1,0,14,14,3,0
6480bb948211fe47e65f2e77,2018,,,1,Mohammad Nabi,YK Pathan,22,18,3,0,1,14,10,2,0,7,8,1,0
6480bb94d8ce46258c13e90e,2017,,,2,BA Stokes,MS Dhoni,22,19,2,0,1,17,12,2,0,5,7,0,0
6480bb9ea1e127d68e288e04,2011,,,2,BJ Hodge,OA Shah,22,9,1,2,1,19,6,1,2,3,3,0,0
6480bb9bc8bcea920f081be8,2009,,,2,KD Karthik,TM Dilshan,22,15,2,1,1,12,9,1,1,8,6,1,0
6480bb9d182be5b0fbe5a4e2,2011,,,2,DJ Jacobs,SR Tendulkar,22,19,1,1,1,15,15,0,1,6,4,1,0
6480bb9d0f6794fbf429449b,2011,,,2,R Vinay Kumar,RV Gomez,22,18,1,1,1,11,10,1,0,10,8,0,1
6480bb9e300070746cc2eb67,2011,,,2,A Mithun,SS Tiwary,22,16,3,0,1,11,8,2,0,8,8,1,0
6480bb9a5d25d853e1cbfe3e,2007/08,,,2,JR Hopes,KC Sangakkara,22,10,3,1,1,2,2,0,0,20,8,3,1
6480bb9dc4ec5a52f8bcc465,2009/10,,,1,IK Pathan,KC Sangakkara,22,12,2,1,1,8,3,0,1,14,9,2,0
6480bb99864a94e086c8395e,2022,,,2,DR Sams,Tilak Varma,22,16,1,1,1,13,7,0,1,8,9,1,0
6480bb9763013a01eae041f2,2020/21,,,2,DA Warner,KS Williamson,22,15,1,1,1,18,10,1,1,3,5,0,0
6480bb970c637fd0c057dca9,2021,,,2,KM Jadhav,Mohammad Nabi,22,9,1,2,1,5,4,0,0,17,5,1,2
6480bb99d2bd76016d47896d,2023,,,1,A Badoni,KH Pandya,22,8,1,2,1,18,7,1,2,1,1,0,0
6480bba0c3cc8c51bc6c1c3a,2013,,,2,A Mukund,V Kohli,22,24,0,0,1,11,12,0,0,9,12,0,0
6480bba1587a54176a9badf4,2014,,,1,RV Uthappa,YK Pathan,22,11,1,2,1,19,8,1,2,3,3,0,0
6480bb94457bfc7687322f80,2017,,,1,CH Gayle,V Kohli,22,23,1,1,1,8,10,1,0,10,13,0,1
6480bb982f070b023b901b3e,2021,,,1,HH Pandya,KH Pandya,22,25,3,0,1,15,14,2,0,6,11,1,0
6480bb9a6ecee5429e0468be,2023,,,1,A Badoni,K Gowtham,22,10,1,2,1,21,7,1,2,1,3,0,0
6480bb9ef7c6084992b7cdf8,2012,,,2,A Mishra,B Chipli,22,12,2,1,1,6,6,0,0,15,6,2,1
6480bb9a1a3ab2ab8297871d,2007/08,,,1,AC Gilchrist,VVS Laxman,22,14,5,0,1,13,9,3,0,9,5,2,0
6480bb9a61edc0c77bc4bc86,2007/08,,,2,MS Gony,S Badrinath,22,10,2,1,0,13,5,1,1,8,5,1,0
6480bb9f3700dfaa08e18c43,2012,,,2,MS Dhoni,SK Raina,22,19,1,2,1,5,9,1,0,16,10,0,2
6480bba0c3cc8c51bc6c1c3a,2013,,,2,R Vinay Kumar,SS Tiwary,22,6,0,3,0,22,6,0,3,0,0,0,0
6480bb950ced01a335bd7833,2019,,,1,AB de Villiers,PA Patel,22,12,4,0,1,13,9,2,0,9,3,2,0
6480bb9f0f959bc6104820c3,2013,,,2,AM Rahane,MDKJ Perera,22,18,4,0,1,7,6,1,0,14,12,3,0
6480bba2eea6f31945e4c5e2,2016,,,2,MJ McClenaghan,RG Sharma,22,10,0,3,1,20,8,0,3,2,2,0,0
6480bba2e8614b1263627c1b,2015,,,1,SPD Smith,SR Watson,22,18,5,0,1,10,6,2,0,12,12,3,0
6480bb9a365c63af4b3de24c,2023,,,1,LS Livingstone,P Simran Singh,22,17,4,0,1,4,5,1,0,13,12,3,0
6480bba0c3cc8c51bc6c1c3a,2013,,,2,MC Henriques,SS Tiwary,22,15,2,0,1,13,8,2,0,7,7,0,0
6480bb98cce4ab46512c2c03,2022,,,1,MM Ali,S Dube,22,16,4,0,1,8,8,1,0,14,8,3,0
6480bb95945c5e5dc4d8c7d6,2019,,,2,AB de Villiers,C de Grandhomme,22,14,1,2,1,18,7,1,2,2,7,0,0
6480bb9e9f1ef9ac02266570,2011,,,1,DT Christian,JP Duminy,22,21,2,0,1,10,11,1,0,12,10,1,0
6480bb973e3a3dbbb7ae3707,2020/21,,,2,DJ Hooda,GJ Maxwell,22,20,3,0,1,6,11,0,0,16,9,3,0
6480bba388682c5ca10ff37a,2016,,,2,DJ Hooda,Yuvraj Singh,22,15,2,1,1,3,6,0,0,19,9,2,1
6480bb970d7cbd85b6ada680,2021,,,2,RM Patidar,Shahbaz Ahmed,22,15,2,1,1,14,7,1,1,6,8,1,0
6480bb98634dba60191637ad,2021,,,1,AK Markram,DJ Hooda,22,18,1,0,1,11,10,1,0,9,8,0,0
6480bba2bbd9d85769220a68,2015,,,2,JP Duminy,SS Tiwary,22,15,0,1,1,11,8,0,0,11,7,0,1
6480bb9e80233e83b9d1be1f,2012,,,2,DPMD Jayawardene,V Sehwag,22,25,1,0,1,12,14,1,0,10,11,0,0
6480bb932d6ccb8870dcd72d,2017,,,1,HM Amla,WP Saha,22,15,3,1,1,8,6,0,1,14,9,3,0
6480bba031c5cf0145ae8cfe,2014,,,1,AM Nayar,AM Rahane,22,18,2,1,1,9,10,0,1,13,8,2,0
6480bb94988cb8c136ec7e46,2018,,,1,MA Agarwal,Yuvraj Singh,22,16,2,1,1,4,5,0,0,18,11,2,1
6480bb9d918bd358d046889d,2011,,,2,DL Vettori,J Syed Mohammad,22,15,3,0,0,8,5,1,0,13,10,2,0
6480bb9d02d996f85dd5e945,2011,,,2,JA Morkel,MS Dhoni,22,11,1,2,0,9,4,0,1,13,7,1,1
6480bb9f2305d07e3c65be11,2013,,,1,CL White,GH Vihari,22,23,2,0,1,5,10,0,0,17,13,2,0
6480bb97752fcb9cd9f23692,2021,,,1,KL Rahul,MA Agarwal,22,16,3,0,1,7,7,1,0,14,9,2,0
6480bb99ed38bcb4025b8d86,2023,,,2,KD Karthik,MG Bracewell,22,16,2,1,1,9,7,1,0,12,9,1,1
6480bb93ff8d1f4cd07859ce,2017,,,1,S Dhawan,Yuvraj Singh,22,12,2,1,1,19,9,2,1,3,3,0,0
6480bb94a0422f6d0abe276b,2017,,,1,G Gambhir,SP Jackson,22,9,4,0,0,9,4,2,0,12,5,2,0
6480bb9dbefe5e2cceb23e01,2011,,,2,S Anirudha,S Badrinath,22,22,1,1,1,9,9,0,1,9,13,1,0
6480bb9a7d91d721555835e5,2007/08,,,2,DB Das,DJ Hussey,22,18,1,0,1,9,9,1,0,11,9,0,0
6480bb9e1d754facf4fad618,2012,,,1,MS Dhoni,RA Jadeja,22,7,2,2,1,15,4,2,1,7,3,0,1
6480bb9efe3f9991539e7f6c,2012,,,2,AD Mathews,RV Uthappa,22,17,2,1,1,11,9,2,0,10,8,0,1
6480bb98af25209ef756aa2c,2021,,,2,Ishan Kishan,RG Sharma,22,20,1,1,1,8,10,1,0,13,10,0,1
6480bb98634dba60191637ad,2021,,,1,Harpreet Brar,NT Ellis,22,23,0,1,1,8,11,0,0,12,12,0,1
6480bb9aa37f3b44678752d9,2023,,,1,N Wadhera,SA Yadav,22,13,2,1,1,15,7,1,1,7,6,1,0
6480bb9aab9770e7260312df,2007/08,,,1,RG Sharma,SB Bangar,22,24,0,1,1,13,10,0,1,8,14,0,0
6480bba2b341a081c069198d,2015,,,2,AM Rahane,SPD Smith,22,20,2,0,1,10,7,1,0,12,13,1,0
6480bb9efe3f9991539e7f6c,2012,,,2,M Manhas,SPD Smith,22,21,1,0,1,5,8,0,0,13,13,1,0
6480bb99f2a793884331579e,2023,,,2,Ishan Kishan,SA Yadav,22,16,2,1,1,15,9,1,1,7,7,1,0
6480bba1448ab5c40ac64696,2014,,,1,Shakib Al Hasan,YK Pathan,22,15,3,0,1,9,8,1,0,12,7,2,0
6480bb9a07d46704efe103ef,2007/08,,,2,CL White,V Kohli,22,9,3,1,1,12,4,1,1,9,5,2,0
6480bb99bb362e3714226928,2022,,,2,DJ Hooda,MP Stoinis,22,17,2,0,1,16,11,2,0,5,6,0,0
6480bba3caa5150f2db7a1dc,2016,,,2,BB McCullum,SK Raina,22,14,1,2,1,2,4,0,0,20,10,1,2
6480bb9e3db1392e753dd785,2012,,,2,DPMD Jayawardene,V Sehwag,22,17,3,0,1,18,14,3,0,2,3,0,0
6480bb93894ff5c944493650,2017,,,1,BB McCullum,JJ Roy,22,19,4,0,1,7,7,1,0,14,12,3,0
6480bb970127afddc00607cc,2021,,,1,DA Warner,JM Bairstow,22,20,2,0,1,12,15,1,0,7,5,1,0
6480bb9827e9fb920cf62809,2021,,,1,KS Williamson,PK Garg,22,19,4,0,1,21,12,4,0,1,7,0,0
6480bba20130c44ed20c9bcf,2016,,,2,AJ Finch,JP Faulkner,22,14,2,0,1,10,6,1,0,7,8,1,0
6480bb9482dff502bff80bcf,2017,,,2,KS Williamson,S Dhawan,22,18,1,1,1,13,12,0,1,5,6,1,0
6480bba107ba9f7f041862c1,2014,,,2,PP Chawla,YK Pathan,22,10,0,3,1,1,2,0,0,21,8,0,3
6480bb98a95cb1650c81c926,2022,,,1,JC Buttler,R Ashwin,22,14,5,0,1,5,5,1,0,17,9,4,0
6480bba03b6f98689b851317,2013,,,2,AC Gilchrist,M Vohra,22,20,2,0,1,8,10,1,0,12,10,1,0
6480bb94c008939d7976abfe,2018,,,1,AM Rahane,JC Buttler,22,16,3,0,1,14,11,2,0,8,5,1,0
6480bb9f9a70ecf3467829df,2013,,,1,M Vijay,MEK Hussey,22,15,2,1,1,3,5,0,0,19,10,2,1
6480bba2b7be71a15b2bb3de,2015,,,2,DR Smith,MEK Hussey,22,28,2,1,1,16,19,1,1,4,9,1,0
6480bba1af9481df8b4f9f0f,2015,,,1,G Gambhir,MK Pandey,22,16,2,0,1,14,10,1,0,6,6,1,0
6480bb9c58b62383739c022e,2009,,,2,RJ Quiney,YK Pathan,22,20,3,0,1,4,6,0,0,17,14,3,0
6480bba0a4e7c61a5656729e,2014,,,1,CA Pujara,V Sehwag,22,25,2,0,1,10,18,1,0,10,7,1,0
6480bb967c50ceac62ba0719,2020/21,,,2,Ishan Kishan,KA Pollard,22,13,2,1,1,12,5,1,1,9,8,1,0
6480bb9f8ab73cf7c77cef03,2012,,,1,AM Rahane,SR Watson,22,22,3,0,1,11,12,2,0,10,10,1,0
6480bba0e883438915efc1e6,2013,,,2,SK Raina,WP Saha,22,19,2,1,1,9,11,1,0,13,8,1,1
6480bb970c637fd0c057dca9,2021,,,2,B Kumar,Sandeep Sharma,22,16,3,0,0,14,10,2,0,8,6,1,0
6480bb94a0422f6d0abe276b,2017,,,1,G Gambhir,MK Pandey,22,15,4,0,1,17,11,3,0,5,4,1,0
6480bb9af85f41b4de44ca19,2023,,,2,Shubman Gill,WP Saha,22,18,2,1,1,9,7,0,1,12,11,2,0
6480bb9db0ecec8acdd30619,2011,,,2,MK Pandey,Yuvraj Singh,22,15,2,1,1,5,5,1,0,17,10,1,1
6480bb9834c7569d5fa64353,2022,,,2,JDS Neesham,R Parag,22,19,0,1,1,9,9,0,0,13,10,0,1
6480bb96ebf33df82879ad4c,2020/21,,,2,AT Rayudu,F du Plessis,22,16,3,0,1,8,9,1,0,12,7,2,0
6480bb97af44a48533f08540,2020/21,,,1,CH Gayle,GJ Maxwell,22,11,1,2,1,15,6,0,2,6,5,1,0
6480bb9c266a85f1960d87e9,2009,,,2,S Sohal,SM Katich,22,19,2,1,1,2,9,0,0,20,10,2,1
6480bb973d64aa91e60b4088,2021,,,1,MS Dhoni,RA Jadeja,22,21,2,0,1,18,17,2,0,3,4,0,0
6480bb9e156723e64d6bd26b,2012,,,2,JEC Franklin,RG Sharma,22,7,1,2,0,7,4,1,0,14,3,0,2
6480bb94c2dcb1007bf6788b,2017,,,2,M Vohra,WP Saha,22,26,0,1,1,16,16,0,1,6,10,0,0
6480bb94d8ce46258c13e90e,2017,,,1,HH Pandya,RG Sharma,22,18,2,0,1,13,11,2,0,5,7,0,0
6480bb9ba9d43057d652a5fe,2009,,,1,KC Sangakkara,RR Powar,22,20,2,0,1,12,10,1,0,10,10,1,0
6480bb9adb5d9ca80cb1c6a0,2023,,,2,Abdul Samad,GD Phillips,22,6,1,3,1,0,1,0,0,22,5,1,3
6480bba1f5d65d6146678a7f,2015,,,1,AD Mathews,NM Coulter-Nile,22,8,1,2,1,20,6,1,2,2,2,0,0
6480bb9a9801c2dda3fe88e9,2007/08,,,1,TM Srivastava,Yuvraj Singh,22,16,1,1,1,7,9,0,0,15,7,1,1
6480bb96f8379d02d3435ceb,2020/21,,,1,KD Karthik,PJ Cummins,22,13,2,1,1,7,6,1,0,14,7,1,1
6480bb98634dba60191637ad,2021,,,2,MK Pandey,WP Saha,22,34,1,0,1,13,23,1,0,7,11,0,0
6480bba3caa5150f2db7a1dc,2016,,,1,MC Henriques,S Dhawan,22,27,2,0,1,14,16,2,0,6,11,0,0
6480bb9908b154f78b12b8fb,2023,,,2,KD Karthik,SS Prabhudessai,22,16,2,0,1,11,7,1,0,10,9,1,0
6480bba2c3207713bd927ce5,2015,,,2,BE Hendricks,DA Miller,22,6,1,3,0,0,0,0,0,22,6,1,3
6480bba2557febf92f9f79ab,2015,,,1,DR Smith,SK Raina,22,24,2,1,1,5,5,0,0,17,19,2,1
6480bb9c2778066dafd78a71,2009/10,,,1,JA Morkel,S Tyagi,22,11,1,2,0,18,7,1,2,3,4,0,0
6480bb9b46b4360184dc19f3,2007/08,,,1,RG Sharma,SB Styris,22,21,2,0,1,10,10,2,0,5,11,0,0
6480bb969d80bbba2884b855,2020/21,,,2,KS Williamson,WP Saha,22,26,2,0,1,5,10,0,0,17,16,2,0
6480bb98f01e4672b988c112,2022,,,2,A Badoni,Q de Kock,22,17,2,0,1,5,7,0,0,17,10,2,0
6480bb965f597c872396f67c,2020/21,,,1,LH Ferguson,Shubman Gill,22,17,4,0,1,16,9,3,0,6,8,1,0
6480bb96acacf3be646d300a,2020/21,,,2,R Ashwin,TU Deshpande,22,11,2,1,1,7,5,1,0,15,6,1,1
6480bba00be5cdbaf6648462,2013,,,2,MS Dhoni,RA Jadeja,22,9,1,2,1,18,7,1,2,3,2,0,0
6480bb96ee2a21f0d9b9f37f,2020/21,,,2,AD Russell,N Rana,22,11,1,2,1,13,8,1,1,8,3,0,1
6480bb958f737f809dfb65e1,2019,,,1,S Dhawan,SS Iyer,22,22,1,1,1,9,11,1,0,12,11,0,1
6480bb954817ed0a4ba25bc2,2018,,,1,Ishan Kishan,SA Yadav,22,14,1,2,1,20,12,1,2,1,2,0,0
6480bb988b447f26d7a96c0c,2022,,,2,JD Unadkat,KA Pollard,22,9,2,1,1,14,6,2,1,4,3,0,0
6480bb9d85a6220ec9bc7dcb,2011,,,1,JD Ryder,MD Mishra,22,19,4,0,1,19,12,4,0,2,7,0,0
6480bb9ac9149c73fdf073b3,2023,,,2,Aman Hakim Khan,DA Warner,22,16,3,0,1,7,9,1,0,11,7,2,0
6480bb96a43476c5d9a56c4e,2020/21,,,1,AT Rayudu,F du Plessis,22,18,1,1,1,14,10,0,1,8,8,1,0
6480bba0e52e9733fc6d9937,2013,,,2,P Awana,P Kumar,21,14,0,2,1,0,2,0,0,19,12,0,2
6480bb9b332c16fba9cd28bc,2009,,,2,SR Tendulkar,ST Jayasuriya,21,21,3,0,1,11,11,2,0,7,10,1,0
6480bba2f05e90a9005771d2,2015,,,1,MC Henriques,S Dhawan,21,11,1,2,1,19,9,1,2,2,2,0,0
6480bba1d3370c13ea1f79f3,2014,,,2,KM Jadhav,R Shukla,21,13,2,1,1,19,8,2,1,1,5,0,0
6480bba3bca9c998d5f3e3d0,2016,,,1,DA Miller,HM Amla,21,14,3,0,1,14,7,2,0,7,7,1,0
6480bb9e8dfd9ba30b93cbd8,2012,,,2,F du Plessis,S Badrinath,21,16,0,2,1,16,9,0,2,5,7,0,0
6480bb99cbb648c5c0ecb205,2023,,,1,AD Russell,RK Singh,21,13,1,2,1,19,10,1,2,2,3,0,0
6480bb9ab49fc97bbb30576f,2023,,,2,DA Miller,Shubman Gill,21,13,1,1,1,6,7,1,0,13,6,0,1
6480bb9ff2e0b1df0c3972c9,2012,,,1,DA Warner,V Sehwag,21,13,3,1,1,14,8,3,0,6,5,0,1
6480bba28257fe87dd859e3e,2015,,,1,GJ Bailey,WP Saha,21,14,2,0,1,8,5,1,0,11,9,1,0
6480bb98291bb8b3f3e8145d,2022,,,2,AM Rahane,VR Iyer,21,15,1,2,1,2,7,0,0,18,8,1,2
6480bba286cca051953c976a,2015,,,2,Anureet Singh,WP Saha,21,32,0,0,1,8,15,0,0,11,17,0,0
6480bb95b33a36f0dd77d1a1,2018,,,1,E Lewis,Ishan Kishan,21,15,0,2,1,15,9,0,2,5,6,0,0
6480bb9bcf9df9e7ae0416ba,2009,,,2,LA Carseldine,NV Ojha,21,18,2,0,1,9,8,1,0,12,10,1,0
6480bb95f214d4f82ab97ee5,2018,,,1,IS Sodhi,JD Unadkat,21,16,3,1,1,1,6,0,0,20,10,3,1
6480bb98b8bb5b0d2c2f0848,2022,,,1,D Brevis,SA Yadav,21,13,3,0,1,3,5,0,0,18,8,3,0
6480bba11eff9b230a172302,2014,,,1,G Gambhir,MS Bisla,21,22,2,0,1,15,13,2,0,3,9,0,0
6480bb9f36da1a646c80be45,2013,,,2,IK Pathan,MC Juneja,21,18,0,0,1,10,12,0,0,4,6,0,0
6480bba3fc9599eca1b87a77,2016,,,2,AD Nath,AJ Finch,21,21,2,0,1,3,6,0,0,16,15,2,0
6480bb9c2778066dafd78a71,2009/10,,,1,JA Morkel,L Balaji,21,14,1,1,1,5,4,0,0,15,10,1,1
6480bb9754755bb7a7427d52,2021,,,1,N Rana,RA Tripathi,21,15,1,1,1,11,10,0,1,10,5,1,0
6480bb933fdc96ee7273400e,2017,,,2,HH Pandya,KA Pollard,21,17,1,1,1,6,8,0,0,14,9,1,1
6480bb9a51ee1ef33a5b2dbb,2007/08,,,1,KC Sangakkara,SE Marsh,21,13,4,0,0,10,10,2,0,9,3,2,0
6480bb9eb14c6138aebfbf98,2012,,,2,G Gambhir,MS Bisla,21,24,1,1,1,8,10,1,0,11,14,0,1
6480bb9ded279701c84af803,2011,,,1,JA Morkel,MS Dhoni,21,9,0,3,1,19,6,0,3,1,3,0,0
6480bb95cf9d446747bd74fe,2019,,,2,AT Rayudu,SR Watson,21,16,4,0,1,5,5,1,0,16,11,3,0
6480bba08cc4182f0127f2e2,2013,,,1,KD Karthik,RG Sharma,21,16,2,1,1,19,13,2,1,2,3,0,0
6480bb9341152e168005ccc9,2017,,,1,KM Jadhav,SR Watson,21,27,0,0,1,9,12,0,0,10,15,0,0
6480bb951677500061c85592,2019,,,1,Q de Kock,RG Sharma,21,22,0,2,1,10,8,0,1,11,14,0,1
6480bb9fc524f8142f0b3461,2012,,,2,OA Shah,SR Watson,21,16,3,0,0,4,7,0,0,17,9,3,0
6480bba0e52e9733fc6d9937,2013,,,2,DA Miller,PP Chawla,21,17,0,1,1,6,7,0,0,12,10,0,1
6480bba2f3ed8323f852acfa,2016,,,2,M Vohra,SE Marsh,21,22,3,0,1,13,13,2,0,7,9,1,0
6480bb9996eb97dd08b62f78,2023,,,2,JM Sharma,P Simran Singh,21,11,1,2,1,11,6,1,1,8,5,0,1
6480bba1603d86b7d278a366,2015,,,1,MK Pandey,RV Uthappa,21,24,1,0,1,3,10,0,0,15,14,1,0
6480bb9f1faffe780b407e67,2013,,,2,DJ Hussey,M Vohra,21,17,3,0,0,8,11,1,0,11,6,2,0
6480bb9bbb0ec0266749f518,2007/08,,,2,AS Yadav,SB Bangar,21,11,0,2,0,3,4,0,0,17,7,0,2
6480bb9d867c041656e9a75f,2009/10,,,2,MD Mishra,TL Suman,21,15,2,1,1,15,9,1,1,5,6,1,0
6480bb96c880c7df4e055f14,2020/21,,,2,KL Rahul,N Pooran,21,15,1,1,1,4,6,0,0,14,9,1,1
6480bb9e335bec070f88430f,2011,,,2,JA Morkel,MS Dhoni,21,15,1,1,1,5,9,0,0,15,6,1,1
6480bb97dee20878b0c4246c,2021,,,1,RV Patel,SO Hetmyer,21,14,2,1,1,7,7,1,0,12,7,1,1
6480bb9aa64355ce98da1141,2007/08,,,2,DPMD Jayawardene,IK Pathan,21,24,1,1,0,2,7,0,0,17,17,1,1
6480bba01893b0faadb9c761,2013,,,1,KD Karthik,RG Sharma,21,16,2,0,1,11,8,1,0,10,8,1,0
6480bba250b404cdcbff22c8,2015,,,2,Harbhajan Singh,KA Pollard,21,5,1,2,1,5,2,1,0,12,3,0,2
6480bba2a01f4062fc561247,2016,,,1,M Vijay,M Vohra,21,22,2,0,1,12,10,2,0,8,12,0,0
6480bb96c40b697b63d08717,2019,,,1,KS Williamson,V Shankar,21,14,2,0,1,16,10,2,0,3,4,0,0
6480bb9498a98d52f9285b52,2017,,,1,NV Ojha,Yuvraj Singh,21,19,1,1,1,2,6,0,0,19,13,1,1
6480bb96686655f09172741d,2020/21,,,2,S Dube,Washington Sundar,21,15,2,1,1,10,7,0,1,11,8,2,0
6480bba0001885407e860a8d,2013,,,1,DJG Sammy,GH Vihari,21,15,2,1,0,8,6,0,1,11,9,2,0
6480bb9fe31a789bcb52d583,2012,,,2,BB McCullum,G Gambhir,21,27,3,0,1,11,15,2,0,10,12,1,0
6480bba0d4b2f9be71a5f230,2014,,,2,KD Karthik,LRPL Taylor,21,18,2,1,1,15,9,1,1,6,9,1,0
6480bb99efa58b95852be382,2023,,,2,HH Pandya,Shubman Gill,21,16,1,1,1,8,11,0,0,13,5,1,1
6480bb97fcc6fccd233157f9,2021,,,1,AR Patel,Lalit Yadav,21,11,1,1,1,12,7,0,1,6,4,1,0
6480bb9c620c92d09ba1b6b9,2009,,,1,RG Sharma,TL Suman,21,14,2,1,1,2,5,0,0,19,9,2,1
6480bba0adee98d459585bed,2014,,,2,Harbhajan Singh,KA Pollard,21,7,2,2,1,10,5,1,1,10,2,1,1
6480bb9c44492d9e5fc4bb60,2009/10,,,1,CA Pujara,SC Ganguly,21,26,1,1,1,4,14,0,0,17,12,1,1
6480bb9f60d58ee39ba047b9,2013,,,1,IK Pathan,MC Juneja,21,27,1,0,1,14,17,1,0,6,10,0,0
6480bb99bb362e3714226928,2022,,,1,D Padikkal,R Parag,21,14,1,1,1,15,8,1,1,5,6,0,0
6480bb9b724406459cd357c9,2007/08,,,2,MV Boucher,P Kumar,21,14,2,1,1,16,7,2,1,5,7,0,0
6480bba2679194b06d4834db,2016,,,2,AT Rayudu,PA Patel,21,20,3,0,1,8,8,1,0,10,12,2,0
6480bb9ade063258af41163b,2007/08,,,2,AC Gilchrist,Y Venugopal Rao,21,21,1,0,1,3,7,0,0,14,14,1,0
6480bba273adb498d96b27a9,2016,,,2,G Gambhir,RV Uthappa,21,18,2,0,1,6,8,0,0,15,10,2,0
6480bb9d69cb9046a72d8fbe,2009/10,,,1,S Anirudha,S Badrinath,21,21,2,0,1,10,10,1,0,8,11,1,0
6480bba20559f15c3489f637,2015,,,1,J Suchith,KA Pollard,21,10,1,1,1,3,2,0,0,15,8,1,1
6480bba11a59d64bb4aa66f4,2014,,,2,AM Rahane,KK Nair,21,16,3,0,1,10,10,1,0,11,6,2,0
6480bb9d97cceb6330e84df0,2011,,,1,DA Warner,V Sehwag,21,15,3,1,1,6,6,1,0,15,9,2,1
6480bb9f9a70ecf3467829df,2013,,,1,DJ Bravo,MS Dhoni,21,15,1,0,1,5,5,0,0,15,10,1,0
6480bb962a1612c936d161ba,2019,,,1,HH Pandya,RG Sharma,21,19,2,1,1,4,8,0,0,17,11,2,1
6480bb9442c4889bcbb4a784,2017,,,1,G Gambhir,MK Pandey,21,11,3,1,1,20,10,3,1,1,1,0,0
6480bb9f23c17ccb47aa9e58,2013,,,1,AM Rahane,BJ Hodge,21,30,2,0,1,6,14,0,0,15,16,2,0
6480bb9b283b30d0503656f7,2007/08,,,2,AC Gilchrist,Shahid Afridi,21,13,4,0,1,14,9,3,0,5,4,1,0
6480bb9f79be50f1621abcc6,2012,,,1,N Saini,SE Marsh,21,24,2,0,1,2,9,0,0,14,15,2,0
6480bb94ca96a1c1f17d1294,2017,,,2,AB de Villiers,V Kohli,21,16,3,0,1,3,8,0,0,17,8,3,0
6480bba2bae80e615447f251,2015,,,1,MS Dhoni,RA Jadeja,21,13,2,1,1,18,9,2,1,3,4,0,0
6480bb9d97cceb6330e84df0,2011,,,1,DA Warner,NV Ojha,21,21,2,1,1,7,9,1,0,13,12,1,1
6480bb9c13fa57328b17e4e2,2009/10,,,2,M Vijay,SK Raina,21,8,1,2,0,14,6,1,1,7,2,0,1
6480bb9da398a7c3c645732c,2011,,,2,MK Pandey,Yuvraj Singh,21,23,2,0,1,12,12,2,0,7,11,0,0
6480bb9b82dc3ec84c520466,2009,,,2,AB Agarkar,MN van Wyk,21,14,2,0,0,6,7,0,0,13,7,2,0
6480bb9f8ab73cf7c77cef03,2012,,,1,OA Shah,SR Watson,21,16,1,1,1,4,9,0,0,14,7,1,1
6480bb9a51ee1ef33a5b2dbb,2007/08,,,2,DJ Hussey,LR Shukla,21,28,1,0,1,13,18,1,0,7,10,0,0
6480bb93d9581d69657887c3,2017,,,1,KM Jadhav,Vishnu Vinod,21,10,1,2,1,12,5,1,1,9,5,0,1
6480bb95b1f28cf5bcf5e167,2018,,,2,F du Plessis,Harbhajan Singh,21,17,2,1,1,18,8,2,1,2,9,0,0
6480bb948a69b3d86293b12b,2017,,,1,DR Smith,Ishan Kishan,21,19,3,0,1,8,8,1,0,10,11,2,0
6480bb9763013a01eae041f2,2020/21,,,1,HH Pandya,Ishan Kishan,21,11,1,2,1,13,6,1,1,8,5,0,1
6480bb9eae43aed76989151b,2011,,,1,LA Pomersbach,V Kohli,21,19,2,0,1,10,10,1,0,9,9,1,0
6480bba2e8614b1263627c1b,2015,,,2,NV Ojha,RS Bopara,21,14,2,0,0,8,6,1,0,11,8,1,0
6480bb96c880c7df4e055f14,2020/21,,,1,RG Sharma,SA Yadav,21,18,4,0,1,10,11,2,0,10,7,2,0
6480bb9d61e9b86b0f0aae49,2009/10,,,2,JH Kallis,RV Uthappa,21,18,0,1,1,9,10,0,0,12,8,0,1
6480bb95f214d4f82ab97ee5,2018,,,2,CA Lynn,SP Narine,21,8,2,2,1,0,1,0,0,21,7,2,2
6480bba1c67d2c9c1279a4c8,2014,,,1,AB de Villiers,RR Rossouw,21,21,0,1,1,11,9,0,1,8,12,0,0
6480bb99358a21ba3487db81,2023,,,1,Anmolpreet Singh,MA Agarwal,21,17,1,1,1,13,10,0,1,8,7,1,0
6480bb94ca3c1b1eac5e8dd3,2018,,,2,DJ Bravo,Harbhajan Singh,21,11,3,0,1,12,6,2,0,8,5,1,0
6480bb9f6f311344dac147cc,2012,,,2,MK Pandey,SPD Smith,21,19,2,0,1,10,9,1,0,10,10,1,0
6480bb983ad1bab18d1d8774,2022,,,2,HV Patel,KD Karthik,21,9,3,1,0,10,6,2,0,11,3,1,1
6480bb9618b5973b98c0ba18,2019,,,1,KS Williamson,YK Pathan,21,12,0,2,1,16,8,0,2,3,4,0,0
6480bb9cba868c69775db687,2009,,,2,JA Morkel,MS Dhoni,21,19,0,1,1,12,9,0,1,9,10,0,0
6480bb9746dfc5c467942a84,2021,,,2,Ishan Kishan,SS Tiwary,21,22,2,0,1,10,9,1,0,11,13,1,0
6480bb9b9614f21d90333e15,2007/08,,,2,SR Watson,YK Pathan,21,8,1,2,1,7,4,1,0,14,4,0,2
6480bb9c6f1c8ea3dc73226f,2009/10,,,1,KD Karthik,MF Maharoof,21,11,3,0,1,16,6,3,0,3,5,0,0
6480bba18a2fe828fa106f6c,2014,,,1,KK Nair,SR Watson,21,11,3,1,1,16,5,2,1,5,6,1,0
6480bb9480627b50308b7903,2017,,,1,BB McCullum,Ishan Kishan,21,12,2,1,1,6,4,1,0,12,8,1,1
6480bb9e173228d1b18e376b,2012,,,1,NV Ojha,Y Nagar,21,21,1,1,1,11,11,0,1,7,10,1,0
6480bb9b7557e68b433167d5,2007/08,,,2,Kamran Akmal,M Kaif,21,12,1,1,1,11,5,0,1,10,7,1,0
6480bb9a87f64c1a12f62ece,2007/08,,,2,RV Uthappa,ST Jayasuriya,21,16,3,0,1,2,8,0,0,15,8,3,0
6480bb9e9f1ef9ac02266570,2011,,,1,B Chipli,JP Duminy,21,22,1,0,1,12,11,1,0,9,11,0,0
6480bb9ec07aa72ec89917f0,2012,,,2,RA Jadeja,S Badrinath,21,19,1,1,1,12,14,1,0,9,5,0,1
6480bb9d3ab782f83ce3e381,2011,,,1,A Mishra,B Chipli,21,15,2,0,0,9,9,0,0,11,6,2,0
6480bb9d69cb9046a72d8fbe,2009/10,,,2,B Sumanth,RJ Harris,21,14,2,1,1,6,6,1,0,15,8,1,1
6480bba120182b9ca0b70004,2014,,,2,AJ Finch,S Dhawan,21,16,3,0,1,11,10,2,0,6,6,1,0
6480bb9d1ed71a4f47892d00,2009/10,,,1,BB McCullum,SC Ganguly,21,15,4,0,1,6,7,1,0,13,8,3,0
6480bb9c37b72d7a51019794,2009/10,,,1,AC Gilchrist,RG Sharma,21,14,1,2,1,18,11,1,2,2,3,0,0
6480bb93ff8d1f4cd07859ce,2017,,,1,DJ Hooda,MC Henriques,21,10,2,1,0,9,4,0,1,12,6,2,0
6480bb94566b0cf89fca84f9,2018,,,2,Rashid Khan,WP Saha,21,8,1,2,0,17,4,1,2,4,4,0,0
6480bb9a40966b9b90fcdf2e,2023,,,1,P Simran Singh,S Dhawan,21,12,5,0,1,12,8,3,0,9,4,2,0
6480bb987c720def5fbaf218,2022,,,2,KA Pollard,SA Yadav,21,20,1,1,1,10,11,1,0,10,9,0,1
6480bba069d61566bb63ac2b,2014,,,2,R Vinay Kumar,SA Yadav,21,17,1,0,1,4,5,0,0,12,12,1,0
6480bb97a42828c5a5ebef1c,2020/21,,,2,MP Stoinis,RR Pant,21,24,2,0,1,17,15,2,0,3,9,0,0
6480bb96f1eadf803ffc292c,2020/21,,,2,R Tewatia,S Gopal,21,15,1,1,1,18,12,1,1,2,3,0,0
6480bb9ee0795047740de5a7,2011,,,1,AM Rahane,SR Watson,21,13,4,0,1,15,9,3,0,6,4,1,0
6480bb96c0ffb76dab723a2b,2019,,,1,PP Shaw,S Dhawan,21,15,4,0,1,5,6,1,0,15,9,3,0
6480bba234aac105851964b1,2015,,,1,DR Smith,MEK Hussey,21,19,3,0,1,17,12,3,0,3,7,0,0
6480bb9c5d0fccb6a3a6d37d,2009,,,2,GC Smith,RA Jadeja,21,21,2,0,1,5,7,0,0,16,14,2,0
6480bb931e6d2b03141b586d,2017,,,2,MK Pandey,SA Yadav,21,18,1,0,1,12,9,1,0,7,9,0,0
6480bb99e520ec7a66b73adb,2022,,,1,DA Warner,PP Shaw,21,18,2,1,1,5,6,1,0,15,12,1,1
6480bba27b4786f36f706f8e,2016,,,1,HH Pandya,LMP Simmons,21,16,2,1,1,9,10,2,0,7,6,0,1
6480bb99ed38bcb4025b8d86,2023,,,1,N Rana,Rahmanullah Gurbaz,21,17,1,1,1,1,5,0,0,14,12,1,1
6480bba2563745309ee2bdfb,2016,,,1,DR Smith,SK Raina,21,20,2,1,1,3,5,0,0,18,15,2,1
6480bb95481ab7c06b86419b,2018,,,1,JJ Roy,PP Shaw,21,23,3,0,1,11,12,2,0,9,11,1,0
6480bba1743abcb135a6a4c7,2015,,,2,KK Nair,SPD Smith,21,19,2,1,1,8,11,0,1,12,8,2,0
6480bb997d1393ca85856ec2,2022,,,1,Shubman Gill,WP Saha,21,15,3,1,1,1,4,0,0,20,11,3,1
6480bba17bce347084729c56,2015,,,1,AT Rayudu,KA Pollard,21,26,2,0,1,11,10,2,0,9,16,0,0
6480bb97c92184fed1a879f3,2021,,,1,JJ Roy,PK Garg,21,16,1,1,1,6,5,1,0,15,11,0,1
6480bb9ea1e127d68e288e04,2011,,,1,MEK Hussey,SK Raina,21,16,1,2,1,2,3,0,0,19,13,1,2
6480bba0e52e9733fc6d9937,2013,,,2,DA Miller,DJ Hussey,21,15,1,1,1,19,12,1,1,2,3,0,0
6480bb9718a9b89de407178b,2021,,,1,DJ Hooda,N Pooran,21,15,1,1,1,11,7,0,1,9,8,1,0
6480bb9f7258f976eb8fe943,2012,,,2,DJ Bravo,MEK Hussey,21,32,1,0,1,10,15,0,0,11,17,1,0
6480bb9ba6cd609c32579bde,2009,,,2,Harbhajan Singh,SR Tendulkar,21,15,1,1,1,6,7,0,0,14,8,1,1
6480bb9dec749d630afd07d1,2011,,,1,B Chipli,JP Duminy,21,18,2,0,1,14,12,2,0,7,6,0,0
6480bba0a4e7c61a5656729e,2014,,,2,CH Gayle,PA Patel,21,8,2,2,1,20,7,2,2,1,1,0,0
6480bba1af9481df8b4f9f0f,2015,,,2,CH Gayle,KD Karthik,21,16,2,1,1,13,8,1,1,6,8,1,0
6480bb9c13fa57328b17e4e2,2009/10,,,2,ML Hayden,PA Patel,21,13,4,0,1,14,7,3,0,6,6,1,0
6480bb9754755bb7a7427d52,2021,,,2,JC Buttler,YBK Jaiswal,21,20,4,0,1,5,7,1,0,14,13,3,0
6480bba1603d86b7d278a366,2015,,,2,BB McCullum,F du Plessis,21,10,5,0,1,4,2,1,0,16,8,4,0
6480bb94834e2b780c4782b5,2017,,,1,Kuldeep Yadav,MK Pandey,21,19,2,0,1,10,10,1,0,10,9,1,0
6480bb9f022f0e8cd6e9cdeb,2012,,,1,AD Russell,P Negi,21,10,1,2,1,15,7,0,2,5,3,1,0
6480bb987c720def5fbaf218,2022,,,1,JM Sharma,S Dhawan,21,15,1,1,1,3,4,0,0,18,11,1,1
6480bba2ebdcfb98389cee5a,2015,,,1,JA Morkel,SS Iyer,21,16,2,1,1,8,8,0,1,13,8,2,0
6480bb9be2940d96c1f903ca,2007/08,,,2,B Akhil,R Dravid,21,11,3,0,1,0,1,0,0,20,10,3,0
6480bb9b3a5e1af467fb027b,2009,,,2,A Flintoff,SK Raina,21,18,3,0,1,14,10,2,0,7,8,1,0
6480bb994877788ec5b187ff,2023,,,2,PWH de Silva,SS Prabhudessai,21,11,0,2,1,2,2,0,0,18,9,0,2
6480bb9fcbbfd8053f253537,2012,,,1,IK Pathan,NV Ojha,21,13,2,0,1,13,7,2,0,2,6,0,0
6480bba065b341458c934986,2013,,,2,JH Kallis,YK Pathan,21,21,2,1,1,11,12,2,0,9,9,0,1
6480bb9558c0acb502a3b1a9,2019,,,1,MA Agarwal,SM Curran,21,12,3,1,1,1,2,0,0,20,10,3,1
6480bb9f1faffe780b407e67,2013,,,2,AC Gilchrist,Mandeep Singh,21,14,3,1,1,15,10,2,1,5,4,1,0
6480bb9a1032ce724214f6dd,2007/08,,,1,RR Raje,SM Pollock,21,5,0,3,1,1,1,0,0,18,4,0,3
6480bb9adb5d9ca80cb1c6a0,2023,,,2,Abdul Samad,M Jansen,21,8,0,2,0,17,6,0,2,3,2,0,0
6480bba10e78f50f124b406a,2015,,,2,DJ Bravo,F du Plessis,21,13,4,0,1,5,4,1,0,16,9,3,0
6480bb99537b54b870dc74d1,2023,,,1,M Shahrukh Khan,SM Curran,21,8,1,2,1,15,4,0,2,6,4,1,0
6480bb9b2e179d359c1d446d,2009,,,1,DR Smith,Y Venugopal Rao,21,19,1,0,1,8,8,1,0,11,11,0,0
6480bb966c197bad273f91f1,2020/21,,,2,AS Rajpoot,JC Archer,21,13,2,1,1,2,4,0,0,19,9,2,1
6480bb9eb14c6138aebfbf98,2012,,,1,AC Gilchrist,PP Chawla,21,17,0,1,1,12,7,0,1,9,10,0,0
6480bb96ec7d98e34055e8fc,2020/21,,,2,MS Dhoni,RA Jadeja,21,7,0,3,0,20,5,0,3,1,2,0,0
6480bb9b4b74852492343291,2007/08,,,2,AB de Villiers,TM Dilshan,21,28,1,0,1,16,18,1,0,4,10,0,0
6480bb9561509a2f4f139254,2019,,,1,Q de Kock,SA Yadav,21,14,0,1,1,5,4,0,0,16,10,0,1
6480bb98a95cb1650c81c926,2022,,,2,RM Patidar,Shahbaz Ahmed,21,21,0,1,1,14,9,0,1,6,12,0,0
6480bb9ac9149c73fdf073b3,2023,,,2,DA Warner,PD Salt,21,19,2,1,1,18,13,2,1,3,6,0,0
6480bb9558c0acb502a3b1a9,2019,,,2,RR Pant,S Dhawan,21,15,1,0,1,14,11,1,0,3,4,0,0
6480bb94c2dcb1007bf6788b,2017,,,2,M Vohra,SE Marsh,21,21,3,0,1,9,12,1,0,12,9,2,0
6480bba1ff55936e203ca5a6,2014,,,1,GJ Bailey,MG Johnson,21,17,1,1,1,6,5,0,0,14,12,1,1
6480bba0adee98d459585bed,2014,,,1,KM Jadhav,KP Pietersen,21,18,2,0,0,14,10,2,0,7,8,0,0
6480bb9a3ffea6235f54cc1e,2023,,,1,RK Singh,SN Thakur,21,12,1,1,1,12,6,0,1,8,6,1,0
6480bb99773871f8e2ddc4b1,2022,,,2,JM Sharma,LS Livingstone,21,9,3,1,1,19,7,3,1,2,2,0,0
6480bb973d98bfd2d4a5f108,2020/21,,,2,AD Russell,RA Tripathi,21,16,2,1,1,16,8,2,1,5,8,0,0
6480bb9a1a3ab2ab8297871d,2007/08,,,2,Pankaj Singh,SK Warne,21,7,1,2,0,4,3,0,0,17,4,1,2
6480bb941ab79050c3c90ee5,2018,,,2,DJ Bravo,RA Jadeja,21,8,0,2,0,11,5,0,1,8,3,0,1
6480bb951677500061c85592,2019,,,1,HH Pandya,KA Pollard,21,22,0,1,1,14,14,0,1,6,8,0,0
6480bb9ef8d4c23c6e5be4c7,2011,,,2,M Klinger,PA Patel,21,18,3,0,1,4,8,0,0,16,10,3,0
6480bb9f58a3e7ea877fc9dc,2012,,,1,DJ Harris,PA Patel,21,19,1,1,1,3,6,0,0,17,13,1,1
6480bb9abfe839459b1a28f6,2007/08,,,1,DNT Zoysa,RG Sharma,21,12,3,1,1,1,2,0,0,20,10,3,1
6480bb9e5ad1f3182858e7c9,2012,,,2,Azhar Mahmood,SE Marsh,21,13,1,1,1,10,7,0,1,8,6,1,0
6480bba3b818a7cff6fe4f89,2016,,,1,NV Ojha,Yuvraj Singh,21,14,3,0,1,7,8,0,0,12,6,3,0
6480bb977f55a1c473670850,2021,,,1,DA Miller,R Tewatia,21,32,0,0,1,9,12,0,0,12,20,0,0
6480bb9ee4565d108b29626f,2012,,,1,JA Morkel,MS Dhoni,21,12,1,0,0,13,8,0,0,7,4,1,0
6480bb9e95693a2c4c4531e8,2011,,,1,AC Gilchrist,PC Valthaty,21,21,3,0,1,9,9,2,0,11,12,1,0
6480bb943565d22d24ec0ae8,2017,,,2,SP Jackson,YK Pathan,21,21,1,0,1,10,11,1,0,8,10,0,0
6480bb9b5d0191a0a2611916,2009,,,1,KC Sangakkara,RS Bopara,21,24,4,0,1,9,10,2,0,11,14,2,0
6480bba37e4fcb8af147f79b,2016,,,2,KK Nair,SS Iyer,21,16,4,0,1,15,11,3,0,6,5,1,0
6480bb971ffe5345804e7f32,2020/21,,,1,AT Carey,MP Stoinis,21,18,0,1,1,13,11,0,1,6,7,0,0
6480bba141bcb000fa6fe2a4,2015,,,1,DJ Hooda,SPD Smith,21,10,0,2,1,13,4,0,2,7,6,0,0
6480bb982fc21d541267f7b9,2022,,,1,AT Rayudu,RV Uthappa,21,22,1,1,1,14,15,1,1,6,7,0,0
6480bb99cf7659c6e45bd01d,2023,,,1,H Klaasen,M Jansen,21,22,1,0,1,11,9,1,0,9,13,0,0
6480bba2eea6f31945e4c5e2,2016,,,1,G Gambhir,RV Uthappa,21,22,2,0,1,10,12,1,0,8,10,1,0
6480bb95430629e254bbc4fd,2018,,,1,HH Pandya,SA Yadav,21,16,1,1,1,12,8,0,1,9,8,1,0
6480bb9ce7891d47a7fe9c12,2009/10,,,2,IK Pathan,PP Chawla,21,24,0,0,1,10,9,0,0,10,15,0,0
6480bb9aef150645306cc170,2023,,,1,Abhishek Sharma,MA Agarwal,21,15,4,0,1,14,9,3,0,5,6,1,0
6480bba33dab752d79e587d2,2016,,,1,DJ Hooda,KS Williamson,21,16,2,0,1,10,9,1,0,9,7,1,0
6480bb9c71030f4c6f018f55,2009,,,1,RG Sharma,RJ Harris,21,8,2,1,1,18,7,2,1,0,1,0,0
6480bb9bc74c35e494cec477,2007/08,,,2,DB Ravi Teja,Y Venugopal Rao,21,13,4,0,1,6,6,1,0,15,7,3,0
6480bba0c3cc8c51bc6c1c3a,2013,,,1,AM Rahane,R Dravid,21,17,4,0,1,2,7,0,0,19,10,4,0
6480bba3caa5150f2db7a1dc,2016,,,1,NV Ojha,S Dhawan,21,10,3,0,0,9,6,1,0,11,4,2,0
6480bba2f39653e2f61baca2,2015,,,1,PA Patel,RG Sharma,21,15,1,1,1,13,11,1,0,8,4,0,1
6480bb980cc3d01eab3a4748,2022,,,2,LS Livingstone,PBB Rajapaksa,21,11,0,2,1,8,4,0,1,10,7,0,1
6480bba358370ecde0231113,2016,,,2,DJ Hooda,NV Ojha,21,9,1,2,1,14,5,0,2,7,4,1,0
6480bb9a3ffea6235f54cc1e,2023,,,2,AK Markram,Abdul Samad,21,16,3,0,1,8,7,1,0,13,9,2,0
6480bb983ad1bab18d1d8774,2022,,,1,SP Narine,SW Billings,21,13,1,2,1,11,6,1,1,10,7,0,1
6480bb9c3803ef7726af83ab,2009/10,,,1,M Vijay,SK Raina,21,15,3,0,1,8,8,1,0,13,7,2,0
6480bba250b404cdcbff22c8,2015,,,1,R Ashwin,RA Jadeja,21,11,2,1,1,12,6,2,0,9,5,0,1
6480bb9c12e6c723b248799b,2009,,,1,R Dravid,RE van der Merwe,21,14,1,1,1,3,5,0,0,18,9,1,1
6480bb967c50ceac62ba0719,2020/21,,,1,MP Stoinis,S Dhawan,21,11,3,0,1,13,8,2,0,6,3,1,0
6480bb950c59218964b27cc0,2018,,,2,KL Rahul,MK Tiwary,21,18,1,0,1,13,10,1,0,7,8,0,0
6480bb9b1087ddfd207caa83,2009,,,2,DPMD Jayawardene,Yuvraj Singh,21,11,1,2,1,6,4,1,0,14,7,0,2
6480bb9c620c92d09ba1b6b9,2009,,,1,AC Gilchrist,TL Suman,21,21,1,1,1,10,11,0,1,10,10,1,0
6480bba1de7febd9f1f0138e,2014,,,1,DR Smith,SK Raina,21,13,3,0,1,18,10,3,0,2,3,0,0
6480bb9b9d7aa6d8e47576d7,2007/08,,,2,SK Warne,Sohail Tanvir,21,14,1,0,0,8,7,1,0,9,7,0,0
6480bb9c9685addc4a78d7d0,2009/10,,,2,MK Tiwary,WP Saha,20,4,2,2,0,20,4,2,2,0,0,0,0
6480bba0208e8fbb34afdc50,2013,,,2,AC Gilchrist,DA Miller,20,9,1,2,1,18,5,1,2,2,4,0,0
6480bb98b00f767943bb8415,2022,,,2,Kuldeep Yadav,R Powell,20,9,0,3,1,0,3,0,0,20,6,0,3
6480bb93894ff5c944493650,2017,,,1,AJ Finch,SK Raina,20,13,0,2,1,15,8,0,2,5,5,0,0
6480bb967c50ceac62ba0719,2020/21,,,1,AM Rahane,S Dhawan,20,23,3,0,1,15,15,3,0,3,8,0,0
6480bb95e25835586d412978,2018,,,2,HH Pandya,RG Sharma,20,15,1,1,1,16,9,1,1,4,6,0,0
6480bb9a24adc8d916dfe2db,2023,,,2,B Kumar,M Markande,20,11,2,1,1,7,5,1,0,12,6,1,1
6480bba1448ab5c40ac64696,2014,,,1,RV Uthappa,YK Pathan,20,11,0,2,1,16,6,0,2,4,5,0,0
6480bb978c66ea3d9c85132d,2020/21,,,2,Abdul Samad,Rashid Khan,20,10,1,2,1,8,4,0,1,11,6,1,1
6480bba097818bcc0db9555d,2014,,,2,AJ Finch,DA Warner,20,21,3,0,1,10,10,2,0,8,11,1,0
6480bba2c04b3acd88a50839,2015,,,1,AD Russell,YK Pathan,20,10,1,1,1,5,5,1,0,10,5,0,1
6480bb94d8ce46258c13e90e,2017,,,2,DT Christian,MK Tiwary,20,13,3,0,1,8,7,1,0,10,6,2,0
6480bb9c58b62383739c022e,2009,,,1,JP Duminy,SR Tendulkar,20,12,1,1,1,4,5,0,0,14,7,1,1
6480bb9ea1e127d68e288e04,2011,,,1,MEK Hussey,S Badrinath,20,18,0,1,1,7,8,0,0,13,10,0,1
6480bb97b945155c90dccd3d,2021,,,1,EJG Morgan,RA Tripathi,20,24,1,0,1,8,14,0,0,12,10,1,0
6480bba0a9f68a29bda72302,2013,,,1,DB Das,YK Pathan,20,9,3,1,1,5,3,1,0,15,6,2,1
6480bb98323919fff9902666,2022,,,1,JM Sharma,R Dhawan,20,7,3,1,0,15,5,2,1,5,2,1,0
6480bb9ade063258af41163b,2007/08,,,1,DJ Hussey,Mohammad Hafeez,20,21,1,1,1,6,8,0,0,13,13,1,1
6480bb98de3641699db2c5a1,2021,,,1,MM Ali,RV Uthappa,20,18,1,0,1,5,8,0,0,13,10,1,0
6480bb94457bfc7687322f80,2017,,,2,RA Jadeja,SK Raina,20,10,2,1,0,2,4,0,0,17,6,2,1
6480bba1af51ddc81185931d,2014,,,1,S Rana,V Kohli,20,10,0,2,1,4,4,0,0,15,6,0,2
6480bb94ebff9a116f68560b,2018,,,2,DJ Hooda,YK Pathan,20,10,2,1,0,2,3,0,0,17,7,2,1
6480bb984a8abbb79a69e6ce,2022,,,2,AK Markram,Abhishek Sharma,20,21,3,0,1,12,12,2,0,7,9,1,0
6480bba0f858e6c12b25d8c3,2014,,,1,SA Yadav,SP Narine,20,14,0,1,1,13,6,0,1,6,8,0,0
6480bb973d64aa91e60b4088,2021,,,1,F du Plessis,MM Ali,20,11,3,1,1,18,7,3,1,2,4,0,0
6480bba2a01f4062fc561247,2016,,,1,KJ Abbott,SE Marsh,20,9,0,2,0,12,6,0,1,8,3,0,1
6480bb980b5b26e8c4335a4b,2022,,,2,MJ Santner,RD Gaikwad,20,22,1,0,1,9,15,1,0,3,7,0,0
6480bb96a43476c5d9a56c4e,2020/21,,,1,AT Rayudu,MS Dhoni,20,12,0,2,1,16,7,0,2,3,5,0,0
6480bba237377ccc608266d2,2016,,,1,M Vijay,M Vohra,20,17,2,1,1,19,13,2,1,1,4,0,0
6480bb9d79d603cc45fc9b3c,2011,,,1,KA Pollard,SR Tendulkar,20,11,2,1,1,12,6,1,1,7,5,1,0
6480bb9e32ed1b9e077b8c11,2011,,,1,J Botha,LRPL Taylor,20,18,0,0,1,8,8,0,0,12,10,0,0
6480bb970c637fd0c057dca9,2021,,,2,KM Jadhav,KS Williamson,20,13,1,1,1,11,7,0,1,7,6,1,0
6480bba2f05e90a9005771d2,2015,,,2,F du Plessis,SK Raina,20,15,1,1,1,9,7,1,0,10,8,0,1
6480bb93c1cc671d66c471ba,2017,,,2,MK Pandey,YK Pathan,20,25,1,0,1,14,14,1,0,6,11,0,0
6480bb9f6b144f2a6d105b32,2013,,,1,MEK Hussey,SK Raina,20,15,3,0,1,9,8,2,0,10,7,1,0
6480bb95833c06e6c5119173,2019,,,1,MM Ali,MP Stoinis,20,7,2,1,0,0,2,0,0,18,5,2,1
6480bba223f162806c0794ac,2015,,,1,DR Smith,SK Raina,20,23,2,0,1,10,13,1,0,10,10,1,0
6480bba0120becd670aec59d,2013,,,1,AJ Finch,RV Uthappa,20,17,1,1,1,15,11,1,1,4,6,0,0
6480bb961ee814aee7b674ac,2020/21,,,2,MA Agarwal,SN Khan,20,21,2,0,1,8,9,0,0,12,12,2,0
6480bb9efe3f9991539e7f6c,2012,,,1,Mandeep Singh,SE Marsh,20,22,2,0,1,10,10,1,0,10,12,1,0
6480bb9763013a01eae041f2,2020/21,,,1,KA Pollard,KH Pandya,20,4,2,2,0,0,0,0,0,20,4,2,2
6480bb9d02d996f85dd5e945,2011,,,1,BJ Hodge,PA Patel,20,15,1,1,1,11,8,1,0,9,7,0,1
6480bb9be2940d96c1f903ca,2007/08,,,1,SK Raina,SP Fleming,20,15,1,1,1,4,5,0,0,15,10,1,1
6480bb9d0f6794fbf429449b,2011,,,1,Iqbal Abdulla,R Bhatia,20,14,2,0,1,12,9,1,0,8,5,1,0
6480bb95fbd4f1b7f3d8dfc0,2019,,,1,CH Gayle,MA Agarwal,20,15,1,1,1,3,6,0,0,15,9,1,1
6480bb93575636076d81e4c5,2017,,,2,AR Patel,M Vohra,20,22,2,0,1,7,12,0,0,13,10,2,0
6480bb94f27c8167d1685878,2017,,,2,AJ Finch,Ishan Kishan,20,18,1,0,1,14,12,1,0,4,6,0,0
6480bb991a4f7e5f59dd1afc,2023,,,2,N Jagadeesan,VR Iyer,20,17,3,0,1,8,6,1,0,10,11,2,0
6480bb951677500061c85592,2019,,,1,Ishan Kishan,KH Pandya,20,20,2,0,1,11,7,2,0,6,13,0,0
6480bba0120becd670aec59d,2013,,,2,AB de Villiers,SS Tiwary,20,13,1,1,1,9,7,1,0,11,6,0,1
6480bb960d9d6af315534958,2019,,,1,MA Agarwal,Mandeep Singh,20,16,1,0,1,10,9,0,0,10,7,1,0
6480bb9c12e6c723b248799b,2009,,,1,JH Kallis,MK Pandey,20,21,3,0,1,15,17,3,0,2,4,0,0
6480bb9a807eb5f39489408a,2023,,,2,MR Marsh,PD Salt,20,13,1,2,1,1,2,0,0,17,11,1,2
6480bb9c7b7d7712bdc663de,2009/10,,,2,RJ Harris,TL Suman,20,18,1,0,1,13,10,1,0,6,8,0,0
6480bb9b0e32875998e9bfdc,2009,,,1,G Gambhir,V Sehwag,20,15,2,1,1,8,6,1,0,12,9,1,1
6480bba01a3f8444c7a33ba6,2014,,,1,DS Kulkarni,PV Tambe,20,8,0,2,1,18,6,0,2,2,2,0,0
6480bb97951f1bc43b462c46,2021,,,2,GD Phillips,S Dube,20,12,1,1,0,14,8,1,1,5,4,0,0
6480bb95cf9d446747bd74fe,2019,,,1,AR Patel,R Tewatia,20,17,2,0,0,8,8,1,0,11,9,1,0
6480bba069c0322e91e50958,2013,,,1,BB Samantray,DJG Sammy,20,6,1,2,0,5,2,1,0,15,4,0,2
6480bb964a4d5a1709db428e,2020/21,,,1,HH Pandya,Q de Kock,20,10,1,2,1,8,4,0,1,12,6,1,1
6480bb9bb070eb19f9ac8a76,2007/08,,,1,LA Pomersbach,SE Marsh,20,18,0,1,1,6,8,0,0,14,10,0,1
6480bb96acacf3be646d300a,2020/21,,,2,K Rabada,RR Pant,20,19,2,0,1,3,7,0,0,16,12,2,0
6480bb9faf20f0bc714af2ea,2013,,,2,DPMD Jayawardene,NV Ojha,20,19,2,0,1,11,10,1,0,9,9,1,0
6480bb9f02801d2090cdba0d,2012,,,1,JD Ryder,MJ Clarke,20,20,3,0,1,8,10,1,0,12,10,2,0
6480bb9b52b93b56f5a16e52,2007/08,,,1,MF Maharoof,TM Dilshan,20,14,2,1,1,6,6,1,0,14,8,1,1
6480bb9a40966b9b90fcdf2e,2023,,,1,R Dhawan,SM Curran,20,13,1,1,1,19,11,1,1,1,2,0,0
6480bb96a467817b9b68ca94,2020/21,,,2,Rashid Khan,S Nadeem,20,10,2,1,1,14,8,1,1,5,2,1,0
6480bb9f23c17ccb47aa9e58,2013,,,2,P Kumar,RJ Harris,20,7,2,1,1,15,7,2,1,0,0,0,0
6480bb9bed3e2a1a008f93a6,2007/08,,,1,DJ Thornely,ST Jayasuriya,20,12,1,1,0,1,6,0,0,12,6,1,1
6480bb95e25835586d412978,2018,,,2,HH Pandya,Ishan Kishan,20,8,1,2,1,7,4,1,0,13,4,0,2
6480bb947b065b9dc0256f0d,2018,,,2,AB de Villiers,V Kohli,20,14,0,2,1,11,9,0,1,8,5,0,1
6480bb9e9f1ef9ac02266570,2011,,,1,JP Duminy,KC Sangakkara,20,21,1,0,1,9,9,0,0,11,12,1,0
6480bb95816d3ad3bc382ab6,2018,,,2,Mohammed Siraj,TG Southee,20,16,3,0,1,9,8,1,0,10,8,2,0
6480bb9bdde9db92f880e40d,2007/08,,,1,I Sharma,SC Ganguly,20,7,1,2,0,0,1,0,0,20,6,1,2
6480bb9d69cb9046a72d8fbe,2009/10,,,1,R Ashwin,S Anirudha,20,8,0,2,1,2,3,0,0,14,5,0,2
6480bba280f09c38002cf14b,2015,,,2,DA Miller,Gurkeerat Singh,20,15,0,1,1,13,8,0,1,4,7,0,0
6480bb9c89e2e8ecb04f94cb,2009/10,,,2,KD Karthik,MC Henriques,20,9,2,1,1,9,4,0,1,11,5,2,0
6480bb98de3641699db2c5a1,2021,,,2,RR Pant,S Dhawan,20,18,1,1,1,15,12,1,1,3,6,0,0
6480bb9bfcaabf33b5687e32,2007/08,,,1,Kamran Akmal,SA Asnodkar,20,19,4,0,1,18,16,4,0,2,3,0,0
6480bba107ba9f7f041862c1,2014,,,1,BB McCullum,DR Smith,20,15,3,1,1,4,4,1,0,16,11,2,1
6480bb96ee2a21f0d9b9f37f,2020/21,,,1,MP Stoinis,SS Iyer,20,8,1,2,1,1,3,0,0,19,5,1,2
6480bba071a7a0cbb02d505a,2013,,,2,DA Miller,M Vohra,20,27,2,0,1,12,16,1,0,8,11,1,0
6480bb9a8ac627a1ebf8dacf,2007/08,,,2,MEK Hussey,PA Patel,20,15,2,1,1,5,3,1,0,14,12,1,1
6480bb973e3a3dbbb7ae3707,2020/21,,,2,DJ Hooda,JDS Neesham,20,19,1,1,0,9,11,1,0,10,8,0,1
6480bba0be153677ce53c58e,2014,,,1,DJ Bravo,MS Dhoni,20,8,1,2,1,8,3,0,1,12,5,1,1
6480bb9651b51fdcda05e4c8,2020/21,,,1,EJG Morgan,RA Tripathi,20,18,0,1,1,15,11,0,1,4,7,0,0
6480bb97c92184fed1a879f3,2021,,,2,D Padikkal,KS Bharat,20,21,2,1,1,7,11,1,0,12,10,1,1
6480bba33dab752d79e587d2,2016,,,2,MA Agarwal,Q de Kock,20,19,4,0,1,10,9,2,0,10,10,2,0
6480bb9bed3e2a1a008f93a6,2007/08,,,2,AB Agarkar,SC Ganguly,20,21,3,0,1,12,11,2,0,8,10,1,0
6480bba0c7bf2b92ac8d836a,2013,,,2,AM Rahane,SR Watson,20,19,3,0,1,6,10,1,0,12,9,2,0
6480bb94c5d20726ee59d3d6,2017,,,1,Mandeep Singh,V Kohli,20,16,2,1,1,15,7,2,1,5,9,0,0
6480bb994877788ec5b187ff,2023,,,1,AT Rayudu,MM Ali,20,7,1,2,1,13,5,1,1,7,2,0,1
6480bba23ed328dbb847b4e7,2016,,,1,SR Watson,V Kohli,20,18,1,1,1,13,11,1,1,7,7,0,0
6480bb9a07d46704efe103ef,2007/08,,,2,JH Kallis,W Jaffer,20,16,4,0,1,15,11,3,0,5,5,1,0
6480bb9b0e32875998e9bfdc,2009,,,2,GC Smith,RJ Quiney,20,21,4,0,1,13,12,3,0,4,9,1,0
6480bb9c12e6c723b248799b,2009,,,1,LRPL Taylor,V Kohli,20,16,2,1,1,12,9,1,1,7,7,1,0
6480bb9f36da1a646c80be45,2013,,,1,Harbhajan Singh,RG Sharma,20,5,0,3,0,1,1,0,0,19,4,0,3
6480bba2bbd9d85769220a68,2015,,,2,A Mishra,SS Tiwary,20,9,1,1,0,1,3,0,0,16,6,1,1
6480bb9932735ca83d38f6e7,2022,,,1,AD Russell,SP Narine,20,7,0,3,0,19,5,0,3,1,2,0,0
6480bb9b62eb35d78fcd7df0,2007/08,,,1,DJ Hussey,LR Shukla,20,14,1,1,1,9,6,0,1,10,8,1,0
6480bb94aad1a08ca4276b4e,2018,,,1,AJ Tye,R Ashwin,20,17,1,0,1,7,7,0,0,12,10,1,0
6480bb9ca5c1d511ad78e92d,2009,,,2,DL Vettori,MF Maharoof,20,13,0,0,0,4,2,0,0,16,11,0,0
6480bb95816d3ad3bc382ab6,2018,,,2,PA Patel,V Kohli,20,17,0,2,1,15,8,0,2,4,9,0,0
6480bb945901306d3cb2b759,2018,,,2,AM Rahane,H Klaasen,20,11,2,1,1,11,4,1,1,7,7,1,0
6480bb961cdee4d82c395517,2020/21,,,2,RR Pant,S Dhawan,20,25,1,0,1,7,12,0,0,13,13,1,0
6480bb9e8dfd9ba30b93cbd8,2012,,,1,Ankit Sharma,DW Steyn,20,15,0,2,1,15,7,0,2,5,8,0,0
6480bba2aecb4103bab63c15,2016,,,2,AD Russell,R Sathish,20,12,0,2,1,14,7,0,2,3,5,0,0
6480bb9619eaed447b2a05d4,2020/21,,,2,SA Yadav,SS Tiwary,20,17,1,1,1,15,9,1,1,5,8,0,0
6480bb9b46b4360184dc19f3,2007/08,,,1,RP Singh,Y Venugopal Rao,20,13,1,1,0,6,4,1,0,11,9,0,1
6480bb9f59fd8000010baf09,2013,,,1,CH Gayle,KL Rahul,20,18,2,1,1,7,6,0,1,12,12,2,0
6480bb958e752648ab95362b,2019,,,1,KD Karthik,Shubman Gill,20,24,2,0,1,14,15,2,0,6,9,0,0
6480bb9c121ee402b7b2eda6,2009,,,2,AA Bilakhia,RJ Harris,20,11,2,0,0,16,8,2,0,4,3,0,0
6480bb9bcc2f6123673672d0,2007/08,,,1,G Gambhir,V Sehwag,20,8,3,1,1,2,2,0,0,18,6,3,1
6480bba22daffa649f339a05,2016,,,2,MS Dhoni,R Bhatia,20,8,2,1,0,20,6,2,1,0,2,0,0
6480bba1551dc12c8f2a7038,2014,,,1,JP Duminy,LR Shukla,20,24,1,0,1,9,10,0,0,10,14,1,0
6480bb98a95cb1650c81c926,2022,,,2,PWH de Silva,Shahbaz Ahmed,20,18,1,1,1,9,8,1,0,7,10,0,1
6480bb966c9efd5bf35d10b9,2019,,,2,R Parag,STR Binny,20,14,1,1,1,6,3,1,0,11,11,0,1
6480bb9a7f7a862ba0b2c59e,2007/08,,,1,JA Morkel,MS Gony,20,8,1,2,0,5,2,1,0,15,6,0,2
6480bb945901306d3cb2b759,2018,,,1,MS Dhoni,SR Watson,20,9,4,0,1,5,3,1,0,14,6,3,0
6480bb97cca23939859c422e,2021,,,2,KM Jadhav,KS Williamson,20,18,2,0,1,9,9,1,0,10,9,1,0
6480bb9d22388e966342dba8,2009/10,,,1,S Badrinath,SK Raina,20,16,2,0,1,14,11,2,0,5,5,0,0
6480bb9929c7e430acd1ef18,2022,,,2,DA Warner,MR Marsh,20,15,2,1,1,11,6,1,1,9,9,1,0
6480bba2ab35be3ffcfa932a,2016,,,1,AB de Villiers,SR Watson,20,9,0,3,1,0,2,0,0,19,7,0,3
6480bb9814efd9a91e8c911f,2021,,,2,GD Phillips,S Dube,20,23,0,2,1,8,12,0,1,12,11,0,1
6480bb95ea40317152ed9ca5,2018,,,2,MS Dhoni,SK Raina,20,19,2,0,1,10,9,1,0,10,10,1,0
6480bba3b830360cf7031278,2016,,,1,Harbhajan Singh,MJ McClenaghan,20,17,2,0,1,10,8,1,0,8,9,1,0
6480bb9765a785922ad360fe,2021,,,2,PP Shaw,S Dhawan,20,17,4,0,1,11,8,2,0,9,9,2,0
6480bb9fcb2b412c0ebd4afa,2013,,,2,KK Nair,V Kohli,20,21,2,0,1,9,9,0,0,11,12,2,0
6480bb96e61ac20a6e10582e,2019,,,1,M Vijay,SR Watson,20,15,4,0,1,10,6,2,0,10,9,2,0
6480bb996c324f07ab7f763c,2023,,,2,N Jagadeesan,Rahmanullah Gurbaz,20,15,2,1,1,5,3,1,0,15,12,1,1
6480bb97fb920d483d0da2af,2020/21,,,2,KL Rahul,P Simran Singh,20,17,2,0,1,9,9,0,0,11,8,2,0
6480bb982f070b023b901b3e,2021,,,2,AR Patel,SS Iyer,20,20,1,0,1,9,9,1,0,8,11,0,0
6480bb9ab655ac367694708c,2007/08,,,1,G Gambhir,V Sehwag,20,10,5,0,1,8,6,2,0,12,4,3,0
6480bb9bcf9df9e7ae0416ba,2009,,,1,RE van der Merwe,V Kohli,20,20,2,0,1,11,11,1,0,8,9,1,0
6480bb9eda28fb340ed37b49,2012,,,2,G Gambhir,JH Kallis,20,17,1,0,1,9,8,0,0,9,9,1,0
6480bba2aecb4103bab63c15,2016,,,1,AM Rahane,JA Morkel,20,14,0,2,1,16,9,0,2,3,5,0,0
6480bba1d21281c7385d5ce4,2014,,,1,MA Starc,VR Aaron,20,17,2,0,1,14,9,2,0,6,8,0,0
6480bb9ca181f55cb21526f5,2009/10,,,2,JH Kallis,V Kohli,20,15,0,2,1,3,3,0,0,17,12,0,2
6480bba1670ace74604a420f,2015,,,1,BB McCullum,DR Smith,20,8,4,0,1,4,2,1,0,12,6,3,0
6480bba0c9e6d590ed35eb56,2014,,,2,AP Tare,MEK Hussey,20,24,2,0,1,2,9,0,0,16,15,2,0
6480bb948211fe47e65f2e77,2018,,,1,KS Williamson,S Dhawan,20,10,3,0,1,10,4,2,0,5,6,1,0
6480bba18a431be2cc738de0,2014,,,2,AM Rahane,KK Nair,20,17,3,0,1,12,10,2,0,7,7,1,0
6480bb9774dd8e44bbeeb5a4,2021,,,2,S Dhawan,SO Hetmyer,20,7,1,2,0,2,3,0,0,16,4,1,2
6480bb9bd918d2e963f0218a,2009,,,2,AC Gilchrist,VVS Laxman,20,20,1,1,1,15,10,1,1,5,10,0,0
6480bb94c5d20726ee59d3d6,2017,,,1,KM Jadhav,TM Head,20,18,1,1,1,8,9,1,0,12,9,0,1
6480bb95ea40317152ed9ca5,2018,,,2,MS Dhoni,RA Jadeja,20,21,0,1,1,5,11,0,0,15,10,0,1
6480bb94cf431881ac3e9cbf,2018,,,2,Q de Kock,V Kohli,20,15,1,1,1,12,9,0,1,8,6,1,0
6480bb9b9d7aa6d8e47576d7,2007/08,,,1,CK Kapugedera,MS Dhoni,20,18,1,0,1,8,12,0,0,9,6,1,0
6480bba3ebbd8e4867dfa673,2016,,,2,AM Rahane,NLTC Perera,20,7,1,2,0,5,2,1,0,14,5,0,2
6480bb95a8153d4daac6e4f7,2019,,,2,KM Jadhav,SK Raina,20,12,3,1,1,20,12,3,1,0,0,0,0
6480bba2d313234709068efb,2015,,,2,CH Gayle,V Kohli,20,19,2,1,1,13,12,1,1,6,7,1,0
6480bb97aabcd4374e076d04,2021,,,1,KS Williamson,WP Saha,20,18,3,0,1,11,11,2,0,8,7,1,0
6480bba328f7475f4b87d3ff,2016,,,1,KD Karthik,SK Raina,20,15,3,0,1,12,8,2,0,7,7,1,0
6480bb98b00f767943bb8415,2022,,,1,SO Hetmyer,SV Samson,20,6,2,1,0,1,1,0,0,17,5,2,1
6480bb9f302200e3bc89464e,2012,,,1,JP Duminy,PA Reddy,20,20,1,0,1,10,12,0,0,9,8,1,0
6480bb958f737f809dfb65e1,2019,,,2,Mohammad Nabi,YK Pathan,20,15,2,1,0,17,9,2,1,3,6,0,0
6480bb9ded279701c84af803,2011,,,2,B Chipli,KC Sangakkara,20,14,1,1,1,7,6,0,0,13,8,1,1
6480bba3caa5150f2db7a1dc,2016,,,2,AJ Finch,P Kumar,20,11,1,1,0,14,7,0,1,6,4,1,0
6480bb96c0ffb76dab723a2b,2019,,,1,C Munro,SS Iyer,20,21,2,0,1,14,12,2,0,5,9,0,0
6480bb9fd4a1af6234c9e57c,2012,,,1,AB McDonald,AB de Villiers,20,15,1,1,1,9,10,1,0,9,5,0,1
6480bb96ef6f4c2c85264241,2019,,,2,E Lewis,SA Yadav,20,16,2,1,1,7,8,1,0,13,8,1,1
6480bba265483f7db002ec7c,2015,,,2,DA Warner,MC Henriques,20,23,1,0,1,13,15,1,0,7,8,0,0
6480bb9db9ed29ce1ee8764f,2011,,,2,KD Karthik,SE Marsh,20,11,2,1,1,6,5,1,0,13,6,1,1
6480bb962831291a868490e7,2020/21,,,2,K Rabada,R Ashwin,20,18,3,0,1,8,9,1,0,12,9,2,0
6480bba000b91f6c5cf57fdb,2013,,,1,BB Samantray,NLTC Perera,20,13,1,0,1,7,5,1,0,12,8,0,0
6480bb9d1f9a3cf1fa86e11c,2011,,,1,S Dhawan,S Sohal,20,18,3,0,1,11,9,2,0,6,9,1,0
6480bb9eee740f701b0ee154,2011,,,2,IK Pathan,JR Hopes,20,12,1,1,1,12,6,1,1,8,6,0,0
6480bba163bd0c619365a16b,2015,,,2,RG Sharma,UBT Chand,20,14,2,0,1,4,6,0,0,12,8,2,0
6480bb9bd918d2e963f0218a,2009,,,2,RG Sharma,SB Styris,20,14,0,1,1,6,6,0,0,14,8,0,1
6480bb947a7076697fc0b339,2017,,,2,G Gambhir,SP Narine,20,16,3,0,1,2,5,0,0,16,11,3,0
6480bb97951f1bc43b462c46,2021,,,1,AT Rayudu,RD Gaikwad,20,11,2,1,1,2,4,0,0,18,7,2,1
6480bb96686655f09172741d,2020/21,,,2,AJ Finch,D Padikkal,20,18,1,0,1,13,12,1,0,4,6,0,0
6480bb9e88141830a7a309b5,2011,,,1,JEC Franklin,KA Pollard,20,17,1,0,1,16,12,1,0,3,5,0,0
6480bba17bce347084729c56,2015,,,2,DA Miller,M Vijay,20,16,3,0,1,8,10,1,0,11,6,2,0
6480bb9a2b33e06f46eed54f,2023,,,1,RK Singh,VR Iyer,20,16,0,1,1,7,8,0,0,13,8,0,1
6480bb9fd9db46138a9bb209,2013,,,1,CH Morris,RA Jadeja,20,8,1,1,0,7,4,0,0,12,4,1,1
6480bba1f5d65d6146678a7f,2015,,,1,AD Mathews,KM Jadhav,20,18,1,1,1,5,9,0,0,12,9,1,1
6480bba0dcd1149b9b0b501f,2013,,,1,AJ Finch,RV Uthappa,20,16,3,0,1,5,5,1,0,14,11,2,0
6480bb9a1a3e8cef5633f4e6,2023,,,2,Ishan Kishan,RG Sharma,20,17,2,1,1,14,12,1,1,6,5,1,0
6480bb9b77a0ff5cb3d0e3e0,2009,,,2,DA Warner,G Gambhir,20,20,2,0,1,6,6,0,0,13,14,2,0
6480bb94cfe5aeb50e36aef3,2017,,,2,DA Warner,S Dhawan,20,13,4,0,1,1,2,0,0,18,11,4,0
6480bba19052ba503c5f7c27,2015,,,2,AM Rahane,SPD Smith,20,18,3,0,1,6,8,1,0,13,10,2,0
6480bb97220be892fbfc2a36,2021,,,2,EJG Morgan,N Rana,20,14,2,0,1,7,7,1,0,8,7,1,0
6480bb95f37ebb69ffb216e0,2019,,,1,CA Lynn,RV Uthappa,20,14,4,0,1,9,8,2,0,11,6,2,0
6480bba07e219ed95b7b06df,2013,,,1,DPMD Jayawardene,V Sehwag,20,25,2,0,1,12,17,2,0,2,8,0,0
6480bb9f1faffe780b407e67,2013,,,1,RV Uthappa,TL Suman,20,24,3,0,1,13,10,2,0,6,14,1,0
6480bb9f7258f976eb8fe943,2012,,,2,MS Dhoni,RA Jadeja,20,23,1,1,1,8,12,1,0,12,11,0,1
6480bb9ec0a4e3f137edb047,2011,,,1,AB de Villiers,V Kohli,20,17,1,1,1,11,10,0,1,9,7,1,0
6480bb932f8447acd7840076,2017,,,2,Basil Thampi,P Kumar,20,14,0,1,0,13,8,0,1,6,6,0,0
6480bb93c1cc671d66c471ba,2017,,,1,HH Pandya,Harbhajan Singh,20,8,2,1,0,17,7,2,1,1,1,0,0
6480bb9d716a89dbf5e486d0,2011,,,2,IK Pathan,Y Venugopal Rao,20,8,1,2,1,1,2,0,0,18,6,1,2
6480bb94b882fb725e3f98e5,2018,,,2,DJ Hooda,MK Pandey,20,14,1,0,1,5,5,0,0,14,9,1,0
6480bb9908b154f78b12b8fb,2023,,,2,Shahbaz Ahmed,V Kohli,20,14,3,0,1,2,5,0,0,18,9,3,0
6480bb97a42828c5a5ebef1c,2020/21,,,2,MP Stoinis,SS Iyer,20,15,4,0,1,7,8,1,0,12,7,3,0
6480bb948a69b3d86293b12b,2017,,,2,MN Samuels,SS Iyer,20,15,2,1,1,1,4,0,0,19,11,2,1
6480bb9809c62ba77e5df472,2021,,,1,KS Bharat,V Kohli,20,27,0,0,1,9,16,0,0,10,11,0,0
6480bb97372fc5d5ef4c436a,2021,,,1,AM Rahane,RR Pant,20,16,3,0,1,3,5,0,0,15,11,3,0
6480bba24f6e6e2c212c7469,2016,,,2,P Negi,SV Samson,20,27,1,1,1,11,19,0,1,9,8,1,0
6480bb9651b51fdcda05e4c8,2020/21,,,2,JC Archer,S Gopal,20,17,2,0,1,6,9,0,0,14,8,2,0
6480bb9c07d77f83fb139c41,2009,,,2,B Lee,PP Chawla,20,12,1,1,0,11,6,0,1,8,6,1,0
6480bba2bbd9d85769220a68,2015,,,2,MA Agarwal,SS Iyer,20,15,3,1,1,11,8,1,1,9,7,2,0
6480bb96c3293977af83acbf,2019,,,1,R Parag,VR Aaron,20,16,0,2,1,16,9,0,2,3,7,0,0
6480bb99efa58b95852be382,2023,,,1,BA Stokes,RD Gaikwad,20,11,1,2,1,7,6,1,0,13,5,0,2
6480bb9b69f8ace7659e486d,2009,,,2,RJ Quiney,SA Asnodkar,20,21,0,1,1,6,13,0,0,10,8,0,1
6480bb9ee779ef1e445d0506,2012,,,2,CJ Ferguson,RV Uthappa,20,24,1,0,1,12,13,1,0,8,11,0,0
6480bba1ff89cb428182daa6,2014,,,2,M Manhas,R Ashwin,20,7,2,1,0,8,3,0,1,11,4,2,0
6480bb9ea49fe0f895bf242a,2012,,,1,AT Rayudu,Harbhajan Singh,20,8,1,2,0,2,2,0,0,18,6,1,2
6480bba1c67d2c9c1279a4c8,2014,,,2,AJ Finch,S Dhawan,20,17,2,1,1,13,8,1,1,7,9,1,0
6480bba1de7febd9f1f0138e,2014,,,1,BB McCullum,DR Smith,20,13,0,3,1,6,3,0,1,13,10,0,2
6480bb9f03dd3a09740f0bd0,2013,,,2,G Gambhir,MK Tiwary,20,22,1,0,1,6,9,0,0,14,13,1,0
6480bb9e38040b358f5a34d8,2012,,,1,CL White,JP Duminy,20,13,1,1,1,14,6,1,1,5,7,0,0
6480bba1587a54176a9badf4,2014,,,2,S Dhawan,Y Venugopal Rao,20,26,1,0,1,5,8,0,0,12,18,1,0
6480bba2679194b06d4834db,2016,,,2,AT Rayudu,RG Sharma,20,19,1,1,1,15,11,1,1,5,8,0,0
6480bb9e6d7f7f691dde322d,2012,,,1,AT Rayudu,RJ Peterson,20,12,2,0,0,16,7,2,0,1,5,0,0
6480bb985efffbcafdef9f19,2021,,,1,MK Lomror,YBK Jaiswal,20,15,0,2,1,16,7,0,2,4,8,0,0
6480bb980d1be75574871dcc,2022,,,1,MK Lomror,Shahbaz Ahmed,20,9,2,1,1,16,8,2,1,1,1,0,0
6480bba0bc196f7168b3d989,2013,,,1,RA Jadeja,SK Raina,20,9,1,1,0,5,2,1,0,14,7,0,1
6480bb9f02801d2090cdba0d,2012,,,1,JD Ryder,RV Uthappa,20,21,2,1,1,1,3,0,0,18,18,2,1
6480bb9525c593ee45bb038c,2019,,,1,HH Pandya,KA Pollard,20,15,2,0,1,15,9,2,0,5,6,0,0
6480bba18a289cc4b8d173a4,2014,,,1,KA Pollard,RG Sharma,20,14,1,1,1,11,7,0,1,9,7,1,0
6480bb94738952e740c68749,2018,,,2,KK Nair,MA Agarwal,20,23,0,0,1,10,10,0,0,10,13,0,0
6480bb99a620a7afdb3217fe,2023,,,2,Abishek Porel,DA Warner,20,18,1,0,1,7,9,1,0,11,9,0,0
6480bba0001885407e860a8d,2013,,,2,UBT Chand,V Sehwag,19,22,2,0,1,9,15,2,0,6,7,0,0
6480bba0b5eabeb0a150b93f,2013,,,2,M Manhas,MR Marsh,19,17,1,1,1,9,10,1,0,9,7,0,1
6480bb9fcbbfd8053f253537,2012,,,2,MK Tiwary,YK Pathan,19,12,0,0,1,8,6,0,0,3,6,0,0
6480bba0eb5a345386bdc825,2013,,,1,AT Rayudu,Harbhajan Singh,19,11,1,1,1,15,8,1,1,2,3,0,0
6480bb990b96e91d3fbf421b,2022,,,1,MK Lomror,RM Patidar,19,9,0,2,1,3,3,0,0,14,6,0,2
6480bb9ea1e127d68e288e04,2011,,,1,MS Dhoni,WP Saha,19,11,1,1,1,9,6,1,0,10,5,0,1
6480bb97af05ebd5c4f575c4,2021,,,2,DA Warner,Virat Singh,19,15,1,1,1,12,9,0,1,6,6,1,0
6480bba358370ecde0231113,2016,,,1,GJ Bailey,UT Khawaja,19,21,3,0,1,7,13,1,0,11,8,2,0
6480bba265483f7db002ec7c,2015,,,1,DA Miller,WP Saha,19,24,0,0,1,7,9,0,0,11,15,0,0
6480bb94d8aa9021808a4760,2017,,,1,NV Ojha,V Shankar,19,16,1,1,1,9,9,0,1,7,7,1,0
6480bb9fe31a789bcb52d583,2012,,,2,BB McCullum,JH Kallis,19,26,1,0,1,5,8,0,0,13,18,1,0
6480bb9fc28e897b3c53f359,2012,,,2,DS Kulkarni,SL Malinga,19,10,2,1,1,10,4,2,0,9,6,0,1
6480bb951677500061c85592,2019,,,2,DJ Hooda,MK Pandey,19,22,0,0,1,7,9,0,0,12,13,0,0
6480bb981dc3f7250f93bc92,2022,,,1,KH Pandya,MP Stoinis,19,8,0,1,0,9,6,0,0,7,2,0,1
6480bb975156c246a0ee40b1,2021,,,2,MK Pandey,V Shankar,19,12,0,1,1,6,5,0,0,11,7,0,1
6480bb9754755bb7a7427d52,2021,,,2,SV Samson,YBK Jaiswal,19,9,4,0,1,10,5,2,0,8,4,2,0
6480bb9bcc2f6123673672d0,2007/08,,,2,RV Uthappa,SD Chitnis,19,10,3,0,1,15,6,3,0,3,4,0,0
6480bb97372fc5d5ef4c436a,2021,,,2,DA Miller,S Dube,19,25,2,0,1,17,18,2,0,2,7,0,0
6480bba29fb420d92aef1d2a,2015,,,1,MK Pandey,RN ten Doeschate,19,11,1,1,1,14,7,1,1,5,4,0,0
6480bba1b8e3071cc513602a,2014,,,2,DW Steyn,IK Pathan,19,18,2,0,1,9,8,1,0,9,10,1,0
6480bba0295edd6084b9503b,2014,,,1,KV Sharma,Y Venugopal Rao,19,13,1,0,1,4,5,0,0,12,8,1,0
6480bb93ec7e3351941d3b5b,2017,,,1,DA Warner,S Dhawan,19,11,2,1,1,14,8,2,1,1,3,0,0
6480bba18a2fe828fa106f6c,2014,,,1,KK Cooper,KK Nair,19,13,0,1,1,5,8,0,0,12,5,0,1
6480bb9a21e416835389fd53,2023,,,2,JM Sharma,SM Curran,19,8,0,2,1,9,3,0,1,10,5,0,1
6480bb99e909d98c8193bac5,2023,,,1,R Parag,SV Samson,19,12,1,1,1,7,6,1,0,10,6,0,1
6480bb9e19dd5297ba8ca5f7,2011,,,1,MR Marsh,Yuvraj Singh,19,22,1,1,1,12,14,0,1,6,8,1,0
6480bb9e56c724ba25b94666,2011,,,2,AC Blizzard,SR Tendulkar,19,16,4,0,1,13,7,3,0,6,9,1,0
6480bb93ff8d1f4cd07859ce,2017,,,2,SS Iyer,SV Samson,19,20,1,0,1,13,13,1,0,5,7,0,0
6480bb94a964c10b5f10ae52,2017,,,2,AR Patel,WP Saha,19,21,1,1,1,17,15,1,1,1,6,0,0
6480bb95b1f28cf5bcf5e167,2018,,,1,MK Pandey,YK Pathan,19,29,0,0,1,6,11,0,0,10,18,0,0
6480bb96fed7a7ee65076e4a,2020/21,,,1,JC Archer,R Tewatia,19,10,1,1,0,16,7,1,1,2,3,0,0
6480bb9d97cceb6330e84df0,2011,,,1,TR Birt,Y Venugopal Rao,19,14,2,0,1,10,7,1,0,9,7,1,0
6480bba2e30bef1d7b3bb753,2015,,,1,DA Warner,S Dhawan,19,14,2,0,1,10,7,1,0,8,7,1,0
6480bb93c1cc671d66c471ba,2017,,,2,CA Lynn,MK Pandey,19,16,1,0,1,11,9,1,0,5,7,0,0
6480bb9718a9b89de407178b,2021,,,1,CH Gayle,KL Rahul,19,16,1,1,1,5,6,0,0,14,10,1,1
6480bb95a65bb0f3394a62b5,2018,,,1,DJ Hooda,Shakib Al Hasan,19,9,1,1,0,8,3,0,1,8,6,1,0
6480bb96c880c7df4e055f14,2020/21,,,2,K Gowtham,Mohammed Shami,19,9,2,1,0,17,7,2,1,2,2,0,0
6480bba2256bfaaf14c57ead,2015,,,1,CH Morris,SR Watson,19,12,1,1,1,4,5,0,0,15,7,1,1
6480bb94cfe5aeb50e36aef3,2017,,,1,JP Faulkner,RA Jadeja,19,18,2,0,1,8,10,1,0,11,8,1,0
6480bb967d799ced7fe5d8e9,2020/21,,,1,GJ Maxwell,N Pooran,19,21,0,0,1,12,13,0,0,6,8,0,0
6480bb9824c4678d005d7aeb,2022,,,1,R Ashwin,SO Hetmyer,19,7,1,2,0,2,2,0,0,16,5,1,2
6480bba38060854b4fab1831,2016,,,2,AT Rayudu,KA Pollard,19,13,1,1,1,3,5,0,0,14,8,1,1
6480bba3fc9599eca1b87a77,2016,,,1,CH Gayle,V Kohli,19,23,2,0,1,6,13,1,0,12,10,1,0
6480bb96e834e1c16b33f325,2020/21,,,2,JC Buttler,SPD Smith,19,14,3,0,1,4,7,0,0,12,7,3,0
6480bb9f90a251567178de39,2012,,,1,Mandeep Singh,SE Marsh,19,14,4,0,1,8,7,2,0,11,7,2,0
6480bba16e510ff78ef635a1,2014,,,1,LMP Simmons,MEK Hussey,19,11,3,1,1,12,8,3,0,7,3,0,1
6480bb9b9d7aa6d8e47576d7,2007/08,,,2,NK Patel,SA Asnodkar,19,19,2,0,1,2,11,0,0,12,8,2,0
6480bb9558345af5a1bb044d,2019,,,2,HH Pandya,KH Pandya,19,14,3,0,1,15,9,3,0,3,5,0,0
6480bb94a964c10b5f10ae52,2017,,,2,SE Marsh,WP Saha,19,20,2,1,1,10,13,2,0,9,7,0,1
6480bb970d7cbd85b6ada680,2021,,,2,D Padikkal,V Kohli,19,15,2,1,1,7,6,0,1,12,9,2,0
6480bb9c12e6c723b248799b,2009,,,2,AA Bilakhia,HH Gibbs,19,13,0,1,1,6,7,0,0,12,6,0,1
6480bb97b945155c90dccd3d,2021,,,2,MM Ali,SK Raina,19,15,1,0,1,8,9,0,0,9,6,1,0
6480bb9dc8b09381d0f01a9d,2011,,,2,JD Ryder,MD Mishra,19,16,2,0,1,8,7,1,0,9,9,1,0
6480bb9e95693a2c4c4531e8,2011,,,2,TR Birt,Y Nagar,19,15,2,1,1,16,11,2,1,2,4,0,0
6480bb9ce93a7b4315d8fa30,2009,,,2,A Mishra,KD Karthik,19,11,2,1,1,2,3,0,0,17,8,2,1
6480bb96ec7d98e34055e8fc,2020/21,,,2,F du Plessis,SM Curran,19,8,1,2,1,2,2,0,0,17,6,1,2
6480bb9e5de755887230bb00,2012,,,2,MS Dhoni,SK Raina,19,16,1,0,1,10,8,1,0,6,8,0,0
6480bb9a9801c2dda3fe88e9,2007/08,,,2,MF Maharoof,VY Mahesh,19,13,2,0,1,13,8,2,0,6,5,0,0
6480bb94b991069934e5c7d2,2018,,,1,JC Buttler,K Gowtham,19,12,1,1,1,7,5,1,0,12,7,0,1
6480bba1a6882d256a926a8b,2014,,,2,MK Tiwary,S Kaul,19,11,1,1,0,16,9,1,1,2,2,0,0
6480bb9772f78629131db057,2021,,,1,F du Plessis,MS Dhoni,19,21,3,0,1,5,6,1,0,12,15,2,0
6480bb9ded279701c84af803,2011,,,2,B Chipli,S Dhawan,19,25,0,0,1,10,9,0,0,9,16,0,0
6480bba16af3f513920ef499,2015,,,1,NV Ojha,S Dhawan,19,14,2,1,1,12,6,1,1,7,8,1,0
6480bb9f03dd3a09740f0bd0,2013,,,2,EJG Morgan,Mohammed Shami,19,16,0,1,1,15,9,0,1,4,7,0,0
6480bb9af85f41b4de44ca19,2023,,,2,HH Pandya,Shubman Gill,19,17,3,0,1,8,7,1,0,11,10,2,0
6480bb9d05f8e769574069fa,2009/10,,,1,R Dravid,RV Uthappa,19,10,0,2,1,14,5,0,2,5,5,0,0
6480bb9442c4889bcbb4a784,2017,,,1,G Gambhir,SP Jackson,19,18,2,0,1,4,9,0,0,10,9,2,0
6480bba07e219ed95b7b06df,2013,,,2,M Manhas,SPD Smith,19,12,2,1,0,2,4,0,0,17,8,2,1
6480bb9bc80883a975281815,2009,,,2,RA Jadeja,YK Pathan,19,15,1,1,1,11,9,0,1,7,6,1,0
6480bb97f2f0fabec8f94d86,2020/21,,,2,RD Gaikwad,SM Curran,19,16,2,0,1,10,8,1,0,8,8,1,0
6480bba1de7febd9f1f0138e,2014,,,2,SPD Smith,STR Binny,19,14,1,1,1,9,8,1,0,8,6,0,1
6480bb987c52e15a2cac0697,2022,,,1,LS Livingstone,OF Smith,19,17,1,1,1,6,4,1,0,13,13,0,1
6480bb9ea1e127d68e288e04,2011,,,1,M Vijay,MEK Hussey,19,18,3,0,1,16,11,3,0,3,7,0,0
6480bba0b2a9d600114a43d7,2013,,,2,GJ Maxwell,RG Sharma,19,14,2,1,1,13,7,1,1,6,7,1,0
6480bb9ccfdcb55be258ec95,2009,,,1,GJ Bailey,SK Raina,19,18,1,0,1,9,9,0,0,10,9,1,0
6480bb9d867c041656e9a75f,2009/10,,,2,A Symonds,MD Mishra,19,15,2,1,1,13,11,1,1,6,4,1,0
6480bb955f4b3a84d6973620,2018,,,1,GJ Maxwell,V Shankar,19,8,2,1,1,1,2,0,0,17,6,2,1
6480bb97c92184fed1a879f3,2021,,,2,AB de Villiers,Shahbaz Ahmed,19,11,3,0,1,5,2,1,0,14,9,2,0
6480bb98d2cd0fa3ed0ffc21,2022,,,1,LS Livingstone,S Dhawan,19,12,1,1,1,10,6,0,1,6,6,1,0
6480bb953aab41e7ed166b9d,2019,,,2,BCJ Cutting,Yuvraj Singh,19,8,0,2,1,3,4,0,0,14,4,0,2
6480bb974123cbc9756ceefa,2021,,,2,M Shahrukh Khan,MC Henriques,19,14,1,1,1,15,8,1,1,3,6,0,0
6480bb9f0f1f6c03d8e2f039,2013,,,1,SPD Smith,TL Suman,19,24,1,0,1,7,10,0,0,12,14,1,0
6480bb9eb14c6138aebfbf98,2012,,,1,AC Gilchrist,SE Marsh,19,16,3,0,0,14,13,2,0,5,3,1,0
6480bb94c2dcb1007bf6788b,2017,,,1,Mandeep Singh,SR Watson,19,18,1,1,1,16,12,1,1,3,6,0,0
6480bb99b35dc0981e512451,2022,,,1,D Padikkal,JC Buttler,19,21,2,0,1,2,10,0,0,16,11,2,0
6480bb9ff2e0b1df0c3972c9,2012,,,2,Mandeep Singh,N Saini,19,14,4,0,1,13,8,3,0,6,6,1,0
6480bb9740aaba2132c0eb0e,2021,,,2,Mohammed Siraj,YS Chahal,19,24,0,1,0,12,14,0,1,7,10,0,0
6480bba22daffa649f339a05,2016,,,2,F du Plessis,SPD Smith,19,10,1,1,1,15,7,1,1,4,3,0,0
6480bb9a7194d8b20952afae,2007/08,,,2,MV Boucher,V Kohli,19,6,1,2,0,18,5,1,2,1,1,0,0
6480bb96edb3270eba0af1d4,2020/21,,,2,F du Plessis,SR Watson,19,24,2,0,1,8,10,0,0,10,14,2,0
6480bba1a6882d256a926a8b,2014,,,2,KP Pietersen,MA Agarwal,19,15,3,0,1,2,5,0,0,17,10,3,0
6480bb970127afddc00607cc,2021,,,2,F du Plessis,MM Ali,19,11,3,0,1,3,3,0,0,15,8,3,0
6480bb94c2dcb1007bf6788b,2017,,,2,AR Patel,VR Aaron,19,11,2,1,0,18,6,2,1,0,5,0,0
6480bb9871b0ff7264721cbc,2022,,,2,N Pooran,SA Abbott,19,11,0,2,1,11,6,0,1,7,5,0,1
6480bb9552e25b3867e5c38a,2019,,,2,DJ Bravo,KM Jadhav,19,15,2,0,1,2,6,0,0,11,9,2,0
6480bb979e91d1ff9b54c737,2020/21,,,1,SO Hetmyer,SS Iyer,19,14,3,0,1,5,5,1,0,14,9,2,0
6480bb99d2bd76016d47896d,2023,,,1,KL Rahul,KR Mayers,19,24,1,1,1,8,12,0,1,10,12,1,0
6480bb9d97cceb6330e84df0,2011,,,1,IK Pathan,TR Birt,19,11,4,0,1,2,3,0,0,17,8,4,0
6480bb9561509a2f4f139254,2019,,,1,KA Pollard,Q de Kock,19,19,2,0,1,6,12,0,0,12,7,2,0
6480bb9ce7891d47a7fe9c12,2009/10,,,2,IK Pathan,RS Bopara,19,21,1,0,1,10,10,1,0,8,11,0,0
6480bb9506d56930505d45ae,2019,,,1,CH Gayle,DA Miller,19,14,2,1,1,12,9,1,1,7,5,1,0
6480bb9dec749d630afd07d1,2011,,,1,DB Ravi Teja,DT Christian,19,8,2,1,1,2,2,0,0,16,6,2,1
6480bb945901306d3cb2b759,2018,,,2,BA Stokes,RA Tripathi,19,13,1,0,1,11,8,1,0,5,5,0,0
6480bb9873e53eace3a69dc7,2022,,,2,AD Russell,VR Iyer,19,8,1,2,1,16,5,1,2,1,3,0,0
6480bb99e520ec7a66b73adb,2022,,,2,D Brevis,Tilak Varma,19,18,0,1,1,12,12,0,1,6,6,0,0
6480bb957e6d387fe3a6b26e,2018,,,2,AB de Villiers,C de Grandhomme,19,7,0,2,0,13,3,0,2,3,4,0,0
6480bb95a65bb0f3394a62b5,2018,,,1,DJ Hooda,MK Pandey,19,14,1,0,1,13,8,1,0,5,6,0,0
6480bb970d7cbd85b6ada680,2021,,,1,KL Rahul,P Simran Singh,19,21,1,1,1,11,14,0,1,7,7,1,0
6480bb984f6c41cd28aa0353,2022,,,1,A Badoni,JO Holder,19,8,1,1,1,8,5,1,0,8,3,0,1
6480bb97b97c36ac8be3582f,2021,,,2,JM Bairstow,MK Pandey,19,17,1,0,1,12,13,1,0,5,4,0,0
6480bb9c17dcdfd5b06984f0,2009/10,,,2,CH Gayle,SC Ganguly,19,17,2,1,1,12,7,1,1,5,10,1,0
6480bb9d80e97e178e5f68de,2011,,,2,JH Kallis,MK Tiwary,19,15,1,0,1,5,6,0,0,13,9,1,0
6480bb94f06c6048c8088194,2018,,,1,JC Buttler,S Gopal,19,16,2,0,1,3,5,0,0,15,11,2,0
6480bb9f03dd3a09740f0bd0,2013,,,2,G Gambhir,MS Bisla,19,14,1,1,1,14,10,1,1,1,4,0,0
6480bb97af05ebd5c4f575c4,2021,,,1,KA Pollard,KH Pandya,19,8,0,2,0,16,5,0,2,3,3,0,0
6480bb964752e7c0f9e39d3c,2020/21,,,1,AD Russell,EJG Morgan,19,18,2,1,1,12,9,1,1,7,9,1,0
6480bba1670ace74604a420f,2015,,,2,JA Morkel,SS Iyer,19,12,3,0,1,11,5,2,0,7,7,1,0
6480bb96686655f09172741d,2020/21,,,2,V Kohli,Washington Sundar,19,9,1,1,1,11,6,0,1,6,3,1,0
6480bba3e9fa951efcfc8bfb,2016,,,2,CH Morris,RR Pant,19,13,1,1,0,15,10,0,1,4,3,1,0
6480bb9dc8b09381d0f01a9d,2011,,,1,S Anirudha,S Badrinath,19,14,0,1,1,7,7,0,0,11,7,0,1
6480bb9bd918d2e963f0218a,2009,,,1,JH Kallis,RV Uthappa,19,22,3,0,1,15,14,3,0,4,8,0,0
6480bb97b945155c90dccd3d,2021,,,1,N Rana,RA Tripathi,19,19,1,0,1,7,8,0,0,12,11,1,0
6480bb9e30b7f3c09cfbdabb,2011,,,1,BB McCullum,PA Patel,19,10,0,3,1,12,4,0,2,6,6,0,1
6480bb97cca23939859c422e,2021,,,2,KS Williamson,V Shankar,19,13,1,0,1,10,6,1,0,8,7,0,0
6480bb97b97c36ac8be3582f,2021,,,1,D Padikkal,V Kohli,19,17,3,0,1,11,13,2,0,6,4,1,0
6480bb9df57ec21d17310ad2,2011,,,2,A Mishra,DW Steyn,19,15,2,0,1,6,4,1,0,11,11,1,0
6480bb9ca668b7b36823fb21,2009,,,2,JP Duminy,SR Tendulkar,19,14,4,0,1,9,6,2,0,9,8,2,0
6480bb9359a2cade3b5213d3,2017,,,2,HH Pandya,KH Pandya,19,8,1,1,0,9,4,0,1,6,4,1,0
6480bb9827e9fb920cf62809,2021,,,1,Abdul Samad,PK Garg,19,25,0,1,1,6,11,0,0,13,14,0,1
6480bb975ea60ce128803d60,2021,,,1,F du Plessis,RA Jadeja,19,6,0,3,0,13,5,0,2,6,1,0,1
6480bba097818bcc0db9555d,2014,,,2,DJG Sammy,KL Rahul,19,19,0,1,1,15,11,0,1,4,8,0,0
6480bb97f56e9d700b27a098,2021,,,2,PP Shaw,RR Pant,19,23,2,0,1,7,9,1,0,12,14,1,0
6480bb943565d22d24ec0ae8,2017,,,2,RV Uthappa,YK Pathan,19,9,0,2,1,15,6,0,2,4,3,0,0
6480bba107ba9f7f041862c1,2014,,,2,JH Kallis,RV Uthappa,19,14,2,1,1,4,6,1,0,15,8,1,1
6480bb9651b51fdcda05e4c8,2020/21,,,2,BA Stokes,RV Uthappa,19,6,1,2,1,11,4,1,1,6,2,0,1
6480bb962831291a868490e7,2020/21,,,2,SO Hetmyer,SS Iyer,19,12,0,1,1,10,5,0,1,9,7,0,0
6480bb94704f6dfeb7f4d270,2017,,,1,AR Patel,WP Saha,19,14,0,1,1,6,7,0,0,12,7,0,1
6480bb9eb14c6138aebfbf98,2012,,,1,Mandeep Singh,SE Marsh,19,23,2,0,1,6,10,0,0,13,13,2,0
6480bb9d93cca4d1a7635fba,2011,,,1,TM Dilshan,V Kohli,19,26,2,0,1,2,7,0,0,12,19,2,0
6480bb9e80233e83b9d1be1f,2012,,,2,DPMD Jayawardene,LRPL Taylor,19,16,1,0,0,5,6,0,0,11,10,1,0
6480bb9c7a11e1cbeea46b0e,2009/10,,,1,Harbhajan Singh,R McLaren,19,9,3,0,1,8,5,1,0,10,4,2,0
6480bba0f858e6c12b25d8c3,2014,,,2,V Sehwag,WP Saha,19,15,2,1,1,5,5,1,0,14,10,1,1
6480bb95c28e7980e1768064,2018,,,2,JC Buttler,K Gowtham,19,8,0,2,1,5,4,0,0,13,4,0,2
6480bba097818bcc0db9555d,2014,,,2,DW Steyn,KV Sharma,19,20,0,1,1,10,13,0,0,9,7,0,1
6480bb97752fcb9cd9f23692,2021,,,1,KL Rahul,M Shahrukh Khan,19,9,3,0,1,12,7,2,0,5,2,1,0
6480bb941ab79050c3c90ee5,2018,,,1,CA Lynn,SP Narine,19,9,1,2,1,6,5,1,0,12,4,0,2
6480bb94605dacb25c83dc35,2018,,,2,RR Pant,SS Iyer,19,16,2,0,1,4,7,0,0,15,9,2,0
6480bb9f0f959bc6104820c3,2013,,,2,BJ Hodge,R Dravid,19,16,1,1,1,5,6,0,0,14,10,1,1
6480bb9a1e358307d26cd50d,2023,,,1,HH Pandya,Rashid Khan,19,6,2,1,0,12,4,1,1,5,2,1,0
6480bb974086cbea889134af,2021,,,2,MP Stoinis,RR Pant,19,12,3,0,1,14,9,3,0,4,3,0,0
6480bb9a0a8baa96f94e8db9,2023,,,2,A Badoni,KH Pandya,19,19,3,0,1,3,8,0,0,14,11,3,0
6480bb954714437843ab3647,2019,,,1,AR Patel,KMA Paul,19,10,1,1,1,10,6,1,0,7,4,0,1
6480bb97668d35800fa74139,2021,,,1,M Shahrukh Khan,MC Henriques,19,13,0,1,1,9,6,0,1,5,7,0,0
6480bb9c13817091131f76e3,2009/10,,,1,TL Suman,WPUJC Vaas,19,13,1,1,1,3,3,0,0,16,10,1,1
6480bba2b341a081c069198d,2015,,,2,AM Rahane,SV Samson,19,17,2,0,1,14,9,2,0,5,8,0,0
6480bba1553f17c77d5f1ca2,2014,,,2,KA Pollard,RG Sharma,19,11,3,0,0,6,7,0,0,13,4,3,0
6480bb9c12e6c723b248799b,2009,,,1,R Vinay Kumar,RV Uthappa,19,14,1,1,1,8,8,1,0,10,6,0,1
6480bb9d69cb9046a72d8fbe,2009/10,,,2,AC Gilchrist,HH Gibbs,19,31,1,1,1,15,20,1,1,3,11,0,0
6480bba07b5396a7b65684d3,2013,,,2,DB Das,EJG Morgan,19,15,1,1,1,12,9,1,1,2,6,0,0
6480bb96c0ffb76dab723a2b,2019,,,2,AT Rayudu,MS Dhoni,19,16,3,0,1,9,7,2,0,9,9,1,0
6480bb99e520ec7a66b73adb,2022,,,1,RR Pant,SN Khan,19,18,1,1,1,9,11,1,0,10,7,0,1
6480bb9a0a8baa96f94e8db9,2023,,,1,F du Plessis,KD Karthik,19,14,1,1,1,6,6,0,0,13,8,1,1
6480bb9fe31a789bcb52d583,2012,,,2,MK Tiwary,YK Pathan,19,14,2,0,0,3,4,0,0,15,10,2,0
6480bb9eb2690fb1ed356b42,2011,,,2,B Chipli,DT Christian,19,22,1,0,1,9,9,1,0,10,13,0,0
6480bb97aa725a640d0f8e2f,2021,,,1,CH Morris,R Parag,19,18,2,0,1,14,10,2,0,4,8,0,0
6480bb9fc28e897b3c53f359,2012,,,2,AT Rayudu,JEC Franklin,19,10,2,1,1,11,7,2,0,7,3,0,1
6480bba373508e4f3f4be6c0,2016,,,2,AM Rahane,UT Khawaja,19,17,2,0,1,2,6,0,0,15,11,2,0
6480bb980d1be75574871dcc,2022,,,1,GJ Maxwell,V Kohli,19,15,1,1,1,15,11,1,1,3,4,0,0
6480bb9e502d7987de08e5d5,2012,,,2,IR Jaggi,JP Duminy,19,15,0,0,0,10,7,0,0,8,8,0,0
6480bba1568e0f3990191600,2014,,,2,KK Nair,SV Samson,19,12,1,1,1,6,4,0,0,13,8,1,1
6480bb97668d35800fa74139,2021,,,1,FA Allen,M Shahrukh Khan,19,19,0,1,1,6,11,0,0,11,8,0,1
6480bb9c5d0fccb6a3a6d37d,2009,,,1,M Vijay,ML Hayden,19,18,1,1,1,10,12,0,1,8,6,1,0
6480bba1105add9a994c58a7,2014,,,2,DA Warner,NV Ojha,19,6,1,2,0,6,3,1,0,13,3,0,2
6480bb9ab83a3072124dda22,2023,,,1,Abhishek Sharma,Anmolpreet Singh,19,14,3,0,1,7,5,1,0,10,9,2,0
6480bb95c28e7980e1768064,2018,,,1,AT Rayudu,SR Watson,19,13,3,0,1,12,9,2,0,7,4,1,0
6480bb9f302200e3bc89464e,2012,,,2,OA Shah,R Dravid,19,21,1,0,1,5,9,0,0,12,12,1,0
6480bb9fa3a890f94f179477,2013,,,1,AC Gilchrist,Mandeep Singh,19,15,3,0,1,9,6,2,0,9,9,1,0
6480bba09d1874eb9ded0204,2013,,,2,DPMD Jayawardene,V Sehwag,19,10,3,0,1,5,3,1,0,11,7,2,0
6480bb96c10dfe3d8c259db3,2020/21,,,2,PP Shaw,S Dhawan,19,11,4,0,1,9,6,2,0,10,5,2,0
6480bb97ce8cbd211049f957,2021,,,1,Ishan Kishan,RG Sharma,19,30,1,0,1,6,17,0,0,13,13,1,0
6480bb96ed06a5693a66b9f0,2020/21,,,1,RV Uthappa,SV Samson,19,12,2,1,1,10,7,2,0,9,5,0,1
6480bba01a3f8444c7a33ba6,2014,,,1,SPD Smith,STR Binny,19,24,0,0,1,11,13,0,0,8,11,0,0
6480bb953aab41e7ed166b9d,2019,,,1,RR Pant,S Dhawan,19,13,2,1,1,16,9,2,1,3,4,0,0
6480bb9813fa79617f791851,2022,,,2,HV Patel,KD Karthik,19,8,2,1,0,9,4,0,1,9,4,2,0
6480bba069d61566bb63ac2b,2014,,,1,AB de Villiers,Yuvraj Singh,19,18,2,0,1,10,9,1,0,8,9,1,0
6480bb9dd10e35e6145534dc,2011,,,1,DB Ravi Teja,S Dhawan,19,17,3,0,1,2,9,0,0,15,8,3,0
6480bb9a9dc58f49d783faa9,2023,,,2,R Ashwin,SO Hetmyer,19,6,0,3,1,0,0,0,0,19,6,0,3
6480bba3ebbd8e4867dfa673,2016,,,1,Mohammed Shami,P Negi,19,13,1,1,0,2,3,0,0,17,10,1,1
6480bb9da3dc1406b000cc98,2011,,,2,IK Pathan,NV Ojha,19,16,1,1,1,7,8,1,0,11,8,0,1
6480bb9824c4678d005d7aeb,2022,,,1,JC Buttler,SO Hetmyer,19,8,2,1,1,12,5,1,1,6,3,1,0
6480bb9b72f6a46338302131,2009,,,1,DB Ravi Teja,Y Venugopal Rao,19,12,2,0,1,1,3,0,0,16,9,2,0
6480bb9541caaeddc9ddaac3,2019,,,2,BA Stokes,SPD Smith,19,20,0,0,1,8,8,0,0,9,12,0,0
6480bb9e591b94e62772e66a,2012,,,2,RG Sharma,SR Tendulkar,19,12,1,2,1,12,5,1,1,7,7,0,1
6480bb953b102c650968cba2,2019,,,2,AT Rayudu,KM Jadhav,19,30,2,0,1,9,16,1,0,9,14,1,0
6480bb9c757dbd7f92b1130a,2009/10,,,1,RG Sharma,Y Venugopal Rao,19,15,3,0,1,12,6,2,0,7,9,1,0
6480bb9a3ffea6235f54cc1e,2023,,,1,JJ Roy,N Rana,19,18,3,0,1,11,12,2,0,5,6,1,0
6480bb9ca181f55cb21526f5,2009/10,,,2,EJG Morgan,JH Kallis,19,13,2,0,0,7,6,0,0,12,7,2,0
6480bba30373b229e0090b67,2016,,,2,Sachin Baby,TM Head,19,12,1,0,1,5,5,0,0,11,7,1,0
6480bba3b830360cf7031278,2016,,,1,HH Pandya,KA Pollard,19,26,2,0,1,6,13,0,0,11,13,2,0
6480bb95b1f28cf5bcf5e167,2018,,,1,CR Brathwaite,YK Pathan,19,21,3,0,1,4,10,0,0,14,11,3,0
6480bb96c95abb10156a6055,2020/21,,,2,F du Plessis,SM Curran,19,7,1,2,1,1,1,0,0,18,6,1,2
6480bb953aab41e7ed166b9d,2019,,,1,S Dhawan,SS Iyer,19,14,2,1,1,2,4,0,0,16,10,2,1
6480bba2aecb4103bab63c15,2016,,,1,AM Rahane,NLTC Perera,19,15,0,1,1,6,6,0,0,12,9,0,1
6480bb988545a7776b8c9306,2022,,,1,RD Gaikwad,RV Uthappa,19,22,3,0,1,17,16,3,0,2,6,0,0
6480bb9ab655ac367694708c,2007/08,,,2,D Salunkhe,SK Trivedi,19,17,3,0,0,16,10,3,0,3,7,0,0
6480bb976caaa0cc91f652c7,2021,,,2,EJG Morgan,RA Tripathi,19,15,1,2,1,7,8,0,1,12,7,1,1
6480bb9b4fc6889967a3cd54,2007/08,,,2,PR Shah,YV Takawale,19,9,2,0,1,10,6,2,0,3,3,0,0
6480bb9c266a85f1960d87e9,2009,,,1,G Gambhir,V Sehwag,19,16,2,0,1,7,8,0,0,9,8,2,0
6480bb9be7cbbb90a12dc916,2009,,,1,ML Hayden,MS Dhoni,19,17,1,1,1,14,10,1,1,5,7,0,0
6480bb9da3dc1406b000cc98,2011,,,1,RV Uthappa,Yuvraj Singh,19,21,1,1,1,4,10,0,0,15,11,1,1
6480bb9f0f1f6c03d8e2f039,2013,,,1,AD Mathews,SPD Smith,19,24,0,0,1,9,9,0,0,10,15,0,0
6480bba1105add9a994c58a7,2014,,,1,KD Karthik,MA Agarwal,19,14,2,0,1,4,4,0,0,15,10,2,0
6480bb9b6ded6d116cfe02ee,2009,,,2,Harbhajan Singh,ST Jayasuriya,19,9,1,2,1,18,8,1,2,1,1,0,0
6480bb94adb227976b33d30b,2018,,,2,CA Lynn,SP Narine,19,11,2,1,1,5,6,1,0,14,5,1,1
6480bba2c3207713bd927ce5,2015,,,1,DA Warner,EJG Morgan,19,10,1,2,1,2,3,0,0,17,7,1,2
6480bb94f46306dbde97aa5c,2017,,,2,G Gambhir,SP Narine,19,19,1,1,1,7,10,1,0,9,9,0,1
6480bba38056992b92414bab,2016,,,2,KV Sharma,MC Henriques,19,14,1,0,1,3,5,0,0,10,9,1,0
6480bb9d85a6220ec9bc7dcb,2011,,,2,M Vijay,MEK Hussey,19,27,1,0,1,7,9,0,0,9,18,1,0
6480bb94b991069934e5c7d2,2018,,,1,DS Kulkarni,JC Buttler,19,10,1,0,1,3,3,0,0,12,7,1,0
6480bb9809c62ba77e5df472,2021,,,1,GJ Maxwell,V Kohli,19,16,2,0,1,10,8,1,0,7,8,1,0
6480bb9bd918d2e963f0218a,2009,,,1,KP Pietersen,RV Uthappa,19,21,2,0,1,9,10,1,0,8,11,1,0
6480bb9ba6cd609c32579bde,2009,,,2,SR Tendulkar,ST Jayasuriya,19,20,2,0,1,8,12,1,0,6,8,1,0
6480bb98bc3569cc8d04101a,2022,,,2,SS Iyer,VR Iyer,19,11,4,0,1,10,6,2,0,9,5,2,0
6480bb96e834e1c16b33f325,2020/21,,,2,JC Archer,R Tewatia,19,5,0,3,1,13,3,0,2,6,2,0,1
6480bb9f777b7b1e89543a6e,2013,,,2,AT Rayudu,MG Johnson,19,14,3,0,1,8,5,1,0,11,9,2,0
6480bb9a3d3f26063faa9f71,2007/08,,,2,MV Boucher,R Dravid,19,26,1,0,1,11,15,1,0,5,11,0,0
6480bba2c04b3acd88a50839,2015,,,1,MK Pandey,PP Chawla,19,16,1,0,1,6,6,0,0,12,10,1,0
6480bb990942cd416cf5f447,2022,,,2,KL Rahul,Q de Kock,19,21,1,1,1,8,11,1,0,11,10,0,1
6480bba1f5d65d6146678a7f,2015,,,1,JP Duminy,SS Iyer,19,19,3,0,1,5,8,1,0,13,11,2,0
6480bba38060854b4fab1831,2016,,,2,AT Rayudu,N Rana,19,21,0,2,1,10,10,0,1,9,11,0,1
6480bb9f6b144f2a6d105b32,2013,,,1,B Laughlin,MS Dhoni,18,6,2,1,1,0,1,0,0,16,5,2,1
6480bba1670ace74604a420f,2015,,,1,DR Smith,SK Raina,18,17,1,0,1,7,10,1,0,4,7,0,0
6480bba2c04b3acd88a50839,2015,,,1,J Botha,SA Yadav,18,6,4,0,1,17,5,4,0,1,1,0,0
6480bb9a3d3f26063faa9f71,2007/08,,,1,DJ Hussey,T Taibu,18,9,0,2,1,14,5,0,2,3,4,0,0
6480bb9d967f5a4cfbd8c74d,2011,,,1,IK Pathan,JR Hopes,18,23,1,1,1,9,12,0,1,9,11,1,0
6480bb9873e53eace3a69dc7,2022,,,2,RK Singh,SS Iyer,18,11,0,2,1,8,6,0,1,8,5,0,1
6480bb9af1b34d6aa89e434e,2023,,,2,LS Livingstone,RD Chahar,18,10,1,2,1,17,10,1,2,0,0,0,0
6480bb958f77e7d3929d28e3,2018,,,1,KK Nair,MM Sharma,18,8,1,2,1,17,6,1,2,1,2,0,0
6480bba358370ecde0231113,2016,,,2,KS Williamson,MC Henriques,18,14,2,0,1,8,7,1,0,10,7,1,0
6480bb94009d0662ee94f07b,2018,,,2,DJ Hooda,Shakib Al Hasan,18,16,2,0,1,8,6,1,0,10,10,1,0
6480bba13b673297bce003e2,2014,,,1,MK Pandey,RV Uthappa,18,17,3,0,1,13,12,3,0,4,5,0,0
6480bb9ec90f99c5ea40b014,2012,,,1,Shakib Al Hasan,YK Pathan,18,13,1,1,1,12,7,1,1,3,6,0,0
6480bba358370ecde0231113,2016,,,2,DA Warner,S Dhawan,18,20,1,1,1,11,14,0,1,6,6,1,0
6480bb9d182be5b0fbe5a4e2,2011,,,2,A Symonds,KA Pollard,18,33,0,0,1,9,18,0,0,4,15,0,0
6480bba296f606ef91305124,2016,,,1,DA Warner,S Dhawan,18,17,2,0,1,9,10,1,0,6,7,1,0
6480bb9c3b082d71291a593c,2009,,,1,LRPL Taylor,P Kumar,18,10,0,1,1,3,5,0,0,11,5,0,1
6480bb9eeeaf037e5e41ab86,2012,,,1,AM Rahane,OA Shah,18,13,2,0,1,3,5,0,0,14,8,2,0
6480bb9e1a26096ce68e9ca3,2012,,,1,KK Cooper,STR Binny,18,12,3,0,1,8,6,2,0,8,6,1,0
6480bb9f6b144f2a6d105b32,2013,,,2,AT Rayudu,KD Karthik,18,13,2,0,1,4,4,0,0,13,9,2,0
6480bba0404171e13faa181e,2013,,,2,AT Rayudu,KA Pollard,18,13,0,1,1,8,6,0,0,10,7,0,1
6480bb964c4bea88164f168d,2020/21,,,2,JD Unadkat,TK Curran,18,20,0,0,1,9,13,0,0,8,7,0,0
6480bb96593f4f87a2c294bc,2020/21,,,2,DA Warner,JM Bairstow,18,10,2,1,1,6,6,1,0,10,4,1,1
6480bb9f60d58ee39ba047b9,2013,,,2,A Ashish Reddy,NLTC Perera,18,11,2,0,1,16,9,2,0,2,2,0,0
6480bb96c0ffb76dab723a2b,2019,,,2,AT Rayudu,SK Raina,18,22,1,0,1,10,12,1,0,8,10,0,0
6480bb9f6f311344dac147cc,2012,,,2,MK Pandey,RV Uthappa,18,15,2,0,1,7,6,1,0,8,9,1,0
6480bb98436587de59527f2e,2022,,,1,DR Sams,Ishan Kishan,18,6,2,1,0,7,2,0,1,10,4,2,0
6480bb99f649ea7a6d79892f,2023,,,2,MA Agarwal,RA Tripathi,18,28,0,1,1,7,11,0,0,11,17,0,1
6480bb994877788ec5b187ff,2023,,,2,F du Plessis,Shahbaz Ahmed,18,11,0,2,1,8,5,0,1,9,6,0,1
6480bb9f895e5780080c8059,2012,,,2,DPMD Jayawardene,Y Venugopal Rao,18,15,2,1,1,8,10,1,0,10,5,1,1
6480bba2256bfaaf14c57ead,2015,,,1,JP Faulkner,SR Watson,18,10,2,1,1,6,6,1,0,11,4,1,1
6480bb9d7aa8d2c4c947d164,2009/10,,,1,JH Kallis,MK Pandey,18,15,1,1,1,13,9,1,1,1,6,0,0
6480bb95a65bb0f3394a62b5,2018,,,1,AD Hales,S Dhawan,18,21,3,0,1,2,9,0,0,16,12,3,0
6480bb9480627b50308b7903,2017,,,2,KA Pollard,KH Pandya,18,15,2,0,1,10,8,1,0,8,7,1,0
6480bb95385ebb9bda58a643,2019,,,2,A Mishra,K Rabada,18,14,0,1,1,3,6,0,0,9,8,0,1
6480bb9772f78629131db057,2021,,,1,F du Plessis,RD Gaikwad,18,23,1,0,1,4,9,0,0,12,14,1,0
6480bb99d43295fa2d82c9dc,2023,,,2,Aman Hakim Khan,MK Pandey,18,10,2,1,1,1,1,0,0,17,9,2,1
6480bb99864a94e086c8395e,2022,,,1,Abhishek Sharma,PK Garg,18,16,2,0,1,9,10,1,0,5,6,1,0
6480bb958f737f809dfb65e1,2019,,,1,CH Morris,SS Iyer,18,16,2,0,1,8,9,1,0,9,7,1,0
6480bb947a7c9fe868fc901a,2017,,,1,CJ Anderson,RR Pant,18,21,2,0,1,3,9,0,0,15,12,2,0
6480bb9774dd8e44bbeeb5a4,2021,,,1,CH Gayle,MA Agarwal,18,11,2,1,1,13,9,1,1,5,2,1,0
6480bb963d224b9be17f2c75,2019,,,1,MK Pandey,V Shankar,18,17,1,0,1,11,9,1,0,7,8,0,0
6480bb95a8153d4daac6e4f7,2019,,,1,KD Karthik,Shubman Gill,18,15,1,0,1,9,6,1,0,9,9,0,0
6480bb99f33a7dd80eb0a544,2023,,,2,Atharva Taide,LS Livingstone,18,9,3,0,1,9,4,2,0,9,5,1,0
6480bb9f7ff1377c4d13a645,2013,,,2,AD Mathews,MR Marsh,18,16,0,1,1,10,6,0,1,8,10,0,0
6480bb99b0fa4d217ed7f255,2023,,,1,DA Warner,SN Khan,18,16,1,1,1,8,8,1,0,10,8,0,1
6480bb99b3179a9346d8883c,2022,,,1,D Padikkal,SV Samson,18,12,4,0,1,12,8,3,0,6,4,1,0
6480bb99d43295fa2d82c9dc,2023,,,2,A Nortje,Aman Hakim Khan,18,10,2,0,1,8,5,1,0,9,5,1,0
6480bb981f136a7564719d7f,2022,,,2,DA Miller,R Tewatia,18,5,1,2,0,5,2,1,0,13,3,0,2
6480bb9765a785922ad360fe,2021,,,1,B Kumar,Rashid Khan,18,8,2,1,1,5,2,1,0,11,6,1,1
6480bba20130c44ed20c9bcf,2016,,,1,AT Rayudu,PA Patel,18,17,0,1,1,12,10,0,1,6,7,0,0
6480bb9a0474602f26069e45,2007/08,,,1,GC Smith,SR Watson,18,14,1,1,0,4,6,0,0,14,8,1,1
6480bb9d05f8e769574069fa,2009/10,,,2,AB Agarkar,CA Pujara,18,9,0,2,1,3,4,0,0,14,5,0,2
6480bb99864a94e086c8395e,2022,,,1,KS Williamson,Washington Sundar,18,12,1,0,1,7,5,1,0,9,7,0,0
6480bb9b77a0ff5cb3d0e3e0,2009,,,1,JA Morkel,S Badrinath,18,14,1,0,1,2,2,0,0,12,12,1,0
6480bba090c88df75eba18e6,2014,,,2,MA Starc,V Kohli,18,11,3,0,1,7,5,1,0,10,6,2,0
6480bb9718a9b89de407178b,2021,,,2,Lalit Yadav,MP Stoinis,18,8,3,0,0,12,6,2,0,5,2,1,0
6480bb9836af59f8283f4081,2022,,,2,Ishan Kishan,SA Yadav,18,19,3,0,1,6,8,1,0,12,11,2,0
6480bb954817ed0a4ba25bc2,2018,,,2,AR Patel,KL Rahul,18,10,3,0,1,2,3,0,0,15,7,3,0
6480bba2a01f4062fc561247,2016,,,2,SA Yadav,YK Pathan,18,8,3,0,0,5,2,1,0,12,6,2,0
6480bb9aded509be64de3bfb,2007/08,,,2,I Sharma,LR Shukla,18,9,3,0,1,2,2,0,0,15,7,3,0
6480bb9db9ed29ce1ee8764f,2011,,,1,DA Warner,Y Nagar,18,14,1,1,1,6,5,0,0,11,9,1,1
6480bb9d80536875f41bc605,2011,,,2,AC Blizzard,SR Tendulkar,18,15,4,0,1,6,6,1,0,12,9,3,0
6480bba2563745309ee2bdfb,2016,,,1,Ishan Kishan,RA Jadeja,18,19,1,0,1,7,9,1,0,10,10,0,0
6480bba38056992b92414bab,2016,,,2,KS Williamson,Yuvraj Singh,18,14,0,2,1,3,5,0,0,13,9,0,2
6480bb9a17692bfb5bd3894c,2007/08,,,1,JA Morkel,S Badrinath,18,9,0,2,1,13,5,0,2,5,4,0,0
6480bba2fc84811f520b04cf,2016,,,2,Ishan Kishan,KD Karthik,18,14,3,0,1,11,8,2,0,6,6,1,0
6480bba3de527604cd2f96f3,2016,,,1,KK Nair,SV Samson,18,10,2,0,0,13,6,2,0,3,4,0,0
6480bb966f48b8ee03e6dff5,2020/21,,,1,MS Dhoni,RA Jadeja,18,15,3,0,1,9,9,2,0,7,6,1,0
6480bb95f282ca61c07afe9b,2018,,,2,AT Rayudu,SR Watson,18,18,2,1,1,6,4,0,1,11,14,2,0
6480bb94fbd0b904d63e0e07,2017,,,1,AR Patel,Anureet Singh,18,12,2,0,1,15,8,2,0,3,4,0,0
6480bb9bca2c11520f5b3b9e,2007/08,,,2,PP Chawla,WA Mota,18,23,1,0,1,12,15,1,0,6,8,0,0
6480bb9894cc2d00f057a1f1,2021,,,1,AR Patel,SS Iyer,18,9,1,1,0,4,4,0,0,14,5,1,1
6480bba1b8e3071cc513602a,2014,,,2,DA Warner,NV Ojha,18,17,1,0,1,6,7,0,0,11,10,1,0
6480bb9774a44376e3b5eb6f,2021,,,1,Shubman Gill,VR Iyer,18,14,3,0,1,7,7,1,0,10,7,2,0
6480bb9ec07aa72ec89917f0,2012,,,1,KP Pietersen,V Sehwag,18,14,2,0,1,3,3,0,0,15,11,2,0
6480bb96c10dfe3d8c259db3,2020/21,,,2,MP Stoinis,RR Pant,18,10,1,1,0,10,5,0,1,6,5,1,0
6480bb980ea7c3bcea4fdf9c,2022,,,1,Mohsin Khan,PVD Chameera,18,5,0,3,1,6,2,0,1,12,3,0,2
6480bba1d21281c7385d5ce4,2014,,,1,PA Patel,S Rana,18,19,4,0,1,9,8,2,0,9,11,2,0
6480bb9db0ecec8acdd30619,2011,,,2,Harpreet Singh,RV Uthappa,18,9,2,1,0,1,1,0,0,15,8,2,1
6480bb9c121ee402b7b2eda6,2009,,,2,RG Sharma,Y Venugopal Rao,18,16,1,0,1,10,7,1,0,8,9,0,0
6480bb9e335bec070f88430f,2011,,,2,MS Dhoni,SB Jakati,18,7,1,2,0,18,7,1,2,0,0,0,0
6480bb9523e6dc3c988ce398,2019,,,2,SP Narine,Shubman Gill,18,17,4,0,1,17,12,4,0,1,5,0,0
6480bb99349f00f851e8d2fd,2023,,,2,TH David,Tilak Varma,18,11,0,1,1,15,7,0,1,3,4,0,0
6480bb9c3803ef7726af83ab,2009/10,,,2,AA Jhunjhunwala,NV Ojha,18,8,0,2,1,7,4,0,1,8,4,0,1
6480bb9e565ef5f11c5c8f55,2011,,,2,CK Langeveldt,S Aravind,18,9,2,1,1,7,4,0,1,11,5,2,0
6480bb9e56c724ba25b94666,2011,,,2,DS Kulkarni,KA Pollard,18,10,1,1,1,2,2,0,0,15,8,1,1
6480bba2d324f0342e6af689,2016,,,1,KD Karthik,SK Raina,18,16,2,0,1,8,9,1,0,9,7,1,0
6480bb99d2bd76016d47896d,2023,,,2,Aman Hakim Khan,DA Warner,18,11,2,0,1,4,5,0,0,14,6,2,0
6480bb9dc4ec5a52f8bcc465,2009/10,,,2,Harbhajan Singh,JP Duminy,18,10,1,1,1,9,7,1,0,8,3,0,1
6480bb9c6f1c8ea3dc73226f,2009/10,,,1,AB de Villiers,V Sehwag,18,15,3,0,1,11,9,2,0,7,6,1,0
6480bb94605dacb25c83dc35,2018,,,1,KK Nair,MA Agarwal,18,18,2,0,1,13,10,2,0,5,8,0,0
6480bb958c7b985a2b586a02,2018,,,1,AT Rayudu,MS Dhoni,18,18,2,0,1,15,13,2,0,3,5,0,0
6480bb9932735ca83d38f6e7,2022,,,2,AK Markram,Abhishek Sharma,18,21,1,0,1,10,14,0,0,8,7,1,0
6480bb95b1f28cf5bcf5e167,2018,,,2,DJ Bravo,F du Plessis,18,22,0,1,1,7,11,0,0,11,11,0,1
6480bb9b166300b6298fc71a,2009,,,2,NV Ojha,YK Pathan,18,9,1,2,1,6,2,0,1,12,7,1,1
6480bb97fcc6fccd233157f9,2021,,,1,PP Shaw,S Dhawan,18,19,1,0,1,10,11,0,0,8,8,1,0
6480bb9e28b7a946a6921fa6,2011,,,2,Harbhajan Singh,SR Tendulkar,18,10,2,1,1,13,7,1,1,5,3,1,0
6480bb9d8f5769d3a514fd88,2009/10,,,2,AM Nayar,S Dhawan,18,11,2,0,1,2,4,0,0,11,7,2,0
6480bba0404171e13faa181e,2013,,,2,DR Smith,RG Sharma,18,19,0,1,1,11,10,0,1,7,9,0,0
6480bb9be7cbbb90a12dc916,2009,,,1,ML Hayden,SK Raina,18,15,3,0,1,10,6,2,0,8,9,1,0
6480bb9e4bb50b724830b249,2011,,,1,G Gambhir,JH Kallis,18,10,2,1,1,8,7,0,1,8,3,2,0
6480bb996c324f07ab7f763c,2023,,,1,A Manohar,B Sai Sudharsan,18,11,3,0,1,14,8,3,0,4,3,0,0
6480bb9c7bc1dc527c14f1ac,2009/10,,,1,AD Mathews,DJ Hussey,18,8,2,1,0,5,3,1,0,11,5,1,1
6480bb94ce8e0a620532955b,2018,,,2,RR Pant,SS Iyer,18,12,1,1,1,15,7,1,1,3,5,0,0
6480bba237377ccc608266d2,2016,,,1,DA Miller,GJ Maxwell,18,13,0,1,1,10,6,0,1,8,7,0,0
6480bb97ce981c1918dce924,2021,,,2,MK Pandey,Mohammad Nabi,18,10,1,1,1,14,6,1,1,3,4,0,0
6480bb9c3b082d71291a593c,2009,,,1,LRPL Taylor,RV Uthappa,18,18,3,0,1,13,16,2,0,4,2,1,0
6480bb99e520ec7a66b73adb,2022,,,1,AR Patel,R Powell,18,14,0,2,1,10,6,0,1,8,8,0,1
6480bb9b9dd7fe8c5cbdbab0,2009,,,1,MS Dhoni,SK Raina,18,15,2,0,1,5,7,0,0,13,8,2,0
6480bb9558345af5a1bb044d,2019,,,1,AB de Villiers,AD Nath,18,9,2,1,1,16,7,2,1,2,2,0,0
6480bb96c0ffb76dab723a2b,2019,,,1,RR Pant,SS Iyer,18,16,2,0,1,10,7,1,0,8,9,1,0
6480bb9f60d58ee39ba047b9,2013,,,1,J Botha,MC Juneja,18,26,1,0,1,9,14,1,0,9,12,0,0
6480bb98bc3569cc8d04101a,2022,,,2,AD Russell,VR Iyer,18,9,2,1,1,11,5,1,1,7,4,1,0
6480bb9c9f9d5376b4227724,2009/10,,,1,AB Agarkar,WP Saha,18,9,3,0,0,8,5,1,0,10,4,2,0
6480bba07fa24b891b818984,2013,,,1,DA Miller,M Vohra,18,10,4,0,1,5,4,1,0,13,6,3,0
6480bb984f0f3dc0df6d4531,2022,,,2,DA Miller,HH Pandya,18,10,3,0,1,7,5,1,0,10,5,2,0
6480bb958e752648ab95362b,2019,,,2,F du Plessis,SR Watson,18,14,2,1,1,1,5,0,0,17,9,2,1
6480bb9c8cbb5dec60b7d50a,2009/10,,,2,A Symonds,HH Gibbs,18,12,3,0,1,17,11,3,0,0,1,0,0
6480bb96e8ba017befb2bc8a,2020/21,,,1,P Dubey,R Ashwin,18,17,0,1,1,5,9,0,0,12,8,0,1
6480bb933fdc96ee7273400e,2017,,,2,KA Pollard,N Rana,18,13,2,0,1,13,8,2,0,5,5,0,0
6480bb9b52b93b56f5a16e52,2007/08,,,2,M Rawat,YK Pathan,18,9,2,1,1,2,4,0,0,16,5,2,1
6480bb94457bfc7687322f80,2017,,,2,BB McCullum,Ishan Kishan,18,15,4,0,1,2,4,0,0,16,11,4,0
6480bb9b9ca80d1c48994e04,2007/08,,,2,S Badrinath,SP Fleming,18,16,3,0,1,2,5,0,0,15,11,3,0
6480bb9f59fd8000010baf09,2013,,,2,BJ Rohrer,DPMD Jayawardene,18,18,2,0,1,14,14,2,0,4,4,0,0
6480bb94ca96a1c1f17d1294,2017,,,1,AM Rahane,RA Tripathi,18,19,2,0,1,6,8,0,0,11,11,2,0
6480bb9e692eaa193a417426,2012,,,1,AB de Villiers,DL Vettori,18,12,1,1,1,14,8,1,1,3,4,0,0
6480bb9f00ef088221497043,2013,,,2,MEK Hussey,RA Jadeja,18,8,0,2,1,8,4,0,1,9,4,0,1
6480bba0ddcc30675d83403c,2013,,,2,A Ashish Reddy,DJG Sammy,18,11,1,1,1,12,7,0,1,6,4,1,0
6480bb9435048f20502ba1e1,2018,,,1,Mandeep Singh,V Kohli,18,16,1,1,1,14,10,1,1,4,6,0,0
6480bb99efa58b95852be382,2023,,,2,R Tewatia,V Shankar,18,18,1,1,1,4,9,0,0,14,9,1,1
6480bb9ed74d222a3da56dfa,2012,,,1,R Vinay Kumar,SS Tiwary,18,15,1,0,1,7,8,0,0,9,7,1,0
6480bba1827557ebdfc70821,2015,,,2,G Gambhir,MK Pandey,18,13,3,0,1,6,7,1,0,12,6,2,0
6480bb9fe7d0f611ba6ad229,2012,,,1,MJ Clarke,RV Uthappa,18,17,2,0,1,13,10,2,0,5,7,0,0
6480bb94704f6dfeb7f4d270,2017,,,1,AR Patel,R Tewatia,18,10,3,0,0,1,2,0,0,15,8,3,0
6480bb946efcc4cd9aa80399,2018,,,2,N Rana,RV Uthappa,18,13,1,1,1,12,6,1,1,4,7,0,0
6480bb96ebf33df82879ad4c,2020/21,,,1,Abdul Samad,PK Garg,18,13,1,0,0,8,6,0,0,9,7,1,0
6480bba11a59d64bb4aa66f4,2014,,,2,BJ Hodge,R Tewatia,18,16,0,1,1,7,10,0,0,9,6,0,1
6480bb99cf7659c6e45bd01d,2023,,,1,M Jansen,Washington Sundar,18,15,2,0,1,8,9,1,0,9,6,1,0
6480bba1743abcb135a6a4c7,2015,,,1,AR Patel,M Vijay,18,22,2,0,1,9,10,1,0,7,12,1,0
6480bb983ad1bab18d1d8774,2022,,,1,AM Rahane,SS Iyer,18,11,3,0,1,6,5,1,0,11,6,2,0
6480bba13b673297bce003e2,2014,,,1,RN ten Doeschate,RV Uthappa,18,8,2,1,0,6,3,0,1,11,5,2,0
6480bb9b9ca80d1c48994e04,2007/08,,,2,S Vidyut,SP Fleming,18,17,3,0,1,16,11,3,0,2,6,0,0
6480bba328f7475f4b87d3ff,2016,,,1,BB McCullum,SK Raina,18,7,1,1,1,6,3,0,1,6,4,1,0
6480bb9c21492b9a562c6f46,2009/10,,,2,BJ Hodge,MK Tiwary,18,18,3,0,1,6,5,1,0,11,13,2,0
6480bb95945c5e5dc4d8c7d6,2019,,,1,KA Pollard,SA Yadav,18,11,2,0,1,4,4,0,0,13,7,2,0
6480bb9ec90f99c5ea40b014,2012,,,2,BJ Hodge,J Botha,18,11,1,1,0,10,4,0,1,6,7,1,0
6480bba234aac105851964b1,2015,,,2,D Wiese,SN Khan,18,12,0,1,1,12,7,0,1,5,5,0,0
6480bba03b6f98689b851317,2013,,,2,DJ Hussey,Gurkeerat Singh,18,16,1,0,1,8,8,0,0,9,8,1,0
6480bba20559f15c3489f637,2015,,,1,AT Rayudu,KA Pollard,18,17,2,0,1,7,7,1,0,11,10,1,0
6480bb939b2499e9af6ee18c,2017,,,2,BB McCullum,Ishan Kishan,18,15,1,1,1,13,7,1,1,4,8,0,0
6480bba163bd0c619365a16b,2015,,,2,Harbhajan Singh,SL Malinga,18,18,1,1,1,9,10,0,1,6,8,1,0
6480bb9e80233e83b9d1be1f,2012,,,2,KP Pietersen,V Sehwag,18,17,2,0,1,9,8,1,0,8,9,1,0
6480bb9e591b94e62772e66a,2012,,,1,KP Pietersen,V Sehwag,18,12,2,1,1,16,10,2,1,1,2,0,0
6480bb9d182be5b0fbe5a4e2,2011,,,2,AT Rayudu,RG Sharma,18,26,1,0,1,6,9,0,0,11,17,1,0
6480bb99b4febfb641fddd39,2023,,,1,HR Shokeen,Tilak Varma,18,10,2,1,1,5,3,1,0,13,7,1,1
6480bb9e59fe7a0f48b7f9b9,2012,,,1,LRPL Taylor,Y Nagar,18,20,1,0,1,9,10,1,0,7,10,0,0
6480bba119569fcc2d7859a4,2014,,,2,CH Gayle,V Kohli,18,26,1,0,1,14,19,1,0,4,7,0,0
6480bb95d675b7da24db1a57,2019,,,2,CA Ingram,S Dhawan,18,10,1,1,0,14,6,1,1,4,4,0,0
6480bba3de527604cd2f96f3,2016,,,2,DA Warner,Yuvraj Singh,18,17,1,0,1,7,6,0,0,10,11,1,0
6480bb946efcc4cd9aa80399,2018,,,1,BB McCullum,Q de Kock,18,10,3,1,1,14,6,2,1,4,4,1,0
6480bb9523e6dc3c988ce398,2019,,,1,PA Patel,V Kohli,18,20,2,0,1,11,11,2,0,6,9,0,0
6480bb96a467817b9b68ca94,2020/21,,,2,KS Williamson,V Shankar,18,12,0,1,1,6,5,0,0,12,7,0,1
6480bb9b2ca4a7b325526f1f,2009,,,1,DR Smith,TL Suman,18,15,2,0,1,7,8,1,0,11,7,1,0
6480bb96c40b697b63d08717,2019,,,2,PP Shaw,SS Iyer,18,17,1,0,1,8,7,0,0,8,10,1,0
6480bb96fb897a6ff486ffe4,2020/21,,,1,KM Jadhav,RA Jadeja,18,14,2,0,0,4,7,0,0,13,7,2,0
6480bba2ebdcfb98389cee5a,2015,,,2,DR Smith,SK Raina,18,13,1,1,1,13,9,1,1,5,4,0,0
6480bb9800ba03eb1f9437d2,2022,,,1,Abhishek Sharma,RA Tripathi,18,13,2,1,1,2,3,0,0,16,10,2,1
6480bba2b341a081c069198d,2015,,,1,KD Karthik,Mandeep Singh,18,5,1,2,1,8,3,0,1,10,2,1,1
6480bb9e95693a2c4c4531e8,2011,,,1,KD Karthik,Mandeep Singh,18,12,3,0,1,7,5,1,0,11,7,2,0
6480bba00be5cdbaf6648462,2013,,,2,DJ Bravo,M Vijay,18,14,1,1,1,11,9,0,1,6,5,1,0
6480bba35038a60ea566794a,2016,,,1,AJ Finch,BB McCullum,18,19,1,1,1,14,14,1,1,4,5,0,0
6480bb9c963968000dfd00d1,2009/10,,,2,IK Pathan,RS Bopara,18,17,3,0,1,17,9,3,0,1,8,0,0
6480bb9cc5312f3d7cfb650e,2009/10,,,1,KC Sangakkara,RS Bopara,18,13,2,0,1,14,8,2,0,4,5,0,0
6480bb94738952e740c68749,2018,,,2,AS Rajpoot,Mujeeb Ur Rahman,18,12,3,0,1,6,7,1,0,10,5,2,0
6480bb94009d0662ee94f07b,2018,,,1,KH Pandya,SA Yadav,18,17,2,0,1,15,10,2,0,2,7,0,0
6480bba2c3207713bd927ce5,2015,,,2,DA Miller,Gurkeerat Singh,18,10,0,2,1,15,5,0,2,3,5,0,0
6480bba0a222eb875a07f5a3,2014,,,1,JP Duminy,M Vijay,18,18,2,0,1,6,9,1,0,9,9,1,0
6480bb9d86effd7e5e6a5261,2011,,,2,AB de Villiers,JJ van der Wath,18,10,1,1,1,18,8,1,1,0,2,0,0
6480bb9b0b09749af4aa32dd,2009,,,1,DPMD Jayawardene,Yuvraj Singh,18,9,2,1,1,2,3,0,0,14,6,2,1
6480bb994aafcf67cd092a7d,2023,,,2,B Sai Sudharsan,HH Pandya,18,12,2,1,1,11,8,1,1,5,4,1,0
6480bb9e9f1ef9ac02266570,2011,,,2,CJ Ferguson,SC Ganguly,18,12,3,0,0,15,8,3,0,2,4,0,0
6480bb955f4b3a84d6973620,2018,,,2,DJM Short,RA Tripathi,18,4,0,3,1,18,4,0,3,0,0,0,0
6480bb964592640608a9163c,2020/21,,,2,JC Buttler,SPD Smith,18,14,1,1,1,13,8,1,1,5,6,0,0
6480bb94adb227976b33d30b,2018,,,2,Kuldeep Yadav,MG Johnson,18,10,3,0,0,7,6,1,0,10,4,2,0
6480bb9de80788b3c3ebe4e1,2009/10,,,2,SR Tendulkar,SS Tiwary,18,11,3,0,1,1,2,0,0,15,9,3,0
6480bb94566b0cf89fca84f9,2018,,,1,F du Plessis,SK Raina,18,22,2,0,1,7,7,1,0,10,15,1,0
6480bb994aafcf67cd092a7d,2023,,,1,AR Patel,Aman Hakim Khan,18,14,0,2,1,10,6,0,1,8,8,0,1
6480bb946efcc4cd9aa80399,2018,,,2,AD Russell,KD Karthik,18,12,2,1,1,15,11,2,1,1,1,0,0
6480bb9d97cceb6330e84df0,2011,,,2,DPMD Jayawardene,PA Patel,18,17,1,0,1,7,10,1,0,7,7,0,0
6480bb964752e7c0f9e39d3c,2020/21,,,1,RA Tripathi,Shubman Gill,18,18,2,0,1,7,9,1,0,7,9,1,0
6480bb9a6ecee5429e0468be,2023,,,1,KR Mayers,M Vohra,18,22,2,0,1,14,17,2,0,4,5,0,0
6480bb99fe078839da40e7ab,2023,,,1,JJ Roy,Mandeep Singh,18,18,0,1,1,5,7,0,0,12,11,0,1
6480bb9f218f37b46bef4afb,2013,,,2,SPD Smith,Yuvraj Singh,18,12,0,2,1,2,4,0,0,15,8,0,2
6480bb9e30b7f3c09cfbdabb,2011,,,2,FY Fazal,R Dravid,18,18,3,0,1,16,15,3,0,1,3,0,0
6480bba2fbc243afec641844,2015,,,1,GJ Maxwell,Gurkeerat Singh,18,20,3,0,1,2,6,0,0,15,14,3,0
6480bb9ba9d43057d652a5fe,2009,,,1,K Goel,RS Bopara,18,23,0,1,1,12,12,0,1,6,11,0,0
6480bba01893b0faadb9c761,2013,,,1,Harbhajan Singh,MG Johnson,18,10,3,0,1,16,8,3,0,2,2,0,0
6480bb99349f00f851e8d2fd,2023,,,1,MW Short,P Simran Singh,18,15,2,0,1,11,10,2,0,5,5,0,0
6480bb9a7f7a862ba0b2c59e,2007/08,,,1,SK Raina,SP Fleming,18,13,3,0,1,7,5,1,0,9,8,2,0
6480bba163bd0c619365a16b,2015,,,1,AD Mathews,JP Duminy,18,8,3,0,1,17,8,3,0,0,0,0,0
6480bb95f45dffe4751efc46,2019,,,2,DA Miller,SN Khan,18,11,2,0,1,6,5,1,0,10,6,1,0
6480bb9575ad32214d0f6ec0,2019,,,1,Mujeeb Ur Rahman,R Ashwin,18,5,1,2,0,0,1,0,0,17,4,1,2
6480bb9af1b34d6aa89e434e,2023,,,2,LS Livingstone,M Shahrukh Khan,18,6,1,2,1,10,3,1,1,6,3,0,1
6480bb9a8cf29e28434bb1d5,2023,,,2,HH Pandya,Shubman Gill,18,13,4,0,1,12,6,3,0,6,7,1,0
6480bb96b56e8d513b451da1,2020/21,,,1,EJG Morgan,KD Karthik,18,31,1,1,1,13,18,1,1,4,13,0,0
6480bb9bf2869505c9393b7d,2009,,,2,I Sharma,M Kartik,18,17,0,1,1,9,9,0,1,8,8,0,0
6480bb9746dfc5c467942a84,2021,,,2,Anmolpreet Singh,Q de Kock,18,14,3,0,1,1,2,0,0,17,12,3,0
6480bb9d85a6220ec9bc7dcb,2011,,,1,JE Taylor,Yuvraj Singh,18,10,0,2,0,1,2,0,0,17,8,0,2
6480bba1b8e3071cc513602a,2014,,,2,AJ Finch,KL Rahul,18,15,3,0,1,6,6,1,0,11,9,2,0
6480bb957ae1619e0d648dec,2019,,,2,CH Gayle,KL Rahul,18,19,1,1,1,16,14,1,1,2,5,0,0
6480bb96ec7d98e34055e8fc,2020/21,,,1,R Tewatia,SPD Smith,18,13,2,0,1,10,8,1,0,8,5,1,0
6480bb971c9e4a3ef11759f3,2021,,,1,MA Agarwal,N Pooran,18,22,0,1,1,12,13,0,1,5,9,0,0
6480bb9cafc843037dc1e863,2009,,,1,LRPL Taylor,R Dravid,18,20,0,0,1,6,8,0,0,10,12,0,0
6480bba048fb3d33ea0711e7,2013,,,2,CL White,PA Patel,18,14,3,0,1,10,8,2,0,7,6,1,0
6480bb94f1c027945eeb8b10,2017,,,2,N Rana,PA Patel,18,15,2,1,1,9,11,2,0,8,4,0,1
6480bb9bf2869505c9393b7d,2009,,,2,A Chopra,BJ Hodge,18,32,2,0,1,11,19,2,0,5,13,0,0
6480bb9808d6857eeb335d94,2022,,,1,SS Iyer,VR Iyer,18,18,1,0,1,10,8,1,0,6,10,0,0
6480bb9e95693a2c4c4531e8,2011,,,2,IK Pathan,Y Venugopal Rao,18,15,1,1,1,3,6,0,0,14,9,1,1
6480bb9ded279701c84af803,2011,,,1,M Vijay,MEK Hussey,18,22,1,0,1,3,14,0,0,10,8,1,0
6480bb98960cf9374ee9420d,2022,,,1,DJ Hooda,KL Rahul,18,14,2,0,1,10,9,1,0,7,5,1,0
6480bb9c5d0fccb6a3a6d37d,2009,,,1,ML Hayden,SK Raina,18,18,2,1,1,4,7,1,0,13,11,1,1
6480bb9e19dd5297ba8ca5f7,2011,,,2,DT Christian,JP Duminy,18,15,1,1,1,7,6,1,0,10,9,0,1
6480bb98f01e4672b988c112,2022,,,1,D Padikkal,SV Samson,18,20,2,0,1,4,8,0,0,13,12,2,0
6480bba03b6f98689b851317,2013,,,2,Gurkeerat Singh,PP Chawla,18,6,1,2,0,17,4,1,2,0,2,0,0
6480bba0001885407e860a8d,2013,,,2,DA Warner,UBT Chand,18,22,1,0,1,8,13,0,0,8,9,1,0
6480bba328f7475f4b87d3ff,2016,,,2,JO Holder,YK Pathan,18,9,2,1,1,12,6,1,1,5,3,1,0
6480bba0f858e6c12b25d8c3,2014,,,1,SA Yadav,UT Yadav,18,9,3,0,1,16,7,3,0,1,2,0,0
6480bb9e2c96ab2b87d9466a,2011,,,2,AB Agarkar,M Morkel,18,12,2,0,1,5,3,1,0,10,9,1,0
6480bb9fe7d0f611ba6ad229,2012,,,1,AP Majumdar,SPD Smith,18,18,2,0,1,8,8,1,0,10,10,1,0
6480bb97220be892fbfc2a36,2021,,,2,AD Russell,KD Karthik,18,26,1,0,1,9,15,1,0,8,11,0,0
6480bb956e3f7f62e4b24c01,2019,,,2,CA Ingram,RR Pant,18,8,0,2,0,3,5,0,0,15,3,0,2
6480bb9f231505ffc493730f,2012,,,1,MS Dhoni,RA Jadeja,18,22,0,0,1,13,13,0,0,4,9,0,0
6480bb9d22388e966342dba8,2009/10,,,1,JA Morkel,SK Raina,18,14,1,1,1,15,6,1,1,3,8,0,0
6480bb97220be892fbfc2a36,2021,,,2,N Rana,Shakib Al Hasan,18,13,1,0,1,5,6,0,0,9,7,1,0
6480bb97c48a16e84b55a325,2020/21,,,1,Mohammed Siraj,Navdeep Saini,18,13,2,0,0,10,7,1,0,8,6,1,0
6480bb99b35dc0981e512451,2022,,,1,OC McCoy,R Parag,18,13,1,1,1,8,5,0,1,10,8,1,0
6480bba0d2cdb40c68c4739c,2013,,,1,JA Morkel,MS Dhoni,18,21,0,1,1,10,10,0,1,7,11,0,0
6480bb9b8860198955e581d8,2007/08,,,2,DPMD Jayawardene,IK Pathan,18,11,2,1,1,8,6,0,1,10,5,2,0
6480bb9d80536875f41bc605,2011,,,2,KA Pollard,TL Suman,18,13,2,1,1,2,5,0,0,16,8,2,1
6480bb9929c7e430acd1ef18,2022,,,2,A Nortje,SN Thakur,18,13,2,1,1,1,6,0,0,16,7,2,1
6480bb9f7258f976eb8fe943,2012,,,1,AL Menaria,BJ Hodge,18,8,2,1,1,5,3,1,0,13,5,1,1
6480bb9866dd8ba9b48863c2,2022,,,1,F du Plessis,SS Prabhudessai,18,13,1,1,1,6,4,1,0,10,9,0,1
6480bb9d61e9b86b0f0aae49,2009/10,,,1,B Sumanth,RJ Harris,18,11,0,1,0,6,4,0,0,12,7,0,1
6480bb9993e6e474a4e37366,2023,,,1,HR Shokeen,TH David,18,6,1,2,1,1,1,0,0,17,5,1,2
6480bb9c12e6c723b248799b,2009,,,2,HH Gibbs,TL Suman,18,18,1,0,1,5,7,0,0,10,11,1,0
6480bba071a7a0cbb02d505a,2013,,,1,RE van der Merwe,V Sehwag,18,16,2,0,1,8,9,1,0,9,7,1,0
6480bb98bd3ca4df44cf9d8f,2022,,,2,MR Marsh,RR Pant,18,15,2,0,1,4,6,0,0,14,9,2,0
6480bb9d59f2ded94f736145,2011,,,2,DB Ravi Teja,DT Christian,17,15,1,0,1,7,4,1,0,9,11,0,0
6480bb96686655f09172741d,2020/21,,,1,MP Stoinis,SO Hetmyer,17,10,1,1,0,5,3,1,0,11,7,0,1
6480bba11eff9b230a172302,2014,,,2,AM Rahane,SPD Smith,17,13,1,0,1,3,4,0,0,14,9,1,0
6480bb9866dd8ba9b48863c2,2022,,,2,KL Rahul,Q de Kock,17,17,2,0,1,13,12,2,0,3,5,0,0
6480bb9929c7e430acd1ef18,2022,,,1,AT Rayudu,MS Dhoni,17,7,2,1,1,5,3,1,0,11,4,1,1
6480bb9e565ef5f11c5c8f55,2011,,,2,AB de Villiers,SS Tiwary,17,12,3,0,1,12,7,2,0,5,5,1,0
6480bb9c761c43b2dfb9767d,2009,,,1,IK Pathan,S Sohal,17,13,3,0,1,0,3,0,0,15,10,3,0
6480bb9746dfc5c467942a84,2021,,,1,MS Dhoni,RD Gaikwad,17,18,3,0,1,3,5,0,0,14,13,3,0
6480bb9808d6857eeb335d94,2022,,,2,DA Warner,MR Marsh,17,8,3,0,1,4,1,1,0,13,7,2,0
6480bb9371e90dbd44ee19a3,2017,,,1,CJ Anderson,RR Pant,17,14,3,0,1,3,6,0,0,14,8,3,0
6480bb9932735ca83d38f6e7,2022,,,1,AM Rahane,VR Iyer,17,12,1,1,1,7,6,0,1,7,6,1,0
6480bb9d6ea22feab98beb5b,2011,,,2,J Botha,R Dravid,17,13,2,0,1,8,6,1,0,9,7,1,0
6480bb9c17dcdfd5b06984f0,2009/10,,,2,AD Mathews,WP Saha,17,11,3,0,1,11,7,2,0,6,4,1,0
6480bba2d324f0342e6af689,2016,,,1,DJ Bravo,SK Raina,17,19,0,0,1,8,12,0,0,8,7,0,0
6480bb95f282ca61c07afe9b,2018,,,1,Mandeep Singh,PA Patel,17,21,1,0,1,7,13,0,0,10,8,1,0
6480bb99d2bd76016d47896d,2023,,,1,KH Pandya,MP Stoinis,17,16,0,1,1,4,6,0,0,12,10,0,1
6480bb981b01a21305fd65d5,2022,,,1,B Sai Sudharsan,WP Saha,17,10,1,1,1,0,0,0,0,13,10,1,1
6480bb9b72f6a46338302131,2009,,,2,DS Kulkarni,RR Raje,17,15,0,1,0,7,9,0,0,10,6,0,1
6480bba3ebbd8e4867dfa673,2016,,,1,JP Duminy,KK Nair,17,22,0,0,1,9,11,0,0,8,11,0,0
6480bb980cc3d01eab3a4748,2022,,,2,LS Livingstone,M Shahrukh Khan,17,9,0,1,1,11,6,0,1,3,3,0,0
6480bb988545a7776b8c9306,2022,,,1,MM Ali,RV Uthappa,17,18,1,1,1,3,8,0,0,13,10,1,1
6480bb9774dd8e44bbeeb5a4,2021,,,1,MA Agarwal,P Simran Singh,17,21,0,1,1,5,5,0,0,12,16,0,1
6480bb9a24adc8d916dfe2db,2023,,,2,AK Markram,H Klaasen,17,13,2,0,1,10,8,1,0,7,5,1,0
6480bb9a6935abf34d88ca97,2007/08,,,1,IK Pathan,SM Katich,17,14,0,1,0,3,5,0,0,13,9,0,1
6480bb9800ba03eb1f9437d2,2022,,,2,DA Miller,R Tewatia,17,15,2,0,1,4,7,0,0,13,8,2,0
6480bba107ba9f7f041862c1,2014,,,2,G Gambhir,RV Uthappa,17,15,3,0,1,6,6,1,0,9,9,2,0
6480bba0eb5a345386bdc825,2013,,,2,BJ Hodge,STR Binny,17,18,1,0,1,5,9,0,0,11,9,1,0
6480bb96ef6f4c2c85264241,2019,,,2,KA Pollard,SA Yadav,17,13,1,1,1,4,7,0,0,13,6,1,1
6480bb93f866249511c76dbc,2017,,,2,BA Stokes,MK Tiwary,17,17,2,0,1,14,10,2,0,3,7,0,0
6480bba1dd2f8125fc8b203f,2014,,,1,AT Rayudu,CM Gautam,17,12,3,0,1,8,5,2,0,8,7,1,0
6480bb98291bb8b3f3e8145d,2022,,,2,AM Rahane,SS Iyer,17,13,3,0,1,6,7,1,0,11,6,2,0
6480bba0dcd1149b9b0b501f,2013,,,2,MK Tiwary,R Bhatia,17,8,1,1,0,2,3,0,0,13,5,1,1
6480bb9482dff502bff80bcf,2017,,,2,KS Williamson,Yuvraj Singh,17,20,1,0,1,11,12,1,0,5,8,0,0
6480bb97af05ebd5c4f575c4,2021,,,1,HH Pandya,KA Pollard,17,11,2,0,1,7,5,1,0,9,6,1,0
6480bba140ee53a14fe06e0d,2014,,,2,MS Dhoni,RA Jadeja,17,13,1,0,1,8,6,0,0,6,7,1,0
6480bb9c0dec1a788da66d33,2009/10,,,1,NV Ojha,YK Pathan,17,10,1,1,1,9,4,0,1,8,6,1,0
6480bb9bc80883a975281815,2009,,,1,KP Pietersen,RV Uthappa,17,26,1,0,1,13,16,1,0,3,10,0,0
6480bb94ebff9a116f68560b,2018,,,1,KD Karthik,Shivam Mavi,17,12,1,1,1,13,9,1,1,3,3,0,0
6480bb9fc9e4047271240a59,2012,,,1,MK Tiwary,Shakib Al Hasan,17,6,3,0,0,9,3,2,0,7,3,1,0
6480bba18a2fe828fa106f6c,2014,,,1,KK Nair,UBT Chand,17,15,1,1,1,13,6,1,1,2,9,0,0
6480bba04b49d2ff5f997e02,2013,,,1,AJ Finch,Yuvraj Singh,17,14,1,1,1,15,10,1,1,2,4,0,0
6480bba0001885407e860a8d,2013,,,1,DJG Sammy,KC Sangakkara,17,27,0,0,1,9,13,0,0,8,14,0,0
6480bb9c50838010977c168c,2009,,,1,JDP Oram,SK Raina,17,22,1,0,1,11,14,1,0,5,8,0,0
6480bb97c92184fed1a879f3,2021,,,1,JO Holder,Rashid Khan,17,17,2,0,1,9,8,1,0,7,9,1,0
6480bb9ff2e0b1df0c3972c9,2012,,,2,Azhar Mahmood,DJ Hussey,17,13,2,0,1,9,7,1,0,8,6,1,0
6480bb9f79be50f1621abcc6,2012,,,1,AM Nayar,Gurkeerat Singh,17,10,2,0,1,4,3,0,0,13,7,2,0
6480bb94c2dcb1007bf6788b,2017,,,2,GJ Maxwell,WP Saha,17,15,1,0,1,6,11,1,0,2,4,0,0
6480bb9f955d5c84cde78f58,2012,,,2,AD Mathews,B Kumar,17,13,1,0,1,14,8,1,0,3,5,0,0
6480bb9d867c041656e9a75f,2009/10,,,2,B Sumanth,R Sharma,17,12,2,0,0,3,4,0,0,14,8,2,0
6480bb9d03ce4b87b32b91f5,2009/10,,,2,MS Dhoni,SK Raina,17,23,0,0,1,7,13,0,0,9,10,0,0
6480bb9a5d25d853e1cbfe3e,2007/08,,,2,PP Chawla,WA Mota,17,7,3,0,0,15,6,3,0,1,1,0,0
6480bb9af85f41b4de44ca19,2023,,,1,MM Ali,RA Jadeja,17,8,1,1,1,9,4,0,1,6,4,1,0
6480bb9d5d93b08a19c16313,2009/10,,,2,CH Gayle,SC Ganguly,17,14,2,1,1,7,4,0,1,10,10,2,0
6480bba2bbd9d85769220a68,2015,,,2,JP Duminy,KM Jadhav,17,12,0,1,1,5,5,0,0,11,7,0,1
6480bb9553f3fc8903579544,2018,,,2,PP Chawla,TK Curran,17,21,2,0,1,11,13,1,0,6,8,1,0
6480bba0adee98d459585bed,2014,,,2,KA Pollard,MEK Hussey,17,29,1,0,1,9,15,1,0,7,14,0,0
6480bb9558c0acb502a3b1a9,2019,,,1,DA Miller,Mandeep Singh,17,15,2,0,1,10,6,2,0,6,9,0,0
6480bb9c761c43b2dfb9767d,2009,,,1,B Lee,K Goel,17,18,2,0,1,8,12,1,0,8,6,1,0
6480bb98960cf9374ee9420d,2022,,,1,KL Rahul,MP Stoinis,17,6,0,2,1,12,3,0,2,0,3,0,0
6480bb94d8ce46258c13e90e,2017,,,2,RA Tripathi,SPD Smith,17,12,1,1,1,9,6,0,1,8,6,1,0
6480bb95f37ebb69ffb216e0,2019,,,1,KD Karthik,Shubman Gill,17,12,1,1,1,13,7,1,1,4,5,0,0
6480bb9e713e850d3dd0cba9,2012,,,2,LR Shukla,MK Tiwary,17,14,1,1,1,8,8,0,1,8,6,1,0
6480bb9f022f0e8cd6e9cdeb,2012,,,1,DA Warner,UBT Chand,17,10,2,1,1,15,9,2,1,1,1,0,0
6480bb9f03dd3a09740f0bd0,2013,,,1,AM Rahane,STR Binny,17,14,3,0,1,3,3,0,0,14,11,3,0
6480bba1017a98eead1ec861,2015,,,2,GJ Maxwell,SE Marsh,17,14,3,0,1,1,6,0,0,15,8,3,0
6480bb9d86effd7e5e6a5261,2011,,,2,DL Vettori,JJ van der Wath,17,10,1,1,0,2,2,0,0,14,8,1,1
6480bb9fe8f5df13fc8d1bc3,2012,,,2,F du Plessis,MS Dhoni,17,23,1,0,1,8,10,0,0,9,13,1,0
6480bb9f2305d07e3c65be11,2013,,,1,BB Samantray,CL White,17,21,1,0,1,5,8,0,0,11,13,1,0
6480bba34d78f594b07da1bc,2016,,,2,HM Amla,M Vijay,17,10,2,1,1,1,2,0,0,16,8,2,1
6480bba1d3b4ddc36050e3f3,2014,,,1,GJ Bailey,MG Johnson,17,10,0,2,1,7,3,0,1,10,7,0,1
6480bb94bf9a1728b1b12f4d,2018,,,1,MK Pandey,Shakib Al Hasan,17,14,2,0,1,11,8,1,0,6,6,1,0
6480bb995193664eda3e9e10,2022,,,2,Ishan Kishan,KA Pollard,17,11,0,2,1,8,5,0,1,9,6,0,1
6480bb973e3a3dbbb7ae3707,2020/21,,,2,KL Rahul,MA Agarwal,17,15,1,1,1,15,11,1,1,1,4,0,0
6480bb97b945155c90dccd3d,2021,,,2,AT Rayudu,MM Ali,17,17,1,0,1,10,9,1,0,6,8,0,0
6480bb9ab34d149420eae546,2023,,,2,JJ Roy,N Rana,17,16,2,0,1,9,6,1,0,8,10,1,0
6480bb9f3700dfaa08e18c43,2012,,,2,M Vijay,MEK Hussey,17,18,3,0,1,10,14,2,0,5,4,1,0
6480bba1827557ebdfc70821,2015,,,1,GJ Bailey,NLTC Perera,17,14,0,1,1,4,6,0,0,9,8,0,1
6480bb9c761c43b2dfb9767d,2009,,,1,KC Sangakkara,Yuvraj Singh,17,22,1,0,1,6,12,0,0,6,10,1,0
6480bba0e52e9733fc6d9937,2013,,,2,DA Miller,P Kumar,17,6,1,2,1,12,3,0,2,5,3,1,0
6480bb9ea49fe0f895bf242a,2012,,,2,AL Menaria,KK Cooper,17,13,0,2,1,3,7,0,0,14,6,0,2
6480bb9ef8d4c23c6e5be4c7,2011,,,2,RA Jadeja,RV Gomez,17,23,2,0,1,8,8,1,0,7,15,1,0
6480bb9c968c81bdfcc6df5b,2009,,,2,RG Sharma,TL Suman,17,24,1,0,0,5,11,0,0,11,13,1,0
6480bb970c637fd0c057dca9,2021,,,1,JC Buttler,YBK Jaiswal,17,18,2,0,1,1,5,0,0,12,13,2,0
6480bb9c963968000dfd00d1,2009/10,,,1,JA Morkel,PA Patel,17,20,1,0,1,4,7,0,0,13,13,1,0
6480bb9cb881721acc1bab60,2009,,,1,HH Gibbs,TL Suman,17,19,0,1,1,5,9,0,0,11,10,0,1
6480bba1e64915b9e7c849ca,2014,,,2,GJ Maxwell,V Sehwag,17,9,0,2,1,9,6,0,1,7,3,0,1
6480bba27b4786f36f706f8e,2016,,,1,AT Rayudu,Harbhajan Singh,17,25,1,0,1,10,11,1,0,7,14,0,0
6480bb984a8abbb79a69e6ce,2022,,,1,JC Buttler,SV Samson,17,12,1,1,1,2,3,0,0,15,9,1,1
6480bb94adb227976b33d30b,2018,,,1,SS Iyer,V Shankar,17,3,1,2,0,16,3,1,2,0,0,0,0
6480bb9d182be5b0fbe5a4e2,2011,,,1,R Dravid,SR Watson,17,27,2,0,1,5,16,0,0,12,11,2,0
6480bb963c729ccbcb9446f8,2020/21,,,2,DA Warner,Rashid Khan,17,7,3,0,0,14,5,3,0,1,2,0,0
6480bb99b3179a9346d8883c,2022,,,1,D Padikkal,R Parag,17,8,1,1,1,6,3,1,0,9,5,0,1
6480bb980095555db76d49cb,2022,,,1,Ramandeep Singh,SA Yadav,17,19,2,0,1,6,12,0,0,11,7,2,0
6480bb9f23c17ccb47aa9e58,2013,,,2,Azhar Mahmood,PP Chawla,17,19,1,0,1,10,10,1,0,7,9,0,0
6480bba179195d83fa7fbfbb,2014,,,1,SR Watson,STR Binny,17,14,1,0,1,11,10,1,0,4,4,0,0
6480bba069c0322e91e50958,2013,,,2,G Gambhir,JH Kallis,17,16,2,0,1,5,8,0,0,10,8,2,0
6480bba120182b9ca0b70004,2014,,,2,AJ Finch,KL Rahul,17,14,3,0,1,5,5,1,0,12,9,2,0
6480bb9b2de4e62ee60b7e5c,2009,,,1,LRPL Taylor,P Kumar,17,6,0,2,1,6,2,0,1,10,4,0,1
6480bb94283e3f5a1a95839f,2018,,,1,SK Raina,SW Billings,17,13,0,1,1,14,8,0,1,3,5,0,0
6480bb9c9685addc4a78d7d0,2009/10,,,2,Mandeep Singh,SC Ganguly,17,13,3,0,1,4,7,1,0,12,6,2,0
6480bb99c6aa5989a16174d1,2023,,,1,KD Karthik,PWH de Silva,17,13,1,0,1,9,6,1,0,6,7,0,0
6480bb94988cb8c136ec7e46,2018,,,2,M Vijay,SR Watson,17,12,2,0,1,1,3,0,0,11,9,2,0
6480bb99e909d98c8193bac5,2023,,,1,SO Hetmyer,SV Samson,17,14,1,1,1,11,9,0,1,6,5,1,0
6480bba2a94dd2c01769b3ae,2016,,,1,BB McCullum,DR Smith,17,17,3,0,1,1,4,0,0,15,13,3,0
6480bba287d112bccc55ccd2,2015,,,1,DA Miller,GJ Bailey,17,6,0,2,1,14,4,0,2,2,2,0,0
6480bba1670ace74604a420f,2015,,,2,JA Morkel,NM Coulter-Nile,17,12,2,0,1,11,8,1,0,5,4,1,0
6480bb99c6aa5989a16174d1,2023,,,1,GJ Maxwell,MK Lomror,17,10,2,0,1,12,8,1,0,5,2,1,0
6480bba04b49d2ff5f997e02,2013,,,2,DA Warner,DPMD Jayawardene,17,13,2,0,1,2,5,0,0,9,8,2,0
6480bba1ebb63d1bd8c60b9d,2014,,,2,JDS Neesham,S Nadeem,17,20,1,0,1,10,14,1,0,2,6,0,0
6480bb98bd3ca4df44cf9d8f,2022,,,2,AR Patel,Kuldeep Yadav,17,11,3,0,0,7,4,1,0,10,7,2,0
6480bba24f6e6e2c212c7469,2016,,,2,CH Morris,SV Samson,17,11,2,0,1,11,9,2,0,1,2,0,0
6480bb963c729ccbcb9446f8,2020/21,,,1,AD Russell,EJG Morgan,17,18,2,0,1,9,11,1,0,6,7,1,0
6480bba0a9f68a29bda72302,2013,,,1,G Gambhir,MS Bisla,17,10,0,0,1,4,6,0,0,1,4,0,0
6480bb939b2499e9af6ee18c,2017,,,1,HH Pandya,RG Sharma,17,8,2,0,0,6,3,1,0,10,5,1,0
6480bba071a7a0cbb02d505a,2013,,,1,AB Agarkar,IK Pathan,17,16,1,0,0,9,9,0,0,7,7,1,0
6480bba1670ace74604a420f,2015,,,1,MS Dhoni,RA Jadeja,17,18,1,0,1,13,11,1,0,4,7,0,0
6480bb9bdde9db92f880e40d,2007/08,,,1,DJ Hussey,SC Ganguly,17,19,2,0,1,12,11,2,0,5,8,0,0
6480bb9fc3369c6f5a549d05,2013,,,1,DPMD Jayawardene,V Sehwag,17,18,2,0,1,6,11,1,0,9,7,1,0
6480bb9b283b30d0503656f7,2007/08,,,2,DB Ravi Teja,Y Venugopal Rao,17,5,1,2,1,1,1,0,0,16,4,1,2
6480bb980d1be75574871dcc,2022,,,2,B Sai Sudharsan,DA Miller,17,15,2,0,1,8,6,1,0,9,9,1,0
6480bb958e752648ab95362b,2019,,,2,F du Plessis,SK Raina,17,16,1,1,1,2,3,0,0,14,13,1,1
6480bb980d1be75574871dcc,2022,,,2,B Sai Sudharsan,Shubman Gill,17,9,1,1,1,5,4,0,0,11,5,1,1
6480bb93d9581d69657887c3,2017,,,2,SV Samson,SW Billings,17,12,0,1,1,7,6,0,0,10,6,0,1
6480bb99af95c6c90c4c3924,2023,,,2,Abdul Samad,M Jansen,17,11,3,0,1,2,5,0,0,13,6,3,0
6480bba23ed328dbb847b4e7,2016,,,1,AB de Villiers,V Kohli,17,15,2,0,1,4,6,0,0,13,9,2,0
6480bb976caaa0cc91f652c7,2021,,,1,Ishan Kishan,Q de Kock,17,17,1,0,1,7,8,0,0,8,9,1,0
6480bb9d362f72789dcdc5a7,2009/10,,,1,R Ashwin,S Badrinath,17,25,0,0,1,6,13,0,0,11,12,0,0
6480bb97c92184fed1a879f3,2021,,,1,JO Holder,WP Saha,17,13,2,0,1,7,5,1,0,10,8,1,0
6480bba069c0322e91e50958,2013,,,2,EJG Morgan,JH Kallis,17,21,1,0,1,9,9,1,0,8,12,0,0
6480bb9516b0dbc1972e5c3c,2018,,,2,H Klaasen,SV Samson,17,16,2,0,1,9,9,1,0,8,7,1,0
6480bb99c6aa5989a16174d1,2023,,,2,SO Hetmyer,SV Samson,17,10,2,1,1,1,4,0,0,15,6,2,1
6480bb9f4bdcea2f81049fe9,2012,,,1,DA Warner,DPMD Jayawardene,17,14,3,0,1,3,7,0,0,14,7,3,0
6480bb98b8bb5b0d2c2f0848,2022,,,2,DJ Bravo,MS Dhoni,17,5,2,1,0,1,1,0,0,16,4,2,1
6480bb973e451a92813d78cc,2020/21,,,1,Mohammad Nabi,WP Saha,17,10,3,0,1,11,7,2,0,4,3,1,0
6480bba2b5d601f8354f5b5a,2016,,,2,MG Johnson,MM Sharma,17,12,1,1,1,0,4,0,0,15,8,1,1
6480bb94bf9a1728b1b12f4d,2018,,,1,AD Hales,S Dhawan,17,13,3,0,1,11,9,2,0,6,4,1,0
6480bb9a3ffea6235f54cc1e,2023,,,1,AS Roy,RK Singh,17,11,2,0,1,12,5,2,0,5,6,0,0
6480bb9a807eb5f39489408a,2023,,,1,AM Rahane,RD Gaikwad,17,12,3,0,1,10,6,2,0,7,6,1,0
6480bb993e44f97eccb361fe,2023,,,2,MW Short,P Simran Singh,17,11,4,0,1,13,7,3,0,4,4,1,0
6480bb989bf19eb260a04f0e,2022,,,1,AD Russell,UT Yadav,17,5,1,2,0,16,4,1,2,1,1,0,0
6480bb9b4b74852492343291,2007/08,,,1,B Akhil,Misbah-ul-Haq,17,10,1,1,1,3,3,0,0,14,7,1,1
6480bb98bd3ca4df44cf9d8f,2022,,,1,GJ Maxwell,Shahbaz Ahmed,17,11,2,0,1,7,8,1,0,5,3,1,0
6480bb94640655c49683aee1,2018,,,1,KA Pollard,KH Pandya,17,15,1,1,1,10,9,0,1,7,6,1,0
6480bb96edb3270eba0af1d4,2020/21,,,2,AT Rayudu,MS Dhoni,17,10,1,1,1,6,4,1,0,10,6,0,1
6480bb95a8153d4daac6e4f7,2019,,,2,AT Rayudu,SK Raina,17,22,1,0,1,5,11,0,0,11,11,1,0
6480bb99864a94e086c8395e,2022,,,2,T Stubbs,TH David,17,10,2,0,1,2,2,0,0,15,8,2,0
6480bb9cba868c69775db687,2009,,,1,JH Kallis,MK Pandey,17,10,4,0,1,9,7,2,0,8,3,2,0
6480bb995193664eda3e9e10,2022,,,1,RK Singh,SP Jackson,17,14,2,0,1,12,7,2,0,5,7,0,0
6480bb93ec7e3351941d3b5b,2017,,,1,BCJ Cutting,DJ Hooda,17,8,0,2,0,16,6,0,2,1,2,0,0
6480bba154ce29a67e4752df,2015,,,2,HH Pandya,Harbhajan Singh,17,7,0,2,1,16,6,0,2,0,1,0,0
6480bb99349f00f851e8d2fd,2023,,,1,Atharva Taide,LS Livingstone,17,15,1,1,1,5,3,1,0,10,12,0,1
6480bb9ec07aa72ec89917f0,2012,,,2,S Badrinath,SK Raina,17,20,1,1,1,6,11,1,0,8,9,0,1
6480bb948211fe47e65f2e77,2018,,,1,KS Williamson,YK Pathan,17,16,2,0,1,12,11,2,0,1,5,0,0
6480bba0c63a6317296391b7,2013,,,2,AM Rahane,JP Faulkner,17,17,2,0,1,4,4,0,0,12,13,2,0
6480bb9ba6cd609c32579bde,2009,,,2,AM Nayar,JP Duminy,17,23,1,0,1,9,11,1,0,7,12,0,0
6480bb9ee0795047740de5a7,2011,,,2,JA Morkel,MS Dhoni,17,9,0,1,0,5,4,0,0,10,5,0,1
6480bb95c701f5c8388f7f88,2018,,,1,AJ Finch,AR Patel,17,18,0,1,1,11,11,0,1,4,7,0,0
6480bb9439fcd1191cf17a90,2017,,,2,AR Patel,WP Saha,17,5,1,2,1,17,5,1,2,0,0,0,0
6480bb9b166300b6298fc71a,2009,,,1,PP Chawla,Yuvraj Singh,17,13,1,1,1,6,7,1,0,9,6,0,1
6480bba2bae80e615447f251,2015,,,1,MS Dhoni,P Negi,17,8,0,2,1,10,6,0,1,7,2,0,1
6480bb93575636076d81e4c5,2017,,,2,KC Cariappa,M Vohra,17,11,1,1,1,1,5,0,0,16,6,1,1
6480bb9c37b72d7a51019794,2009/10,,,1,RG Sharma,RP Singh,17,11,1,1,1,13,6,1,1,3,5,0,0
6480bb96e61ac20a6e10582e,2019,,,2,Q de Kock,SA Yadav,17,18,3,0,1,8,12,2,0,6,6,1,0
6480bb9802d8f5ec4413766d,2022,,,1,HH Pandya,MS Wade,17,14,3,0,1,15,11,3,0,2,3,0,0
6480bb9f5867d07199aa832a,2013,,,1,M Vijay,S Badrinath,17,14,1,1,1,10,8,0,1,7,6,1,0
6480bb9c17dcdfd5b06984f0,2009/10,,,1,DA Warner,KD Karthik,17,6,2,1,1,15,5,2,1,0,1,0,0
6480bb94ee669473878c11c2,2017,,,1,RV Uthappa,SP Narine,17,12,3,0,1,11,6,2,0,6,6,1,0
6480bb96b56e8d513b451da1,2020/21,,,1,EJG Morgan,Kuldeep Yadav,17,19,2,0,1,13,10,2,0,4,9,0,0
6480bb9ab655ac367694708c,2007/08,,,2,T Kohli,YK Pathan,17,15,2,1,1,7,12,0,1,9,3,2,0
6480bba22daffa649f339a05,2016,,,1,DJ Bravo,RA Jadeja,17,12,0,1,0,9,4,0,1,4,8,0,0
6480bba0dcd1149b9b0b501f,2013,,,1,AD Mathews,M Rawat,17,13,0,2,1,15,7,0,2,2,6,0,0
6480bba3412663673a969a24,2016,,,2,R Ashwin,R Bhatia,17,7,0,2,0,10,5,0,1,7,2,0,1
6480bb94c5d20726ee59d3d6,2017,,,1,P Negi,TM Head,17,8,1,1,1,5,3,1,0,11,5,0,1
6480bb947a7c9fe868fc901a,2017,,,2,P Negi,SR Watson,17,7,3,0,0,13,5,3,0,1,2,0,0
6480bb964c4bea88164f168d,2020/21,,,1,AD Russell,KD Karthik,17,12,0,2,1,16,9,0,2,1,3,0,0
6480bb95960e393c939ab44c,2018,,,2,E Lewis,KA Pollard,17,17,0,1,1,10,11,0,1,7,6,0,0
6480bb94c008939d7976abfe,2018,,,1,AM Rahane,BA Stokes,17,17,1,1,1,1,5,0,0,16,12,1,1
6480bb957e6d387fe3a6b26e,2018,,,2,AB de Villiers,Mandeep Singh,17,17,0,1,1,4,3,0,0,13,14,0,1
6480bb9fd26b695cee9d8761,2013,,,1,AD Mathews,Yuvraj Singh,17,10,2,1,0,1,1,0,0,16,9,2,1
6480bb9f00ef088221497043,2013,,,2,MEK Hussey,S Badrinath,17,24,0,0,1,9,11,0,0,6,13,0,0
6480bba2679194b06d4834db,2016,,,2,AT Rayudu,JC Buttler,17,21,1,0,1,5,10,0,0,11,11,1,0
6480bb9e300070746cc2eb67,2011,,,2,J Syed Mohammad,SS Tiwary,17,8,0,2,0,2,2,0,0,14,6,0,2
6480bba069d61566bb63ac2b,2014,,,2,JH Kallis,RV Uthappa,17,21,0,0,1,5,8,0,0,12,13,0,0
6480bb99315aee6cd9d56504,2023,,,2,A Badoni,JD Unadkat,17,10,2,0,1,8,6,1,0,7,4,1,0
6480bba0f1ebf9ff255e1c91,2013,,,2,DW Steyn,I Sharma,17,6,2,1,0,16,6,2,1,0,0,0,0
6480bb99fe078839da40e7ab,2023,,,2,AR Patel,MK Pandey,17,16,2,0,1,7,9,1,0,8,7,1,0
6480bba2c3207713bd927ce5,2015,,,1,DA Warner,NV Ojha,17,11,2,0,1,14,8,2,0,2,3,0,0
6480bba1a6882d256a926a8b,2014,,,2,KM Jadhav,MK Tiwary,17,14,2,0,1,3,3,0,0,14,11,2,0
6480bb9e713e850d3dd0cba9,2012,,,1,AL Menaria,SP Goswami,17,12,0,1,1,10,6,0,1,6,6,0,0
6480bb9b9dd7fe8c5cbdbab0,2009,,,1,A Flintoff,JA Morkel,17,11,2,0,1,9,7,1,0,7,4,1,0
6480bb99b3179a9346d8883c,2022,,,2,DA Warner,RR Pant,17,6,0,2,0,4,2,0,0,13,4,0,2
6480bb9ae4498012aa089436,2023,,,2,JJ Roy,VR Iyer,17,11,3,0,1,7,7,1,0,9,4,2,0
6480bb9bca2c11520f5b3b9e,2007/08,,,2,SE Marsh,Yuvraj Singh,17,14,1,1,1,12,6,1,1,4,8,0,0
6480bb964752e7c0f9e39d3c,2020/21,,,2,Q de Kock,SA Yadav,17,18,1,0,1,7,8,0,0,10,10,1,0
6480bb9c5d0fccb6a3a6d37d,2009,,,2,RA Jadeja,YK Pathan,17,11,1,2,1,11,5,1,1,6,6,0,1
6480bb9746dfc5c467942a84,2021,,,2,Anmolpreet Singh,SA Yadav,17,16,2,1,1,15,12,2,1,2,4,0,0
6480bba1ff55936e203ca5a6,2014,,,1,Mandeep Singh,V Sehwag,17,9,4,0,1,0,3,0,0,16,6,4,0
6480bb99fe078839da40e7ab,2023,,,2,AR Patel,Lalit Yadav,17,19,0,0,0,11,12,0,0,4,7,0,0
6480bb942efd740a6ffc47df,2017,,,2,AB de Villiers,KM Jadhav,17,11,1,1,1,10,6,0,1,7,5,1,0
6480bb97aabcd4374e076d04,2021,,,1,B Kumar,Rashid Khan,17,10,2,0,0,2,2,0,0,14,8,2,0
6480bba1b8e3071cc513602a,2014,,,2,IK Pathan,MC Henriques,17,20,1,0,1,8,10,0,0,6,10,1,0
6480bb9e713e850d3dd0cba9,2012,,,2,DB Das,MK Tiwary,17,21,0,1,1,12,14,0,1,4,7,0,0
6480bb948a69b3d86293b12b,2017,,,2,CR Brathwaite,SS Iyer,17,13,3,0,1,11,10,2,0,5,3,1,0
6480bb9718a9b89de407178b,2021,,,1,CH Gayle,DJ Hooda,17,7,0,2,1,6,3,0,1,10,4,0,1
6480bb96e2809aa0bc35c7e9,2019,,,2,MJ Guptill,MK Pandey,17,7,2,1,1,1,2,0,0,16,5,2,1
6480bb9618b5973b98c0ba18,2019,,,2,AB de Villiers,V Kohli,17,8,2,1,1,1,1,0,0,16,7,2,1
6480bb9d69cb9046a72d8fbe,2009/10,,,2,A Symonds,HH Gibbs,17,21,1,0,1,7,10,0,0,10,11,1,0
6480bb9f36ad55c3c7fd6548,2012,,,1,AT Rayudu,RG Sharma,17,16,0,1,1,11,8,0,1,6,8,0,0
6480bb9cff4ec2f71cdf18d1,2009/10,,,2,PP Chawla,VS Malik,17,10,2,0,1,7,5,1,0,6,5,1,0
6480bba23ed328dbb847b4e7,2016,,,1,SR Watson,STR Binny,17,5,1,2,1,1,1,0,0,16,4,1,2
6480bb99537b54b870dc74d1,2023,,,2,HH Pandya,Shubman Gill,17,18,1,0,1,8,11,1,0,5,7,0,0
6480bb9ed74d222a3da56dfa,2012,,,1,R Vinay Kumar,Z Khan,17,12,1,0,1,4,5,0,0,11,7,1,0
6480bb993e44f97eccb361fe,2023,,,2,M Shahrukh Khan,Sikandar Raza,17,12,1,1,1,8,5,0,1,7,7,1,0
6480bb9edd901481f13ce9ba,2012,,,2,CH Gayle,SS Tiwary,17,19,2,0,1,12,12,2,0,4,7,0,0
6480bb97ea8bfb43e3f7515f,2020/21,,,2,MS Dhoni,RA Jadeja,17,13,1,0,1,3,5,0,0,12,8,1,0
6480bb97c92184fed1a879f3,2021,,,2,AB de Villiers,D Padikkal,17,16,1,0,1,7,6,0,0,10,10,1,0
6480bb9553f3fc8903579544,2018,,,2,N Rana,RV Uthappa,17,16,2,1,1,10,10,2,0,7,6,0,1
6480bb981b01a21305fd65d5,2022,,,1,Shubman Gill,WP Saha,17,13,4,0,1,9,6,2,0,8,7,2,0
6480bb9b5d0191a0a2611916,2009,,,1,KC Sangakkara,Yuvraj Singh,17,12,2,0,1,10,9,2,0,2,3,0,0
6480bb952f20835ddd6e533f,2019,,,1,Mandeep Singh,SN Khan,17,5,1,1,0,5,2,0,0,11,3,1,1
6480bb9c89f35f11aae1f2d0,2009/10,,,2,P Dogra,SW Tait,17,17,0,1,1,7,8,0,0,10,9,0,1
6480bb9cafc843037dc1e863,2009,,,1,MV Boucher,RE van der Merwe,17,8,0,1,1,9,4,0,1,3,4,0,0
6480bb9ba6cd609c32579bde,2009,,,2,JP Duminy,Z Khan,17,7,0,2,0,15,5,0,2,2,2,0,0
6480bb95b84f125c6212267a,2019,,,2,C de Grandhomme,UT Yadav,17,14,1,1,1,2,5,0,0,14,9,1,1
6480bb997d1393ca85856ec2,2022,,,1,MS Wade,WP Saha,17,17,2,1,1,16,13,2,1,1,4,0,0
6480bb9bbb0ec0266749f518,2007/08,,,1,JH Kallis,V Kohli,17,11,1,1,1,6,5,1,0,10,6,0,1
6480bb9e4bb50b724830b249,2011,,,1,R Bhatia,RN ten Doeschate,17,11,1,1,1,3,3,0,0,14,8,1,1
6480bb95b84f125c6212267a,2019,,,1,DA Warner,V Shankar,17,7,0,2,1,8,4,0,1,9,3,0,1
6480bb9c12f907c7b81b11a9,2009,,,2,NK Patel,YK Pathan,17,23,1,0,1,8,15,0,0,8,8,1,0
6480bb9a9dc58f49d783faa9,2023,,,1,GJ Maxwell,MG Bracewell,17,12,1,1,1,13,7,1,1,4,5,0,0
6480bb9a3d3f26063faa9f71,2007/08,,,2,J Arunkumar,S Chanderpaul,17,21,3,0,1,9,10,2,0,7,11,1,0
6480bb9c37b72d7a51019794,2009/10,,,1,AA Bilakhia,RG Sharma,17,10,3,0,1,2,4,0,0,15,6,3,0
6480bb9c89f35f11aae1f2d0,2009/10,,,1,G Gambhir,KM Jadhav,17,17,1,0,1,6,8,0,0,10,9,1,0
6480bb9c71030f4c6f018f55,2009,,,2,IK Pathan,KC Sangakkara,17,11,2,0,1,8,5,1,0,9,6,1,0
6480bb9ef18c54e7aafdd223,2012,,,1,G Gambhir,MS Bisla,17,10,2,1,1,10,6,2,0,7,4,0,1
6480bb9ab655ac367694708c,2007/08,,,2,D Salunkhe,SK Warne,17,17,2,0,1,3,4,0,0,14,13,2,0
6480bb9db0ecec8acdd30619,2011,,,1,CH Gayle,V Kohli,17,14,2,0,1,7,5,1,0,9,9,1,0
6480bb9fcb2b412c0ebd4afa,2013,,,1,GH Vihari,NLTC Perera,17,13,1,0,1,5,5,0,0,7,8,1,0
6480bb967d799ced7fe5d8e9,2020/21,,,1,CJ Jordan,N Pooran,17,19,0,0,1,7,12,0,0,8,7,0,0
6480bb9e56c724ba25b94666,2011,,,2,A Symonds,AT Rayudu,17,20,2,0,1,8,5,1,0,8,15,1,0
6480bb953aab41e7ed166b9d,2019,,,2,MJ McClenaghan,Yuvraj Singh,17,11,3,0,1,9,5,2,0,6,6,1,0
6480bb9d80536875f41bc605,2011,,,1,GC Smith,MK Pandey,17,21,3,0,1,6,12,1,0,11,9,2,0
6480bb95b98d000799e11963,2018,,,2,AD Hales,KS Williamson,17,17,2,0,1,8,8,1,0,9,9,1,0
6480bb96c0ffb76dab723a2b,2019,,,1,KMA Paul,RR Pant,17,12,1,1,1,3,7,0,0,13,5,1,1
6480bb94988cb8c136ec7e46,2018,,,2,AT Rayudu,SW Billings,17,15,2,0,1,8,7,1,0,9,8,1,0
6480bb948f3284f793b2763c,2018,,,2,SN Khan,V Kohli,17,14,1,1,1,5,6,1,0,12,8,0,1
6480bb9dec749d630afd07d1,2011,,,1,DT Christian,JP Duminy,17,14,1,0,1,7,6,0,0,9,8,1,0
6480bb938ed49c6d5c211429,2017,,,2,BCJ Cutting,NV Ojha,17,14,0,1,1,9,6,0,1,7,8,0,0
6480bb94b9d954a885cc531b,2017,,,2,AM Rahane,RA Tripathi,17,14,1,0,1,10,6,1,0,3,8,0,0
6480bb9f5867d07199aa832a,2013,,,2,LRPL Taylor,SPD Smith,17,12,2,0,1,5,6,0,0,11,6,2,0
6480bb9996eb97dd08b62f78,2023,,,2,MW Short,P Simran Singh,16,11,2,1,1,8,7,0,1,8,4,2,0
6480bb96f8379d02d3435ceb,2020/21,,,1,EJG Morgan,RA Tripathi,16,18,1,0,1,7,10,1,0,6,8,0,0
6480bb9553f3fc8903579544,2018,,,1,RG Sharma,SA Yadav,16,20,1,0,1,6,9,0,0,8,11,1,0
6480bb9e56c724ba25b94666,2011,,,1,KD Karthik,Mandeep Singh,16,9,0,2,1,8,4,0,1,8,5,0,1
6480bba280f09c38002cf14b,2015,,,1,GB Hogg,PP Chawla,16,12,2,0,1,5,5,0,0,11,7,2,0
6480bba2ebdcfb98389cee5a,2015,,,2,BB McCullum,DR Smith,16,36,2,0,1,11,21,1,0,5,15,1,0
6480bb990942cd416cf5f447,2022,,,1,MS Wade,Shubman Gill,16,10,3,0,1,10,7,2,0,6,3,1,0
6480bba1d9f266a28a109f29,2015,,,1,DA Miller,GJ Maxwell,16,6,0,2,1,1,1,0,0,15,5,0,2
6480bb9a51ee1ef33a5b2dbb,2007/08,,,1,DPMD Jayawardene,SE Marsh,16,15,0,1,1,10,5,0,1,6,10,0,0
6480bb975ea60ce128803d60,2021,,,2,N Rana,RA Tripathi,16,13,3,0,1,8,9,2,0,6,4,1,0
6480bb96c0ffb76dab723a2b,2019,,,1,C Munro,S Dhawan,16,17,2,0,1,13,12,2,0,3,5,0,0
6480bb99e909d98c8193bac5,2023,,,1,R Ashwin,SO Hetmyer,16,9,1,0,0,1,2,0,0,11,7,1,0
6480bb9e565ef5f11c5c8f55,2011,,,2,AB de Villiers,KB Arun Karthik,16,10,1,0,1,6,4,0,0,6,6,1,0
6480bb9c07d77f83fb139c41,2009,,,1,RG Sharma,TL Suman,16,17,1,1,1,8,11,1,0,8,6,0,1
6480bba0f858e6c12b25d8c3,2014,,,2,DA Miller,V Sehwag,16,12,2,0,1,14,10,2,0,2,2,0,0
6480bb9f2305d07e3c65be11,2013,,,2,DJ Hussey,Gurkeerat Singh,16,14,0,1,1,5,7,0,0,11,7,0,1
6480bba2fbc243afec641844,2015,,,1,M Vohra,WP Saha,16,14,1,1,1,1,2,0,0,15,12,1,1
6480bb980ea7c3bcea4fdf9c,2022,,,2,Arshdeep Singh,R Dhawan,16,12,2,1,0,0,2,0,0,15,10,2,1
6480bb9765a785922ad360fe,2021,,,1,Abdul Samad,JO Holder,16,14,0,1,1,5,5,0,0,10,9,0,1
6480bba1017a98eead1ec861,2015,,,1,STR Binny,SV Samson,16,5,2,1,0,11,3,1,1,5,2,1,0
6480bb990942cd416cf5f447,2022,,,2,A Badoni,DJ Hooda,16,20,1,0,1,8,11,1,0,7,9,0,0
6480bba388682c5ca10ff37a,2016,,,1,STR Binny,Sachin Baby,16,10,1,1,1,9,7,0,1,6,3,1,0
6480bb9c757dbd7f92b1130a,2009/10,,,2,AT Rayudu,SR Tendulkar,16,16,1,0,1,6,7,0,0,9,9,1,0
6480bb9aa64355ce98da1141,2007/08,,,2,SE Marsh,Yuvraj Singh,16,11,3,0,1,15,7,3,0,1,4,0,0
6480bb98291bb8b3f3e8145d,2022,,,2,AD Russell,SW Billings,16,11,1,1,1,1,2,0,0,15,9,1,1
6480bb941ab79050c3c90ee5,2018,,,2,MS Dhoni,SK Raina,16,18,0,1,1,6,12,0,0,10,6,0,1
6480bb98bc3569cc8d04101a,2022,,,2,AM Rahane,VR Iyer,16,25,1,0,1,7,11,0,0,9,14,1,0
6480bb9ea75f51e7a33e90ed,2012,,,1,RA Jadeja,WP Saha,16,14,1,0,1,9,7,1,0,4,7,0,0
6480bb9c3b082d71291a593c,2009,,,2,ML Hayden,SK Raina,16,13,3,0,1,3,3,0,0,13,10,3,0
6480bba08cc4182f0127f2e2,2013,,,1,AT Rayudu,RG Sharma,16,20,1,0,1,10,11,1,0,6,9,0,0
6480bba2557febf92f9f79ab,2015,,,2,GB Hogg,RN ten Doeschate,16,7,2,1,0,2,1,0,0,14,6,2,1
6480bb94f27c8167d1685878,2017,,,2,PJ Sangwan,RA Jadeja,16,5,0,2,0,1,1,0,0,15,4,0,2
6480bb9a6a7169d0e413bcfa,2023,,,2,MP Stoinis,Q de Kock,16,15,0,1,1,4,9,0,0,11,6,0,1
6480bb9f6b144f2a6d105b32,2013,,,1,DJ Bravo,S Badrinath,16,16,1,0,1,5,9,0,0,11,7,1,0
6480bba090c88df75eba18e6,2014,,,2,MA Starc,R Rampaul,16,21,1,0,1,11,11,1,0,5,10,0,0
6480bb95f282ca61c07afe9b,2018,,,2,AT Rayudu,DR Shorey,16,15,1,1,1,7,8,1,0,8,7,0,1
6480bb9bb7a4f1e16df25c8e,2009,,,2,DR Smith,HH Gibbs,16,10,1,1,1,12,5,1,1,4,5,0,0
6480bb9f6b144f2a6d105b32,2013,,,2,AT Rayudu,KA Pollard,16,13,2,0,1,3,6,0,0,11,7,2,0
6480bb9b82dc3ec84c520466,2009,,,2,CH Gayle,MN van Wyk,16,17,1,0,1,10,10,1,0,6,7,0,0
6480bb951354c40599b60208,2018,,,2,F du Plessis,SR Watson,16,24,2,0,1,10,11,1,0,5,13,1,0
6480bb9fe8f5df13fc8d1bc3,2012,,,1,MK Tiwary,YK Pathan,16,14,0,1,1,5,6,0,0,11,8,0,1
6480bba0eb5a345386bdc825,2013,,,2,R Dravid,SR Watson,16,13,3,0,1,10,5,2,0,6,8,1,0
6480bb99fa79383bdc7df827,2022,,,2,KD Karthik,Shahbaz Ahmed,16,21,1,0,1,11,11,1,0,5,10,0,0
6480bba0dcd1149b9b0b501f,2013,,,1,RV Uthappa,UA Birla,16,23,1,0,1,6,9,0,0,7,14,1,0
6480bb9dfb2e8e8c2002df86,2011,,,1,DB Ravi Teja,DW Steyn,16,10,1,1,1,13,6,1,1,3,4,0,0
6480bb9404b444be6724e41e,2017,,,1,KK Nair,PJ Cummins,16,9,0,1,1,4,3,0,0,11,6,0,1
6480bb9429a15517bb46f3be,2018,,,2,GJ Maxwell,JJ Roy,16,9,1,1,1,13,6,1,1,3,3,0,0
6480bb9df60a79ae5f20b748,2011,,,1,AJ Finch,V Sehwag,16,18,3,0,1,6,7,1,0,9,11,2,0
6480bb9a325c576efe386437,2023,,,2,AR Patel,RR Rossouw,16,7,0,2,0,8,3,0,1,8,4,0,1
6480bb94ebff9a116f68560b,2018,,,1,CA Lynn,RV Uthappa,16,16,3,0,1,13,8,3,0,3,8,0,0
6480bb97a42828c5a5ebef1c,2020/21,,,1,Q de Kock,RG Sharma,16,9,3,0,1,16,8,3,0,0,1,0,0
6480bb96686655f09172741d,2020/21,,,2,AB de Villiers,V Kohli,16,11,3,0,1,9,6,2,0,7,5,1,0
6480bb9525c593ee45bb038c,2019,,,1,HH Pandya,KH Pandya,16,8,2,0,1,4,3,0,0,10,5,2,0
6480bb9f00ef088221497043,2013,,,1,SMSM Senanayake,SP Narine,16,10,0,2,1,3,4,0,0,13,6,0,2
6480bb9871b0ff7264721cbc,2022,,,2,Kartik Tyagi,S Gopal,16,8,3,0,1,7,5,1,0,9,3,2,0
6480bb9cdf6c63fec90a42df,2009/10,,,2,M Vijay,ML Hayden,16,19,3,0,1,15,11,3,0,1,8,0,0
6480bb99537b54b870dc74d1,2023,,,1,Harpreet Brar,M Shahrukh Khan,16,9,1,1,1,8,4,0,1,7,5,1,0
6480bb988b447f26d7a96c0c,2022,,,2,Ishan Kishan,RG Sharma,16,16,3,0,1,9,9,2,0,6,7,1,0
6480bba17bce347084729c56,2015,,,2,GJ Bailey,R Dhawan,16,10,1,1,1,9,4,0,1,6,6,1,0
6480bb9c2f07203e8e510386,2009/10,,,1,PP Chawla,S Sreesanth,16,15,1,0,1,5,6,0,0,6,9,1,0
6480bb9b3a5e1af467fb027b,2009,,,1,R Dravid,V Kohli,16,18,0,1,1,4,5,0,0,11,13,0,1
6480bb9c37b72d7a51019794,2009/10,,,2,MJ Lumb,NV Ojha,16,13,2,1,1,15,10,2,1,1,3,0,0
6480bb953b102c650968cba2,2019,,,1,PA Patel,V Kohli,16,22,1,0,1,8,10,1,0,6,12,0,0
6480bb9d8f5769d3a514fd88,2009/10,,,1,LRPL Taylor,R Vinay Kumar,16,18,0,0,1,6,10,0,0,8,8,0,0
6480bba1827557ebdfc70821,2015,,,2,G Gambhir,RV Uthappa,16,14,2,0,1,2,4,0,0,13,10,2,0
6480bb9c9e328ac30bcaf6b0,2009/10,,,2,SR Tendulkar,SS Tiwary,16,18,1,0,0,10,9,1,0,4,9,0,0
6480bb94ebff9a116f68560b,2018,,,1,KD Karthik,Shubman Gill,16,20,1,0,1,12,11,1,0,3,9,0,0
6480bb94cf431881ac3e9cbf,2018,,,1,JJ Roy,SS Iyer,16,20,2,0,1,2,12,0,0,12,8,2,0
6480bb939c56810fd88e895b,2017,,,2,AB de Villiers,Vishnu Vinod,16,15,2,1,1,10,5,1,1,6,10,1,0
6480bb973da000031d26fbba,2021,,,2,Q de Kock,RG Sharma,16,21,1,0,1,7,11,0,0,8,10,1,0
6480bb9f60d58ee39ba047b9,2013,,,1,KM Jadhav,UT Yadav,16,10,1,1,0,9,5,0,1,6,5,1,0
6480bb93575636076d81e4c5,2017,,,2,GJ Maxwell,M Vohra,16,16,3,0,1,10,12,2,0,6,4,1,0
6480bb9b17739118ee6c3bd0,2007/08,,,2,GC Smith,SA Asnodkar,16,12,3,0,1,11,9,2,0,5,3,1,0
6480bba031c5cf0145ae8cfe,2014,,,1,STR Binny,SV Samson,16,14,0,1,1,12,8,0,1,4,6,0,0
6480bb9d86effd7e5e6a5261,2011,,,2,AUK Pathan,MA Agarwal,16,6,2,1,1,14,5,2,1,1,1,0,0
6480bba2b7be71a15b2bb3de,2015,,,2,MS Dhoni,P Negi,16,9,1,1,1,13,7,1,1,2,2,0,0
6480bb9a9514379c05d59c38,2023,,,1,SO Hetmyer,YBK Jaiswal,16,13,0,2,1,8,9,0,1,8,4,0,1
6480bb97af05ebd5c4f575c4,2021,,,1,Ishan Kishan,KA Pollard,16,18,0,1,1,4,7,0,0,10,11,0,1
6480bb95430629e254bbc4fd,2018,,,2,AD Russell,KD Karthik,16,19,1,0,1,9,10,1,0,7,9,0,0
6480bb9f4780a208e13bfb3d,2013,,,2,AM Rahane,R Dravid,16,18,2,1,1,10,8,1,1,6,10,1,0
6480bb9da398a7c3c645732c,2011,,,1,AL Menaria,J Botha,16,18,0,1,1,10,10,0,1,4,8,0,0
6480bb9908b154f78b12b8fb,2023,,,1,AD Russell,RK Singh,16,8,2,1,1,0,1,0,0,16,7,2,1
6480bb9e21655ee16a96b2c3,2012,,,1,M Muralitharan,S Aravind,16,15,2,0,1,6,8,0,0,10,7,2,0
6480bb982f070b023b901b3e,2021,,,2,SO Hetmyer,SS Iyer,16,9,2,0,1,15,8,2,0,1,1,0,0
6480bb9737b1d7284b5297c1,2021,,,2,AB de Villiers,DT Christian,16,9,1,1,1,15,6,1,1,1,3,0,0
6480bb9b52b93b56f5a16e52,2007/08,,,2,RA Jadeja,YK Pathan,16,10,0,2,1,7,5,0,1,9,5,0,1
6480bb9fcb2b412c0ebd4afa,2013,,,1,CL White,PA Reddy,16,14,2,0,1,5,9,1,0,8,5,1,0
6480bb954817ed0a4ba25bc2,2018,,,1,HH Pandya,KA Pollard,16,7,2,1,1,2,3,0,0,14,4,2,1
6480bb958f737f809dfb65e1,2019,,,1,RR Pant,SS Iyer,16,19,1,0,1,5,7,0,0,11,12,1,0
6480bb945f95e767a8a9cc10,2017,,,2,BB McCullum,SK Raina,16,12,1,0,1,7,4,1,0,8,8,0,0
6480bb9ddfb0f2f6f8e813e5,2011,,,1,B Akhil,RA Jadeja,16,13,0,1,1,13,9,0,1,3,4,0,0
6480bb9435048f20502ba1e1,2018,,,2,JP Duminy,SA Yadav,16,13,3,0,1,9,9,2,0,4,4,1,0
6480bb945460b25d997060fb,2018,,,2,GJ Maxwell,V Shankar,16,8,0,2,1,15,6,0,2,1,2,0,0
6480bb9a3d3f26063faa9f71,2007/08,,,1,LR Shukla,T Taibu,16,14,2,0,1,3,6,0,0,12,8,2,0
6480bb9e83b8575f74b8e962,2012,,,1,DJ Bravo,RA Jadeja,16,5,2,1,0,11,4,1,1,4,1,1,0
6480bb99ecbdaaf953b8eee5,2023,,,1,BA Stokes,MM Ali,16,9,3,0,1,2,4,0,0,13,5,3,0
6480bba23b270561e8026bd2,2015,,,1,EJG Morgan,MC Henriques,16,26,1,0,1,9,14,1,0,5,12,0,0
6480bb987b6845947f7ca137,2022,,,2,AJ Finch,B Indrajith,16,19,1,0,1,4,7,0,0,10,12,1,0
6480bb9871b0ff7264721cbc,2022,,,2,KS Williamson,RA Tripathi,16,17,1,1,1,4,8,1,0,11,9,0,1
6480bb9dbefe5e2cceb23e01,2011,,,2,DE Bollinger,S Badrinath,16,7,1,1,0,0,1,0,0,16,6,1,1
6480bb995f3db9699a1f794d,2022,,,2,JC Buttler,YBK Jaiswal,16,10,3,0,1,2,5,0,0,13,5,3,0
6480bb97668d35800fa74139,2021,,,1,DJ Hooda,MC Henriques,16,17,1,0,1,7,7,1,0,9,10,0,0
6480bba2c3207713bd927ce5,2015,,,2,DA Miller,GJ Bailey,16,21,0,0,1,9,10,0,0,6,11,0,0
6480bb96f1eadf803ffc292c,2020/21,,,2,SV Samson,YBK Jaiswal,16,14,0,1,1,5,9,0,0,10,5,0,1
6480bb9c9e328ac30bcaf6b0,2009/10,,,2,Harbhajan Singh,SR Tendulkar,16,13,1,0,1,5,6,1,0,7,7,0,0
6480bb99695e001cdaca81e0,2022,,,1,MS Dhoni,Mukesh Choudhary,16,15,2,1,1,11,11,1,1,4,4,1,0
6480bb984a8abbb79a69e6ce,2022,,,2,AK Markram,B Kumar,16,8,1,1,0,12,4,1,1,3,4,0,0
6480bb9cf1471ad233c7b0af,2009,,,2,AS Raut,J Botha,16,15,1,0,1,10,11,0,0,6,4,1,0
6480bb9a87f64c1a12f62ece,2007/08,,,2,DJ Bravo,SM Pollock,16,12,0,1,1,4,6,0,0,9,6,0,1
6480bb961cdee4d82c395517,2020/21,,,1,Abdul Samad,KS Williamson,16,11,1,1,1,12,6,1,1,3,5,0,0
6480bb9ca181f55cb21526f5,2009/10,,,1,SL Malinga,Z Khan,16,5,2,1,0,0,0,0,0,16,5,2,1
6480bba0b46cf5430edef3f5,2014,,,1,AP Tare,AT Rayudu,16,19,1,0,1,3,7,0,0,13,12,1,0
6480bba2d324f0342e6af689,2016,,,1,AD Nath,SK Raina,16,15,2,0,1,5,9,0,0,11,6,2,0
6480bb973d64aa91e60b4088,2021,,,1,RA Jadeja,SM Curran,16,7,1,1,1,4,2,1,0,12,5,0,1
6480bb94b991069934e5c7d2,2018,,,1,BA Stokes,JC Buttler,16,13,0,1,1,11,8,0,1,5,5,0,0
6480bb99f2a793884331579e,2023,,,1,N Rana,VR Iyer,16,16,2,0,1,5,10,0,0,10,6,2,0
6480bb9da9ca2f2d3738d79e,2011,,,2,JD Ryder,TD Paine,16,21,2,0,1,12,15,2,0,2,6,0,0
6480bb9a58bc8710c38f4c1c,2023,,,2,N Wadhera,TH David,16,12,2,0,1,8,8,1,0,7,4,1,0
6480bb9525ace33768e8b671,2019,,,1,AT Rayudu,SK Raina,16,17,2,0,1,5,6,0,0,11,11,2,0
6480bb9d5cca30c933d4baf4,2011,,,2,AS Raut,DH Yagnik,16,12,2,0,1,7,5,1,0,8,7,1,0
6480bb950c59218964b27cc0,2018,,,2,AJ Tye,KL Rahul,16,6,2,1,0,1,1,0,0,14,5,2,1
6480bba2ebdcfb98389cee5a,2015,,,1,Q de Kock,SS Iyer,16,15,3,0,1,3,7,0,0,13,8,3,0
6480bb9f79be50f1621abcc6,2012,,,2,AL Menaria,BJ Hodge,16,16,0,0,1,8,9,0,0,8,7,0,0
6480bb9e6d7f7f691dde322d,2012,,,2,A Ashish Reddy,JP Duminy,16,14,1,1,1,10,10,0,1,6,4,1,0
6480bb9dfb2e8e8c2002df86,2011,,,1,IR Jaggi,JP Duminy,16,14,0,1,1,6,8,0,0,10,6,0,1
6480bb95f37ebb69ffb216e0,2019,,,1,CA Lynn,NS Naik,16,22,2,0,1,8,6,1,0,7,16,1,0
6480bba2c56d0ef7222ee3b8,2015,,,1,HV Patel,SN Khan,16,7,1,1,1,6,2,0,1,9,5,1,0
6480bb9baccf501985a56d64,2007/08,,,2,AB de Villiers,G Gambhir,16,17,0,0,1,12,13,0,0,3,4,0,0
6480bb98adf21699eaa67796,2022,,,2,AT Rayudu,DP Conway,16,14,0,1,1,10,8,0,1,6,6,0,0
6480bb9a3ffea6235f54cc1e,2023,,,2,AK Markram,RA Tripathi,16,11,2,1,1,0,5,0,0,15,6,2,1
6480bb983ad1bab18d1d8774,2022,,,1,AD Russell,TG Southee,16,13,0,2,1,15,10,0,2,0,3,0,0
6480bb9a24adc8d916dfe2db,2023,,,2,H Klaasen,Sanvir Singh,16,11,0,2,1,9,5,0,1,7,6,0,1
6480bb9d40fc01528c7b7270,2009/10,,,1,MJ Lumb,NV Ojha,16,14,2,0,1,9,8,1,0,6,6,1,0
6480bba34d78f594b07da1bc,2016,,,2,Gurkeerat Singh,MM Sharma,16,12,2,0,1,8,6,1,0,7,6,1,0
6480bb958f77e7d3929d28e3,2018,,,1,KK Nair,R Ashwin,16,4,2,1,1,14,3,2,1,0,1,0,0
6480bb9eda28fb340ed37b49,2012,,,2,BB McCullum,G Gambhir,16,17,2,0,1,10,9,1,0,6,8,1,0
6480bb98d2cd0fa3ed0ffc21,2022,,,1,LS Livingstone,RA Bawa,16,20,1,0,1,9,10,1,0,5,10,0,0
6480bb979e91d1ff9b54c737,2020/21,,,1,AM Rahane,S Dhawan,16,15,3,0,1,2,4,0,0,14,11,3,0
6480bb947a7c9fe868fc901a,2017,,,1,A Mishra,Mohammed Shami,16,8,2,1,1,7,4,0,1,9,4,2,0
6480bb94c2dcb1007bf6788b,2017,,,2,MJ Guptill,SE Marsh,16,16,2,0,1,8,8,1,0,8,8,1,0
6480bb956b439141409fd739,2018,,,1,BA Stokes,JC Buttler,16,12,2,0,1,12,9,2,0,4,3,0,0
6480bb94d8ce46258c13e90e,2017,,,1,N Rana,PA Patel,16,18,1,0,1,3,9,0,0,12,9,1,0
6480bb9929c7e430acd1ef18,2022,,,2,DA Warner,KS Bharat,16,11,2,1,1,8,6,0,1,8,5,2,0
6480bb94605dacb25c83dc35,2018,,,2,G Gambhir,GJ Maxwell,16,14,1,1,1,1,4,0,0,12,10,1,1
6480bb97af05ebd5c4f575c4,2021,,,1,Q de Kock,SA Yadav,16,12,2,1,1,6,6,1,0,10,6,1,1
6480bb9371e90dbd44ee19a3,2017,,,2,HM Amla,WP Saha,16,10,3,0,1,9,5,2,0,7,5,1,0
6480bb939c56810fd88e895b,2017,,,1,AR Patel,HM Amla,16,13,0,1,1,9,6,0,1,6,7,0,0
6480bba287d112bccc55ccd2,2015,,,1,GJ Maxwell,M Vohra,16,13,0,1,1,6,8,0,0,10,5,0,1
6480bb933fdc96ee7273400e,2017,,,2,JC Buttler,RG Sharma,16,13,1,1,1,13,6,1,1,3,7,0,0
6480bb947b065b9dc0256f0d,2018,,,2,CR Woakes,Mandeep Singh,16,7,3,0,0,0,1,0,0,16,6,3,0
6480bb9c12e6c723b248799b,2009,,,1,MK Pandey,RE van der Merwe,16,16,0,2,1,2,4,0,0,14,12,0,2
6480bb947a7c9fe868fc901a,2017,,,2,KM Jadhav,V Kohli,16,14,0,1,1,5,5,0,0,11,9,0,1
6480bb9d038ed22e46cbeccb,2011,,,1,B Chipli,KC Sangakkara,16,13,2,0,1,6,8,1,0,9,5,1,0
6480bb9bcf9df9e7ae0416ba,2009,,,2,NV Ojha,RA Jadeja,16,7,2,1,0,14,4,2,1,1,3,0,0
6480bba069c0322e91e50958,2013,,,2,P Dogra,YK Pathan,16,12,0,1,1,5,8,0,0,10,4,0,1
6480bba255079696d5cfa453,2015,,,2,AR Patel,Karanveer Singh,16,12,1,1,1,12,5,1,1,4,7,0,0
6480bb9af968df9497d2b9c4,2007/08,,,2,AM Rahane,ST Jayasuriya,16,16,2,1,1,4,10,1,0,10,6,1,1
6480bb954e496ec9b12aa120,2019,,,1,JC Buttler,SV Samson,16,5,4,0,1,12,4,3,0,4,1,1,0
6480bb9718a9b89de407178b,2021,,,1,DJ Hooda,M Shahrukh Khan,16,7,2,1,0,1,2,0,0,15,5,2,1
6480bb94c5d20726ee59d3d6,2017,,,1,S Aravind,TM Head,16,3,1,2,0,0,0,0,0,16,3,1,2
6480bba07b5396a7b65684d3,2013,,,2,JH Kallis,YK Pathan,16,14,1,1,1,3,6,0,0,13,8,1,1
6480bb9929c7e430acd1ef18,2022,,,1,MM Ali,MS Dhoni,16,6,2,1,1,9,4,2,0,6,2,0,1
6480bb9af85f41b4de44ca19,2023,,,2,DA Miller,Shubman Gill,16,14,0,0,1,4,6,0,0,8,8,0,0
6480bb9b8860198955e581d8,2007/08,,,2,JR Hopes,SE Marsh,16,12,1,1,1,14,7,1,1,2,5,0,0
6480bba0b07a395235841955,2013,,,1,PA Reddy,S Dhawan,16,14,3,0,1,7,9,1,0,9,5,2,0
6480bb9996eb97dd08b62f78,2023,,,2,Harpreet Singh,P Simran Singh,16,13,1,1,1,13,9,1,1,2,4,0,0
6480bb971c9e4a3ef11759f3,2021,,,1,CJ Jordan,M Shahrukh Khan,16,18,0,1,1,6,9,0,0,10,9,0,1
6480bba28724848c0f3ef034,2015,,,2,PP Chawla,YK Pathan,16,12,1,1,1,1,4,0,0,14,8,1,1
6480bb95014388d3e8c62904,2019,,,1,PA Patel,V Kohli,16,12,2,0,1,9,9,1,0,6,3,1,0
6480bb9c50838010977c168c,2009,,,2,IK Pathan,PP Chawla,16,12,1,0,1,12,10,1,0,2,2,0,0
6480bb9da3dc1406b000cc98,2011,,,1,JD Ryder,Yuvraj Singh,16,9,1,1,1,15,7,1,1,1,2,0,0
6480bb954817ed0a4ba25bc2,2018,,,1,M Markande,MJ McClenaghan,16,11,2,0,0,7,5,1,0,5,6,1,0
6480bb9fa236b26050f19633,2012,,,1,R Dravid,SR Watson,16,13,1,1,1,8,4,1,0,8,9,0,1
6480bb9fe7d0f611ba6ad229,2012,,,1,K Upadhyay,SPD Smith,16,12,0,1,0,11,8,0,1,5,4,0,0
6480bb9cba868c69775db687,2009,,,1,R Dravid,V Kohli,16,16,1,0,1,12,10,1,0,4,6,0,0
6480bb97aad3147696268239,2021,,,2,DS Kulkarni,KA Pollard,16,6,2,1,0,0,0,0,0,16,6,2,1
6480bb9f302200e3bc89464e,2012,,,1,JP Duminy,PA Patel,16,13,1,0,1,6,8,0,0,10,5,1,0
6480bb9cf1471ad233c7b0af,2009,,,2,J Botha,NV Ojha,16,24,1,0,1,3,7,0,0,9,17,1,0
6480bb9e88141830a7a309b5,2011,,,2,B Lee,RN ten Doeschate,16,10,0,1,0,2,3,0,0,14,7,0,1
6480bb98bc3569cc8d04101a,2022,,,2,N Rana,VR Iyer,16,11,1,1,1,8,7,0,1,8,4,1,0
6480bb9bfcaabf33b5687e32,2007/08,,,2,AM Nayar,RV Uthappa,16,15,1,0,1,11,7,1,0,3,8,0,0
6480bba0295edd6084b9503b,2014,,,2,AM Rahane,SR Watson,16,17,1,0,1,10,10,1,0,3,7,0,0
6480bb98f98edd45b1ccb406,2022,,,2,AD Russell,SP Narine,16,7,1,2,1,6,2,0,1,10,5,1,1
6480bb99cf7659c6e45bd01d,2023,,,2,DP Conway,MM Ali,16,10,3,0,0,10,4,2,0,6,6,1,0
6480bb999424dd02cf40772a,2022,,,1,GJ Maxwell,RM Patidar,16,12,0,2,1,9,10,0,1,7,2,0,1
6480bb99af95c6c90c4c3924,2023,,,2,Abdul Samad,Washington Sundar,16,7,2,0,1,1,1,0,0,10,6,2,0
6480bb994877788ec5b187ff,2023,,,1,DP Conway,RD Gaikwad,16,14,1,1,1,13,8,1,1,3,6,0,0
6480bb954e496ec9b12aa120,2019,,,1,RA Tripathi,SPD Smith,16,21,1,0,1,10,12,1,0,6,9,0,0
6480bba140ee53a14fe06e0d,2014,,,1,CM Gautam,LMP Simmons,16,17,3,0,1,9,8,2,0,6,9,1,0
6480bb9d91920239b62f48ad,2009/10,,,1,R Vinay Kumar,V Kohli,16,15,2,0,1,3,7,0,0,12,8,2,0
6480bb9834c7569d5fa64353,2022,,,2,HE van der Dussen,SO Hetmyer,16,18,0,0,1,5,9,0,0,9,9,0,0
6480bb9800ba03eb1f9437d2,2022,,,2,HH Pandya,WP Saha,16,10,3,0,1,10,6,2,0,6,4,1,0
6480bba1de7febd9f1f0138e,2014,,,1,F du Plessis,MS Dhoni,16,16,1,0,1,4,7,0,0,9,9,1,0
6480bb96902b7c96b94f406a,2019,,,1,KD Karthik,RV Uthappa,16,26,0,1,1,3,9,0,0,12,17,0,1
6480bb987b6845947f7ca137,2022,,,2,B Indrajith,SS Iyer,16,15,2,0,1,5,4,1,0,10,11,1,0
6480bb94ee669473878c11c2,2017,,,1,MK Pandey,YK Pathan,16,17,0,0,1,7,9,0,0,8,8,0,0
6480bb9c757dbd7f92b1130a,2009/10,,,1,Jaskaran Singh,RG Sharma,16,8,1,1,1,1,2,0,0,15,6,1,1
6480bb9940bd3bf36dd4897f,2023,,,2,A Badoni,KL Rahul,16,15,0,0,1,8,6,0,0,7,9,0,0
6480bba20559f15c3489f637,2015,,,2,KL Rahul,NV Ojha,16,16,0,0,1,6,7,0,0,9,9,0,0
6480bb9a21e416835389fd53,2023,,,2,JM Sharma,M Shahrukh Khan,16,9,2,0,1,12,7,2,0,2,2,0,0
6480bb98b8bb5b0d2c2f0848,2022,,,2,MJ Santner,RV Uthappa,16,14,2,0,1,11,9,2,0,3,5,0,0
6480bb9ca21b98f1be8254e2,2009/10,,,2,R Dravid,V Kohli,16,11,2,0,1,11,5,2,0,5,6,0,0
6480bb9448fe25ec89c5fcff,2017,,,1,Harbhajan Singh,KA Pollard,16,13,0,1,0,2,4,0,0,13,9,0,1
6480bb9866dd8ba9b48863c2,2022,,,2,KL Rahul,MK Pandey,16,13,1,1,1,10,5,0,1,6,8,1,0
6480bb9eeeaf037e5e41ab86,2012,,,2,JP Faulkner,PP Chawla,16,14,0,1,1,5,6,0,0,10,8,0,1
6480bb9ef8d4c23c6e5be4c7,2011,,,2,BJ Hodge,RA Jadeja,16,19,1,0,1,5,11,0,0,9,8,1,0
6480bb996c5ae75a32d978e8,2022,,,1,MS Dhoni,N Jagadeesan,16,18,0,0,1,7,10,0,0,6,8,0,0
6480bb9d8f5769d3a514fd88,2009/10,,,1,LRPL Taylor,V Kohli,16,12,1,0,1,4,5,0,0,9,7,1,0
6480bb9dd89d4266d59a4592,2011,,,2,KD Karthik,Sunny Singh,16,13,2,0,1,12,8,2,0,4,5,0,0
6480bb9ab34d149420eae546,2023,,,1,KH Pandya,Q de Kock,16,18,0,1,1,9,8,0,1,6,10,0,0
6480bb9ded279701c84af803,2011,,,2,CL White,JP Duminy,16,14,1,0,1,4,7,0,0,12,7,1,0
6480bb98436587de59527f2e,2022,,,1,Anmolpreet Singh,Ishan Kishan,16,14,1,0,1,8,9,0,0,8,5,1,0
6480bba2fc84811f520b04cf,2016,,,2,KD Karthik,RA Jadeja,16,16,1,0,1,6,4,1,0,8,12,0,0
6480bb946efcc4cd9aa80399,2018,,,2,CA Lynn,SP Narine,16,11,2,1,1,5,8,1,0,11,3,1,1
6480bba28724848c0f3ef034,2015,,,2,SA Yadav,YK Pathan,16,8,3,0,1,11,5,2,0,5,3,1,0
6480bba177ab201442a0e3c8,2015,,,1,AB de Villiers,V Kohli,16,10,3,0,1,11,7,2,0,5,3,1,0
6480bb983ad1bab18d1d8774,2022,,,2,F du Plessis,V Kohli,16,9,3,0,1,4,3,1,0,12,6,2,0
6480bb99fa79383bdc7df827,2022,,,1,JM Bairstow,LS Livingstone,16,15,2,0,1,6,6,1,0,10,9,1,0
6480bb9faf20f0bc714af2ea,2013,,,2,AD Russell,DPMD Jayawardene,16,15,2,0,1,4,8,0,0,11,7,2,0
6480bb967d799ced7fe5d8e9,2020/21,,,1,N Pooran,Ravi Bishnoi,16,10,2,0,0,15,10,2,0,0,0,0,0
6480bba0c9e6d590ed35eb56,2014,,,1,NJ Maddinson,PA Patel,16,18,2,0,1,12,8,2,0,4,10,0,0
6480bb9f777b7b1e89543a6e,2013,,,2,KD Karthik,RG Sharma,16,20,2,0,1,11,13,2,0,2,7,0,0
6480bb9a36f2ab9a44baa0f8,2023,,,1,A Zampa,TA Boult,16,14,0,1,1,4,6,0,0,9,8,0,1
6480bb98dd9a2108c79e1014,2022,,,1,Arshdeep Singh,RD Chahar,16,19,2,1,1,4,7,1,0,12,12,1,1
6480bb97752fcb9cd9f23692,2021,,,2,CH Morris,SV Samson,16,11,0,2,1,2,4,0,0,14,7,0,2
6480bba20130c44ed20c9bcf,2016,,,2,AJ Finch,DS Kulkarni,16,8,2,0,0,10,5,1,0,6,3,1,0
6480bba08cc4182f0127f2e2,2013,,,2,MEK Hussey,R Ashwin,16,16,0,1,1,12,8,0,1,2,8,0,0
6480bb983ad1bab18d1d8774,2022,,,1,AD Russell,SW Billings,16,16,1,1,1,10,8,1,1,4,8,0,0
6480bb9442c4889bcbb4a784,2017,,,1,C de Grandhomme,SA Yadav,16,13,2,0,1,13,9,2,0,3,4,0,0
6480bb938ed49c6d5c211429,2017,,,2,BCJ Cutting,Yuvraj Singh,16,9,1,1,1,6,4,1,0,8,5,0,1
6480bba18a289cc4b8d173a4,2014,,,2,KD Karthik,KP Pietersen,16,21,2,0,1,6,10,1,0,10,11,1,0
6480bb94ee669473878c11c2,2017,,,2,CH Gayle,STR Binny,16,13,3,0,1,5,7,1,0,8,6,2,0
6480bb9b69f8ace7659e486d,2009,,,2,RA Jadeja,SK Warne,16,15,1,1,1,14,8,1,1,2,7,0,0
6480bba15b304732a6212cdf,2015,,,2,DA Warner,KL Rahul,16,14,1,1,1,11,6,0,1,5,8,1,0
6480bba01893b0faadb9c761,2013,,,2,J Syed Mohammad,SS Tiwary,16,17,1,0,1,7,8,1,0,9,9,0,0
6480bb9bed3e2a1a008f93a6,2007/08,,,2,A Chopra,Salman Butt,16,17,1,1,1,1,4,0,0,13,13,1,1
6480bba388682c5ca10ff37a,2016,,,2,BCJ Cutting,Bipul Sharma,16,9,2,1,1,11,6,1,1,5,3,1,0
6480bba097818bcc0db9555d,2014,,,2,KL Rahul,Y Venugopal Rao,16,13,2,0,1,5,4,0,0,11,9,2,0
6480bb9ef18c54e7aafdd223,2012,,,2,AC Gilchrist,Mandeep Singh,16,17,2,0,1,5,9,0,0,10,8,2,0
6480bb9e692eaa193a417426,2012,,,2,DAJ Bracewell,IK Pathan,16,12,2,0,1,8,6,1,0,7,6,1,0
6480bba1de7febd9f1f0138e,2014,,,2,KK Nair,STR Binny,15,14,0,1,1,3,5,0,0,12,9,0,1
6480bb9f2305d07e3c65be11,2013,,,2,AC Gilchrist,Mandeep Singh,15,17,1,0,1,4,6,0,0,10,11,1,0
6480bb951677500061c85592,2019,,,1,Ishan Kishan,Q de Kock,15,20,1,0,1,6,10,0,0,9,10,1,0
6480bb9d4e112d675b2925df,2009/10,,,2,A Mishra,DL Vettori,15,10,2,0,0,4,6,0,0,10,4,2,0
6480bba2557febf92f9f79ab,2015,,,2,SA Yadav,YK Pathan,15,31,0,0,1,10,21,0,0,5,10,0,0
6480bb9754755bb7a7427d52,2021,,,2,R Tewatia,SV Samson,15,17,0,0,1,5,8,0,0,5,9,0,0
6480bb9eae43aed76989151b,2011,,,2,EJG Morgan,JH Kallis,15,15,3,0,1,2,5,0,0,13,10,3,0
6480bb9558c0acb502a3b1a9,2019,,,1,KL Rahul,SM Curran,15,11,2,1,1,15,11,2,1,0,0,0,0
6480bb95c8ecc2185a67f4fd,2019,,,1,AM Rahane,JC Buttler,15,20,1,0,1,9,12,0,0,5,8,1,0
6480bb9f36ad55c3c7fd6548,2012,,,2,SP Narine,YK Pathan,15,11,2,0,0,9,6,2,0,3,5,0,0
6480bb9db9ed29ce1ee8764f,2011,,,1,DA Warner,Y Venugopal Rao,15,11,0,1,1,12,8,0,1,3,3,0,0
6480bb949f5853dfe76c99d9,2017,,,1,AM Rahane,RA Tripathi,15,19,2,0,1,2,7,0,0,12,12,2,0
6480bb95b1f28cf5bcf5e167,2018,,,2,F du Plessis,MS Dhoni,15,24,1,0,1,4,6,0,0,9,18,1,0
6480bba2b5d601f8354f5b5a,2016,,,2,DA Miller,M Vohra,15,12,2,0,1,9,9,1,0,5,3,1,0
6480bb99d43295fa2d82c9dc,2023,,,1,GJ Maxwell,HV Patel,15,9,0,2,1,8,5,0,1,6,4,0,1
6480bb972a7d4e1071ea662e,2021,,,2,Lalit Yadav,RR Pant,15,12,2,0,1,6,4,1,0,7,8,1,0
6480bb950c59218964b27cc0,2018,,,2,AR Patel,KL Rahul,15,9,1,0,1,9,5,1,0,2,4,0,0
6480bb99efa58b95852be382,2023,,,1,MJ Santner,MS Dhoni,15,9,1,1,0,1,3,0,0,13,6,1,1
6480bb9f1faffe780b407e67,2013,,,1,AM Nayar,B Kumar,15,19,2,0,1,6,7,1,0,8,12,1,0
6480bb982f070b023b901b3e,2021,,,2,RR Pant,SPD Smith,15,9,0,2,1,7,3,0,1,8,6,0,1
6480bb9bbb0ec0266749f518,2007/08,,,1,P Kumar,R Dravid,15,7,2,1,1,8,4,2,0,7,3,0,1
6480bb96d1b3bea0aa2127e4,2020/21,,,1,KA Pollard,KH Pandya,15,9,1,0,0,12,6,1,0,1,3,0,0
6480bb9eb261c1057830912e,2011,,,1,CA Ingram,MS Wade,15,19,0,0,1,5,5,0,0,10,14,0,0
6480bb9b1fc007965b68d4d9,2009,,,1,DB Ravi Teja,Y Venugopal Rao,15,12,1,0,1,7,4,1,0,7,8,0,0
6480bb9dd10e35e6145534dc,2011,,,2,IK Pathan,JR Hopes,15,9,2,0,1,1,3,0,0,13,6,2,0
6480bb9e335bec070f88430f,2011,,,2,DJ Bravo,MS Dhoni,15,10,1,1,1,5,5,1,0,10,5,0,1
6480bb9575ad32214d0f6ec0,2019,,,2,AM Rahane,STR Binny,15,8,1,1,1,4,5,0,0,11,3,1,1
6480bb9f7ff1377c4d13a645,2013,,,2,B Kumar,R Sharma,15,20,1,0,0,5,8,0,0,10,12,1,0
6480bb99b35dc0981e512451,2022,,,1,R Ashwin,SO Hetmyer,15,17,2,0,1,4,6,0,0,11,11,2,0
6480bb966539f85263cb6429,2019,,,2,AR Patel,SS Iyer,15,16,1,0,1,9,9,1,0,6,7,0,0
6480bb9538916411f52016bf,2019,,,1,CA Lynn,N Rana,15,17,1,0,1,4,6,0,0,11,11,1,0
6480bb970c637fd0c057dca9,2021,,,2,Abdul Samad,KM Jadhav,15,13,0,1,1,10,8,0,1,3,5,0,0
6480bba0ffae8617ee64bd19,2013,,,2,DA Warner,J Botha,15,11,3,0,1,9,5,2,0,6,6,1,0
6480bb9a807eb5f39489408a,2023,,,2,Aman Hakim Khan,Lalit Yadav,15,6,3,0,1,1,1,0,0,12,5,3,0
6480bb9e502d7987de08e5d5,2012,,,1,JD Ryder,MK Pandey,15,15,2,0,1,7,6,1,0,8,9,1,0
6480bba2e8614b1263627c1b,2015,,,1,KK Nair,SPD Smith,15,21,1,0,1,4,10,0,0,9,11,1,0
6480bb9359a2cade3b5213d3,2017,,,1,P Negi,STR Binny,15,11,0,0,0,9,7,0,0,6,4,0,0
6480bb99433f6e11060ba714,2022,,,2,JM Sharma,R Dhawan,15,19,1,0,1,11,6,1,0,4,13,0,0
6480bb9d79d603cc45fc9b3c,2011,,,2,PP Chawla,SE Marsh,15,13,1,0,1,8,8,1,0,5,5,0,0
6480bb9ee0795047740de5a7,2011,,,1,AM Rahane,LRPL Taylor,15,15,0,0,1,8,7,0,0,6,8,0,0
6480bb987c52e15a2cac0697,2022,,,2,AK Markram,Abhishek Sharma,15,13,0,1,1,4,7,0,0,11,6,0,1
6480bb9be2940d96c1f903ca,2007/08,,,1,MS Gony,SK Raina,15,10,3,0,1,4,4,1,0,10,6,2,0
6480bb9b9ca80d1c48994e04,2007/08,,,2,JA Morkel,MS Dhoni,15,6,2,0,1,5,4,1,0,5,2,1,0
6480bb9f23c17ccb47aa9e58,2013,,,1,AM Rahane,R Dravid,15,15,3,0,1,5,3,1,0,9,12,2,0
6480bb9cba868c69775db687,2009,,,2,JA Morkel,JDP Oram,15,12,0,1,1,3,5,0,0,9,7,0,1
6480bb9aef150645306cc170,2023,,,2,PK Garg,SN Khan,15,14,1,0,1,11,8,1,0,4,6,0,0
6480bb957ae1619e0d648dec,2019,,,1,DA Warner,DJ Hooda,15,5,2,1,0,1,2,0,0,14,3,2,1
6480bb950c59218964b27cc0,2018,,,1,BA Stokes,STR Binny,15,10,0,1,1,4,3,0,0,11,7,0,1
6480bb98d8f59b81335f4a3d,2021,,,2,AT Rayudu,SK Raina,15,10,3,0,1,10,6,2,0,5,4,1,0
6480bba1827557ebdfc70821,2015,,,1,AR Patel,GJ Bailey,15,9,2,0,1,2,3,0,0,13,6,2,0
6480bb99773871f8e2ddc4b1,2022,,,1,AK Markram,Abhishek Sharma,15,12,1,1,1,8,6,1,0,7,6,0,1
6480bb98cbaaf700d226941a,2022,,,2,Ishan Kishan,RG Sharma,15,11,1,1,1,4,6,1,0,10,5,0,1
6480bb9619eaed447b2a05d4,2020/21,,,2,Ishan Kishan,SA Yadav,15,14,1,0,1,6,5,1,0,7,9,0,0
6480bb9a807eb5f39489408a,2023,,,1,AM Rahane,MM Ali,15,21,0,0,1,7,9,0,0,7,12,0,0
6480bb974123cbc9756ceefa,2021,,,2,AK Markram,MA Agarwal,15,15,2,0,1,8,9,1,0,7,6,1,0
6480bb9827e9fb920cf62809,2021,,,2,RA Tripathi,Shubman Gill,15,12,3,0,1,7,6,1,0,8,6,2,0
6480bb956b439141409fd739,2018,,,1,RA Tripathi,S Gopal,15,11,1,0,1,8,5,1,0,7,6,0,0
6480bb95f2e3c32afe233820,2018,,,1,AD Hales,S Dhawan,15,15,2,0,1,5,5,1,0,8,10,1,0
6480bb9a17692bfb5bd3894c,2007/08,,,1,JA Morkel,MS Dhoni,15,14,2,0,1,10,8,2,0,4,6,0,0
6480bb95f214d4f82ab97ee5,2018,,,2,CA Lynn,RV Uthappa,15,15,1,1,1,11,9,1,1,4,6,0,0
6480bb94aa9b082aa58a3822,2017,,,2,KK Nair,SS Iyer,15,13,1,1,1,9,6,0,1,6,7,1,0
6480bb94738952e740c68749,2018,,,1,S Dhawan,WP Saha,15,10,3,0,1,10,7,2,0,4,3,1,0
6480bb95f37ebb69ffb216e0,2019,,,1,Kuldeep Yadav,PP Chawla,15,8,2,0,1,10,5,1,0,5,3,1,0
6480bb94640655c49683aee1,2018,,,2,JC Buttler,SV Samson,15,13,1,0,1,6,7,0,0,9,6,1,0
6480bba2b99fcf06aaeac805,2015,,,2,STR Binny,TG Southee,15,10,1,0,1,8,5,1,0,6,5,0,0
6480bba2e30bef1d7b3bb753,2015,,,2,Mandeep Singh,V Kohli,15,9,0,1,1,1,3,0,0,14,6,0,1
6480bb95833c06e6c5119173,2019,,,2,CA Lynn,N Rana,15,10,0,1,1,1,3,0,0,14,7,0,1
6480bb931b06a170006b4713,2017,,,1,MK Pandey,YK Pathan,15,7,3,0,1,5,4,1,0,10,3,2,0
6480bb9574ca455ec008e942,2018,,,2,Shivam Mavi,Shubman Gill,15,7,1,1,1,6,4,1,0,9,3,0,1
6480bb961cdee4d82c395517,2020/21,,,1,JM Bairstow,MK Pandey,15,11,2,0,1,11,6,2,0,3,5,0,0
6480bb9b2de4e62ee60b7e5c,2009,,,2,DPMD Jayawardene,Yuvraj Singh,15,5,1,1,0,1,1,0,0,13,4,1,1
6480bba32e54551792a9e915,2016,,,1,KD Karthik,SK Raina,15,10,2,0,1,3,4,0,0,11,6,2,0
6480bb980ea7c3bcea4fdf9c,2022,,,1,JO Holder,PVD Chameera,15,13,0,1,1,10,6,0,1,5,7,0,0
6480bb9866dd8ba9b48863c2,2022,,,2,JO Holder,PVD Chameera,15,9,0,2,1,13,6,0,2,1,3,0,0
6480bb94605dacb25c83dc35,2018,,,2,A Mishra,SS Iyer,15,10,1,1,1,1,2,0,0,14,8,1,1
6480bb948a69b3d86293b12b,2017,,,1,JP Faulkner,RA Jadeja,15,9,1,0,0,14,8,1,0,1,1,0,0
6480bb945460b25d997060fb,2018,,,1,N Rana,Shubman Gill,15,7,3,0,1,9,5,2,0,5,2,1,0
6480bb9f1faffe780b407e67,2013,,,1,AM Nayar,LRPL Taylor,15,21,1,0,1,5,8,0,0,10,13,1,0
6480bb980b5b26e8c4335a4b,2022,,,2,MS Dhoni,RA Jadeja,15,10,1,1,1,12,8,1,1,2,2,0,0
6480bb98f98edd45b1ccb406,2022,,,1,A Badoni,KH Pandya,15,13,1,0,1,5,6,0,0,10,7,1,0
6480bb95945c5e5dc4d8c7d6,2019,,,1,HH Pandya,JJ Bumrah,15,5,0,2,0,13,4,0,2,0,1,0,0
6480bba0a3e806f41a4dab41,2013,,,2,CA Pujara,CH Gayle,15,27,1,0,1,5,14,0,0,9,13,1,0
6480bb98634dba60191637ad,2021,,,2,B Kumar,JO Holder,15,11,0,1,0,3,4,0,0,10,7,0,1
6480bb964c4bea88164f168d,2020/21,,,2,S Gopal,TK Curran,15,18,1,0,1,5,7,0,0,10,11,1,0
6480bba0a222eb875a07f5a3,2014,,,1,M Vijay,MA Agarwal,15,18,0,1,1,8,8,0,1,6,10,0,0
6480bb948211fe47e65f2e77,2018,,,1,Rashid Khan,YK Pathan,15,14,1,0,1,6,9,0,0,8,5,1,0
6480bba2557febf92f9f79ab,2015,,,2,RN ten Doeschate,YK Pathan,15,18,0,0,1,5,10,0,0,8,8,0,0
6480bb9a4de9fe3e7319ce39,2007/08,,,1,LRPL Taylor,S Chanderpaul,15,12,0,2,1,12,4,0,2,1,8,0,0
6480bb9a81d7fd0ac0307b4d,2023,,,2,DJ Hooda,MP Stoinis,15,12,0,1,1,10,6,0,1,4,6,0,0
6480bba2fbc243afec641844,2015,,,1,GJ Bailey,M Vohra,15,11,2,0,1,12,7,2,0,3,4,0,0
6480bb9aa030c8ebcbcc19c9,2007/08,,,1,L Ronchi,ST Jayasuriya,15,14,3,0,1,13,11,3,0,0,3,0,0
6480bb9f895e5780080c8059,2012,,,1,P Kumar,RJ Harris,15,6,1,1,0,3,2,0,0,12,4,1,1
6480bb9ee779ef1e445d0506,2012,,,2,SC Ganguly,WD Parnell,15,17,1,0,1,3,6,0,0,6,11,1,0
6480bb9f3ca20834ecc7607a,2012,,,2,HH Gibbs,SR Tendulkar,15,14,3,0,1,13,12,3,0,2,2,0,0
6480bb947a7c9fe868fc901a,2017,,,1,Mohammed Shami,S Nadeem,15,8,1,1,1,12,5,1,1,2,3,0,0
6480bb9affabe4960a987464,2007/08,,,1,JH Kallis,W Jaffer,15,15,0,1,1,8,7,0,1,5,8,0,0
6480bb9c620c92d09ba1b6b9,2009,,,2,MM Patel,RA Jadeja,15,18,0,0,1,5,7,0,0,10,11,0,0
6480bb966c9efd5bf35d10b9,2019,,,2,BA Stokes,R Parag,15,17,2,0,1,6,8,1,0,8,9,1,0
6480bb984a8abbb79a69e6ce,2022,,,1,SO Hetmyer,SV Samson,15,7,0,2,1,2,1,0,0,13,6,0,2
6480bb9c5d0fccb6a3a6d37d,2009,,,1,JDP Oram,S Badrinath,15,9,2,0,0,1,2,0,0,14,7,2,0
6480bb964c4bea88164f168d,2020/21,,,2,JC Buttler,SV Samson,15,13,1,1,1,6,4,0,1,8,9,1,0
6480bb950c59218964b27cc0,2018,,,1,BA Stokes,JC Buttler,15,11,1,0,1,9,6,1,0,6,5,0,0
6480bba33dab752d79e587d2,2016,,,1,KS Williamson,Yuvraj Singh,15,12,1,1,1,6,4,1,0,8,8,0,1
6480bb9827e9fb920cf62809,2021,,,1,Abdul Samad,Rashid Khan,15,7,0,2,1,13,5,0,2,2,2,0,0
6480bb9442c4889bcbb4a784,2017,,,1,MK Pandey,YK Pathan,15,20,0,1,1,11,11,0,1,4,9,0,0
6480bb9940bd3bf36dd4897f,2023,,,1,HH Pandya,V Shankar,15,20,1,0,1,5,8,0,0,10,12,1,0
6480bb9a21e416835389fd53,2023,,,2,M Shahrukh Khan,Sikandar Raza,15,8,1,0,0,0,1,0,0,13,7,1,0
6480bb945901306d3cb2b759,2018,,,2,BA Stokes,STR Binny,15,9,1,1,1,9,6,0,1,6,3,1,0
6480bb9f231505ffc493730f,2012,,,1,JA Morkel,MS Dhoni,15,11,1,0,1,13,9,1,0,1,2,0,0
6480bb9c963968000dfd00d1,2009/10,,,2,MS Bisla,Yuvraj Singh,15,15,2,0,1,7,9,1,0,8,6,1,0
6480bb9fe3bc767415c60bfa,2012,,,2,JH Kallis,YK Pathan,15,14,1,0,1,6,6,1,0,9,8,0,0
6480bb964c4bea88164f168d,2020/21,,,2,JC Buttler,SPD Smith,15,12,0,1,1,9,5,0,1,3,7,0,0
6480bb962831291a868490e7,2020/21,,,2,AR Patel,MP Stoinis,15,10,0,1,1,8,4,0,1,6,6,0,0
6480bba08ffdd4393211d261,2014,,,1,AJ Finch,S Dhawan,15,14,2,0,1,6,5,1,0,7,9,1,0
6480bb971c9e4a3ef11759f3,2021,,,2,AD Russell,EJG Morgan,15,19,2,0,1,10,9,2,0,5,10,0,0
6480bb9e34659755628e7471,2012,,,2,AD Mascarenhas,PP Chawla,15,7,2,1,1,0,0,0,0,15,7,2,1
6480bb9a7d91d721555835e5,2007/08,,,2,SC Ganguly,Salman Butt,15,10,2,0,1,5,3,1,0,7,7,1,0
6480bb9c58b62383739c022e,2009,,,2,RA Jadeja,SD Chitnis,15,16,1,0,1,5,8,0,0,6,8,1,0
6480bb9c44492d9e5fc4bb60,2009/10,,,2,JH Kallis,SP Goswami,15,18,3,0,1,7,8,1,0,8,10,2,0
6480bba11c977a5d11c1aa38,2015,,,2,MA Agarwal,SS Iyer,15,13,2,0,1,1,3,0,0,13,10,2,0
6480bb9f231505ffc493730f,2012,,,1,F du Plessis,M Vijay,15,14,2,0,1,1,3,0,0,14,11,2,0
6480bba286cca051953c976a,2015,,,2,DA Miller,M Vijay,15,15,1,0,1,3,9,0,0,8,6,1,0
6480bb96c95abb10156a6055,2020/21,,,1,JL Pattinson,KA Pollard,15,12,2,0,1,7,5,1,0,7,7,1,0
6480bb95a8153d4daac6e4f7,2019,,,2,F du Plessis,SK Raina,15,14,3,0,1,1,4,0,0,14,10,3,0
6480bb9e300070746cc2eb67,2011,,,2,MA Agarwal,V Kohli,15,11,2,0,1,9,4,2,0,5,7,0,0
6480bb94b9d954a885cc531b,2017,,,1,KH Pandya,RG Sharma,15,17,1,0,1,10,10,1,0,3,7,0,0
6480bba3de527604cd2f96f3,2016,,,2,EJG Morgan,NV Ojha,15,13,0,1,1,11,7,0,1,4,6,0,0
6480bb97d5e3b0911408f222,2020/21,,,1,D Padikkal,V Kohli,15,14,2,0,1,11,9,2,0,4,5,0,0
6480bb9faf20f0bc714af2ea,2013,,,2,DPMD Jayawardene,MC Juneja,15,18,2,0,1,7,9,1,0,8,9,1,0
6480bba3b818a7cff6fe4f89,2016,,,2,G Gambhir,RV Uthappa,15,11,1,0,1,4,4,0,0,11,7,1,0
6480bb9cafc843037dc1e863,2009,,,1,LRPL Taylor,MV Boucher,15,12,0,1,1,9,6,0,1,5,6,0,0
6480bba38056992b92414bab,2016,,,1,C Munro,G Gambhir,15,14,2,0,1,10,8,2,0,5,6,0,0
6480bb9a51ee1ef33a5b2dbb,2007/08,,,2,AB Agarkar,WP Saha,15,7,1,1,0,1,2,0,0,13,5,1,1
6480bb9c44492d9e5fc4bb60,2009/10,,,2,EJG Morgan,JH Kallis,15,10,1,1,1,10,7,0,1,5,3,1,0
6480bb9d80e97e178e5f68de,2011,,,1,JA Morkel,SB Styris,15,4,2,1,0,10,2,1,1,5,2,1,0
6480bb945f95e767a8a9cc10,2017,,,2,BB McCullum,KD Karthik,15,11,2,0,1,6,6,1,0,8,5,1,0
6480bba2c5a614e0fd10cd19,2016,,,2,AD Russell,CA Lynn,15,9,3,0,1,15,7,3,0,0,2,0,0
6480bb93d9581d69657887c3,2017,,,1,Iqbal Abdulla,P Negi,15,15,0,1,1,5,7,0,0,10,8,0,1
6480bba0dcd1149b9b0b501f,2013,,,2,G Gambhir,RN ten Doeschate,15,14,0,0,1,7,8,0,0,4,6,0,0
6480bba17bce347084729c56,2015,,,1,AJ Finch,AP Tare,15,19,1,0,1,8,9,1,0,7,10,0,0
6480bba20130c44ed20c9bcf,2016,,,2,AJ Finch,KD Karthik,15,16,1,0,1,5,5,0,0,9,11,1,0
6480bb9e4bb50b724830b249,2011,,,2,RG Sharma,SR Tendulkar,15,13,1,0,1,10,9,1,0,4,4,0,0
6480bb9754755bb7a7427d52,2021,,,1,PJ Cummins,Shivam Mavi,15,8,1,1,1,9,5,0,1,5,3,1,0
6480bba34d78f594b07da1bc,2016,,,2,KC Cariappa,Sandeep Sharma,15,10,0,1,0,10,5,0,1,5,5,0,0
6480bb9f60d58ee39ba047b9,2013,,,2,A Mishra,DW Steyn,15,10,2,0,0,6,5,1,0,9,5,1,0
6480bb9d86effd7e5e6a5261,2011,,,2,AB de Villiers,CA Pujara,15,10,1,0,1,10,6,1,0,2,4,0,0
6480bb9c3803ef7726af83ab,2009/10,,,2,FY Fazal,NV Ojha,15,12,2,0,1,4,5,0,0,9,7,2,0
6480bb969d80bbba2884b855,2020/21,,,1,JR Philippe,V Kohli,15,11,1,0,1,6,4,1,0,7,7,0,0
6480bb9dd10e35e6145534dc,2011,,,2,NV Ojha,V Sehwag,15,19,2,0,1,7,10,1,0,6,9,1,0
6480bb958e752648ab95362b,2019,,,1,KD Karthik,RV Uthappa,15,13,3,0,1,5,6,1,0,10,7,2,0
6480bba326249b668a4713d6,2016,,,1,G Gambhir,RV Uthappa,15,13,2,0,1,5,6,0,0,10,7,2,0
6480bba0ad06ad631cf7665f,2014,,,1,MS Dhoni,RA Jadeja,15,8,1,1,1,14,7,1,1,1,1,0,0
6480bb96f1eadf803ffc292c,2020/21,,,2,Kartik Tyagi,R Tewatia,15,11,1,1,1,1,2,0,0,12,9,1,1
6480bb9d79d603cc45fc9b3c,2011,,,1,KA Pollard,RG Sharma,15,10,1,1,1,8,5,0,1,7,5,1,0
6480bb9aab9770e7260312df,2007/08,,,1,RG Sharma,Shahid Afridi,15,17,2,0,1,13,10,2,0,2,7,0,0
6480bb98e87e6f83b61088ea,2022,,,1,K Rabada,RD Chahar,15,11,1,1,1,3,3,0,0,12,8,1,1
6480bb9dec749d630afd07d1,2011,,,2,AM Nayar,KD Karthik,15,10,2,0,0,11,5,2,0,3,5,0,0
6480bb98f98edd45b1ccb406,2022,,,1,A Badoni,JO Holder,15,6,0,2,1,2,2,0,0,13,4,0,2
6480bb961570df6942a00888,2019,,,2,AT Rayudu,KM Jadhav,15,15,0,1,1,3,6,0,0,10,9,0,1
6480bb987c720def5fbaf218,2022,,,2,SA Yadav,Tilak Varma,15,12,0,1,1,12,10,0,1,2,2,0,0
6480bb95481ab7c06b86419b,2018,,,2,AD Hales,S Dhawan,15,11,3,0,1,14,10,3,0,1,1,0,0
6480bba3aa840e4e9450a200,2016,,,1,P Negi,Q de Kock,15,19,0,0,1,6,12,0,0,6,7,0,0
6480bb962a1612c936d161ba,2019,,,2,DR Shorey,M Vijay,15,16,0,0,1,5,8,0,0,7,8,0,0
6480bb9efe3f9991539e7f6c,2012,,,2,MN Samuels,SC Ganguly,15,17,2,0,1,2,11,0,0,11,6,2,0
6480bb9f68a0a232d83c338c,2012,,,2,KD Karthik,RG Sharma,15,14,3,0,1,9,8,2,0,5,6,1,0
6480bb93182304739a535742,2017,,,1,DL Chahar,R Bhatia,15,7,0,2,1,13,4,0,2,1,3,0,0
6480bb9809c62ba77e5df472,2021,,,2,KD Karthik,SP Narine,15,18,1,0,1,10,11,1,0,4,7,0,0
6480bb988545a7776b8c9306,2022,,,1,MS Dhoni,S Dube,15,6,0,2,0,0,0,0,0,15,6,0,2
6480bb9f58a3e7ea877fc9dc,2012,,,1,A Mishra,J Theron,15,10,2,0,0,8,5,1,0,7,5,1,0
6480bb9c13fa57328b17e4e2,2009/10,,,2,JM Kemp,SK Raina,15,15,0,1,1,4,8,0,0,10,7,0,1
6480bb9fa1611443840261b7,2012,,,2,AB de Villiers,V Kohli,15,23,0,0,1,4,11,0,0,11,12,0,0
6480bba1abec4894f2f69a35,2014,,,2,AB de Villiers,Yuvraj Singh,15,6,1,1,1,12,5,1,1,1,1,0,0
6480bba0ddcc30675d83403c,2013,,,2,DJG Sammy,X Thalaivan Sargunam,15,12,1,1,1,13,8,1,1,2,4,0,0
6480bb9908b154f78b12b8fb,2023,,,2,KD Karthik,PWH de Silva,15,12,0,1,1,10,8,0,1,5,4,0,0
6480bba2a01f4062fc561247,2016,,,2,G Gambhir,MK Pandey,15,14,1,0,1,12,11,1,0,3,3,0,0
6480bb9b46b4360184dc19f3,2007/08,,,2,DJ Hussey,T Taibu,15,9,1,0,1,5,4,0,0,9,5,1,0
6480bba2c04b3acd88a50839,2015,,,2,AD Mathews,JP Duminy,15,10,2,0,1,6,5,1,0,7,5,1,0
6480bba0ddcc30675d83403c,2013,,,1,CH Morris,MS Dhoni,15,5,2,1,0,0,1,0,0,14,4,2,1
6480bb9a3d3f26063faa9f71,2007/08,,,2,J Arunkumar,MV Boucher,15,8,3,0,1,13,7,3,0,1,1,0,0
6480bb96f1eadf803ffc292c,2020/21,,,2,JC Buttler,YBK Jaiswal,15,15,2,0,1,13,8,2,0,2,7,0,0
6480bb9f60d58ee39ba047b9,2013,,,2,CL White,GH Vihari,15,18,0,1,1,4,8,0,0,11,10,0,1
6480bb957e6d387fe3a6b26e,2018,,,2,AB de Villiers,SN Khan,15,10,2,0,1,2,2,0,0,11,8,2,0
6480bb9cd6fe6fad0d6efbd9,2009/10,,,2,AB de Villiers,KD Karthik,15,15,1,0,1,5,7,0,0,10,8,1,0
6480bba065b341458c934986,2013,,,1,BJ Rohrer,DA Warner,15,6,1,1,0,10,3,0,1,5,3,1,0
6480bba2a215721aadf7a90a,2015,,,2,DJ Hooda,SV Samson,15,14,1,0,1,7,8,0,0,7,6,1,0
6480bba1ece63aa1c77a954e,2015,,,2,BB McCullum,DR Smith,15,14,3,0,1,12,7,3,0,3,7,0,0
6480bb94ca3c1b1eac5e8dd3,2018,,,2,AT Rayudu,SK Raina,15,14,2,0,1,11,8,2,0,4,6,0,0
6480bb9b9d7aa6d8e47576d7,2007/08,,,1,MS Dhoni,S Badrinath,15,5,1,1,0,9,3,0,1,6,2,1,0
6480bb95816d3ad3bc382ab6,2018,,,1,K Gowtham,RA Tripathi,15,6,0,2,1,14,5,0,2,1,1,0,0
6480bb94ca3c1b1eac5e8dd3,2018,,,1,HH Pandya,Ishan Kishan,15,13,2,0,1,13,10,2,0,2,3,0,0
6480bb9908b154f78b12b8fb,2023,,,1,D Wiese,RK Singh,15,6,0,2,0,12,3,0,2,2,3,0,0
6480bb97ea8bfb43e3f7515f,2020/21,,,2,F du Plessis,MS Dhoni,15,10,2,0,1,3,3,0,0,12,7,2,0
6480bb964592640608a9163c,2020/21,,,2,R Parag,SV Samson,15,17,0,0,1,5,7,0,0,7,10,0,0
6480bb97ce981c1918dce924,2021,,,2,Abhishek Sharma,MK Pandey,15,10,2,0,1,8,5,1,0,6,5,1,0
6480bb964752e7c0f9e39d3c,2020/21,,,1,N Rana,Shubman Gill,15,15,2,0,1,5,6,1,0,10,9,1,0
6480bb9fc524f8142f0b3461,2012,,,1,M Manhas,SPD Smith,15,13,1,0,1,11,9,1,0,3,4,0,0
6480bb973d64aa91e60b4088,2021,,,2,JC Buttler,SV Samson,15,12,1,1,1,13,7,1,1,1,5,0,0
6480bb9be2940d96c1f903ca,2007/08,,,2,SP Goswami,V Kohli,15,23,2,0,1,8,14,1,0,7,9,1,0
6480bb984f0f3dc0df6d4531,2022,,,2,DA Miller,R Tewatia,15,11,0,1,1,12,7,0,1,3,4,0,0
6480bb9a2b33e06f46eed54f,2023,,,1,Rahmanullah Gurbaz,VR Iyer,15,11,0,2,1,14,6,0,2,1,5,0,0
6480bb94c2dcb1007bf6788b,2017,,,1,KM Jadhav,Mandeep Singh,15,18,2,0,1,6,6,1,0,9,12,1,0
6480bb9e502d7987de08e5d5,2012,,,1,MN Samuels,RV Uthappa,15,20,1,0,1,2,6,0,0,12,14,1,0
6480bb9dd89d4266d59a4592,2011,,,2,L Ablish,P Kumar,15,8,2,1,0,0,2,0,0,14,6,2,1
6480bb9827e9fb920cf62809,2021,,,1,JJ Roy,KS Williamson,15,21,2,0,1,9,12,2,0,5,9,0,0
6480bb9f955d5c84cde78f58,2012,,,2,AP Majumdar,CJ Ferguson,15,16,3,0,1,8,7,2,0,7,9,1,0
6480bb9574ca455ec008e942,2018,,,2,CA Lynn,KD Karthik,15,11,2,0,1,7,5,1,0,8,6,1,0
6480bb9d69cb9046a72d8fbe,2009/10,,,1,JA Morkel,S Badrinath,15,9,1,1,1,4,4,0,0,11,5,1,1
6480bba2c04b3acd88a50839,2015,,,2,JA Morkel,SS Tiwary,15,6,3,0,0,5,2,1,0,9,4,2,0
6480bb963d224b9be17f2c75,2019,,,2,AM Rahane,SV Samson,15,14,0,1,1,5,5,0,0,8,9,0,1
6480bb942fc9529eb2869c17,2018,,,2,AT Rayudu,RA Jadeja,15,16,0,1,1,11,11,0,1,3,5,0,0
6480bb95430629e254bbc4fd,2018,,,1,RG Sharma,SA Yadav,15,14,1,0,1,11,11,1,0,3,3,0,0
6480bb9b62eb35d78fcd7df0,2007/08,,,2,S Dhawan,TM Dilshan,15,18,2,0,1,7,10,1,0,7,8,1,0
6480bb99fe078839da40e7ab,2023,,,1,JJ Roy,Liton Das,15,12,3,0,1,10,8,2,0,4,4,1,0
6480bb94f27c8167d1685878,2017,,,2,AJ Finch,KD Karthik,15,5,2,1,1,4,1,1,0,11,4,1,1
6480bb97668d35800fa74139,2021,,,1,KL Rahul,MA Agarwal,15,19,1,0,1,4,6,0,0,11,13,1,0
6480bb970c637fd0c057dca9,2021,,,2,KS Williamson,V Shankar,15,16,1,0,1,7,8,0,0,8,8,1,0
6480bb9f7bae5ad85c4473ba,2012,,,1,DR Smith,RP Singh,15,4,2,1,0,14,3,2,1,1,1,0,0
6480bba031c5cf0145ae8cfe,2014,,,1,SPD Smith,SV Samson,15,8,1,1,1,6,3,1,0,9,5,0,1
6480bb932f8447acd7840076,2017,,,2,KD Karthik,SK Raina,15,16,1,0,1,11,10,1,0,4,6,0,0
6480bb9e05381e16815803e9,2011,,,2,MK Pandey,Yuvraj Singh,15,14,2,0,1,5,7,0,0,10,7,2,0
6480bba0ddcc30675d83403c,2013,,,1,MS Dhoni,RA Jadeja,15,9,1,1,1,14,5,1,1,1,4,0,0
6480bb96c3293977af83acbf,2019,,,2,AR Patel,RR Pant,15,5,0,2,0,1,1,0,0,14,4,0,2
6480bb93182304739a535742,2017,,,1,F du Plessis,RA Tripathi,15,6,3,0,1,4,1,1,0,10,5,2,0
6480bb9d867c041656e9a75f,2009/10,,,2,MD Mishra,RG Sharma,15,14,2,0,1,3,5,0,0,11,9,2,0
6480bb976344f6d667dfd965,2021,,,2,RA Tripathi,Shubman Gill,15,8,1,1,1,9,5,0,1,6,3,1,0
6480bb94605dacb25c83dc35,2018,,,2,DT Christian,SS Iyer,15,23,1,0,1,6,11,0,0,9,12,1,0
6480bba04b49d2ff5f997e02,2013,,,2,B Chipli,V Sehwag,15,15,2,0,1,4,5,0,0,11,10,2,0
6480bb99864a94e086c8395e,2022,,,2,JJ Bumrah,Ramandeep Singh,15,10,1,1,0,0,4,0,0,14,6,1,1
6480bb9a21e416835389fd53,2023,,,1,DP Conway,MS Dhoni,15,5,0,2,0,1,1,0,0,13,4,0,2
6480bb9b1fc007965b68d4d9,2009,,,2,AM Nayar,DJ Bravo,15,11,0,1,1,10,6,0,1,5,5,0,0
6480bb99f47261f111a6cc1a,2023,,,2,Arjun Tendulkar,JP Behrendorff,15,12,0,1,1,12,8,0,1,3,4,0,0
6480bb9c9f9d5376b4227724,2009/10,,,1,CH Gayle,SC Ganguly,15,14,3,0,1,4,7,1,0,10,7,2,0
6480bb933fdc96ee7273400e,2017,,,2,KH Pandya,N Rana,15,13,0,1,1,3,5,0,0,10,8,0,1
6480bb9dec749d630afd07d1,2011,,,2,AM Nayar,PC Valthaty,15,12,1,1,1,2,5,0,0,12,7,1,1
6480bba373508e4f3f4be6c0,2016,,,2,MS Dhoni,NLTC Perera,15,15,0,1,1,2,4,0,0,13,11,0,1
6480bb9ea75f51e7a33e90ed,2012,,,1,S Badrinath,SK Raina,15,13,2,0,1,7,5,1,0,8,8,1,0
6480bba2a215721aadf7a90a,2015,,,2,KK Nair,SR Watson,15,14,2,0,1,8,7,1,0,7,7,1,0
6480bb9bfcaabf33b5687e32,2007/08,,,1,SA Asnodkar,SR Watson,15,12,2,0,1,7,7,1,0,6,5,1,0
6480bb9ae4498012aa089436,2023,,,2,AD Russell,N Rana,15,8,1,0,0,2,2,0,0,7,6,1,0
6480bb96a467817b9b68ca94,2020/21,,,1,DL Chahar,RA Jadeja,15,5,1,1,0,2,2,0,0,12,3,1,1
6480bb966539f85263cb6429,2019,,,1,MS Dhoni,SK Raina,15,8,2,1,1,0,2,0,0,15,6,2,1
6480bb99433f6e11060ba714,2022,,,2,PBB Rajapaksa,S Dhawan,15,11,3,0,1,4,5,1,0,10,6,2,0
6480bb94704f6dfeb7f4d270,2017,,,1,SE Marsh,WP Saha,15,16,2,0,1,10,7,2,0,4,9,0,0
6480bb9dd778cb6c44535092,2009/10,,,2,AT Rayudu,STR Binny,15,8,1,1,1,7,3,0,1,8,5,1,0
6480bb99bb362e3714226928,2022,,,2,KL Rahul,Q de Kock,15,13,1,0,1,2,5,0,0,7,8,1,0
6480bb9d54ae15d3d0ed9e5e,2011,,,1,DPMD Jayawardene,RA Jadeja,15,17,1,0,1,6,6,0,0,8,11,1,0
6480bb9b62eb35d78fcd7df0,2007/08,,,2,AB de Villiers,G Gambhir,15,14,2,0,1,6,8,0,0,9,6,2,0
6480bb99350726d00af209bf,2022,,,2,J Suchith,RA Tripathi,15,13,0,1,1,2,7,0,0,11,6,0,1
6480bb95ff5da0069bc5274e,2018,,,1,JPR Scantlebury-Searles,Shubman Gill,15,4,2,1,0,6,1,0,1,9,3,2,0
6480bb971c9e4a3ef11759f3,2021,,,1,MC Henriques,N Pooran,15,11,1,1,1,2,3,0,0,13,8,1,1
6480bb9af85f41b4de44ca19,2023,,,2,Mohammed Shami,Noor Ahmad,15,9,2,0,1,5,5,1,0,7,4,1,0
6480bb9e95693a2c4c4531e8,2011,,,1,DJ Hussey,KD Karthik,15,13,1,0,1,3,4,0,0,9,9,1,0
6480bb96ec7d98e34055e8fc,2020/21,,,1,RV Uthappa,SPD Smith,15,13,0,1,1,5,9,0,0,9,4,0,1
6480bb987c52e15a2cac0697,2022,,,1,JM Bairstow,LS Livingstone,15,9,2,1,1,1,3,0,0,14,6,2,1
6480bb9e95693a2c4c4531e8,2011,,,2,DA Warner,Y Venugopal Rao,15,11,3,0,1,14,9,3,0,1,2,0,0
6480bb9f9eae77e599a46300,2012,,,1,DR Smith,KD Karthik,15,10,2,0,1,2,2,0,0,13,8,2,0
6480bb95a09b947e0837a38a,2019,,,1,DA Miller,KL Rahul,15,13,1,0,1,7,8,1,0,7,5,0,0
6480bb9e6d7f7f691dde322d,2012,,,2,JP Duminy,S Dhawan,15,18,1,0,1,5,9,0,0,9,9,1,0
6480bb9fe7d0f611ba6ad229,2012,,,2,TM Dilshan,V Kohli,15,18,2,0,1,6,6,1,0,9,12,1,0
6480bb93d9581d69657887c3,2017,,,1,Mandeep Singh,SR Watson,15,15,3,0,1,12,10,3,0,2,5,0,0
6480bb9e88141830a7a309b5,2011,,,1,Harbhajan Singh,JEC Franklin,15,8,1,1,0,11,5,1,1,4,3,0,0
6480bba1670ace74604a420f,2015,,,2,CM Gautam,MA Agarwal,15,15,1,1,1,4,5,0,0,11,10,1,1
6480bb94f1c027945eeb8b10,2017,,,2,PA Patel,RG Sharma,14,12,1,0,1,13,8,1,0,1,4,0,0
6480bb9a81d7fd0ac0307b4d,2023,,,1,HR Shokeen,N Wadhera,14,7,2,1,1,0,1,0,0,14,6,2,1
6480bb9e05571c1a4c163ef1,2012,,,2,OA Shah,R Dravid,14,20,1,1,1,8,10,0,1,6,10,1,0
6480bb9809c62ba77e5df472,2021,,,1,DT Christian,Shahbaz Ahmed,14,14,1,0,1,8,7,1,0,6,7,0,0
6480bb9b69f390d624466843,2007/08,,,1,Mohammad Hafeez,Salman Butt,14,15,2,0,1,6,6,1,0,6,9,1,0
6480bba15b304732a6212cdf,2015,,,2,KS Williamson,Parvez Rasool,14,6,1,1,0,12,4,1,1,2,2,0,0
6480bba1af9481df8b4f9f0f,2015,,,2,CH Gayle,SA Abbott,14,9,1,1,1,13,5,1,1,1,4,0,0
6480bb967c50ceac62ba0719,2020/21,,,2,KA Pollard,KH Pandya,14,13,2,0,0,2,6,0,0,12,7,2,0
6480bb95f2e3c32afe233820,2018,,,2,AB de Villiers,V Kohli,14,16,1,0,1,5,6,0,0,8,10,1,0
6480bb950c59218964b27cc0,2018,,,2,CH Gayle,KL Rahul,14,12,1,1,1,1,1,0,0,12,11,1,1
6480bba16af3f513920ef499,2015,,,2,MK Pandey,RV Uthappa,14,13,0,1,1,8,6,0,1,5,7,0,0
6480bb98adf21699eaa67796,2022,,,2,D Pretorius,Simarjeet Singh,14,7,1,1,1,12,5,1,1,2,2,0,0
6480bb9774dd8e44bbeeb5a4,2021,,,1,CJ Jordan,MA Agarwal,14,10,0,1,1,2,3,0,0,12,7,0,1
6480bb9edbd8851db7e06741,2012,,,1,BJ Hodge,OA Shah,14,12,0,1,1,10,6,0,1,4,6,0,0
6480bba2bae80e615447f251,2015,,,2,D Wiese,SN Khan,14,15,1,0,1,5,7,0,0,8,8,1,0
6480bb9cd6fe6fad0d6efbd9,2009/10,,,1,GC Smith,SA Asnodkar,14,8,3,0,1,8,4,2,0,5,4,1,0
6480bb99358a21ba3487db81,2023,,,2,KL Rahul,MP Stoinis,14,11,2,0,1,1,2,0,0,8,9,2,0
6480bb9a43249ece8e841e56,2023,,,1,KM Jadhav,PWH de Silva,14,11,2,0,0,2,3,0,0,12,8,2,0
6480bb9d79d603cc45fc9b3c,2011,,,1,DJ Jacobs,SR Tendulkar,14,15,2,0,1,10,10,2,0,2,5,0,0
6480bb985efffbcafdef9f19,2021,,,1,SV Samson,YBK Jaiswal,14,10,1,1,1,4,5,0,0,10,5,1,1
6480bb9c620c92d09ba1b6b9,2009,,,2,LA Carseldine,SA Asnodkar,14,16,2,0,1,8,11,1,0,4,5,1,0
6480bba33195e5ebac1da82a,2016,,,1,JC Buttler,KA Pollard,14,17,1,0,1,6,5,1,0,4,12,0,0
6480bb9b2a5f2fd5053534dc,2007/08,,,2,LA Pomersbach,Yuvraj Singh,14,12,1,0,1,2,6,0,0,7,6,1,0
6480bb9a07d46704efe103ef,2007/08,,,1,RG Sharma,Y Venugopal Rao,14,11,1,0,1,10,9,1,0,2,2,0,0
6480bb9b5d0191a0a2611916,2009,,,2,RJ Quiney,YK Pathan,14,14,3,0,1,6,7,1,0,8,7,2,0
6480bba0c7bf2b92ac8d836a,2013,,,1,JH Kallis,MS Bisla,14,10,0,0,1,5,4,0,0,3,6,0,0
6480bb9439fcd1191cf17a90,2017,,,2,MM Sharma,WP Saha,14,8,0,1,1,4,3,0,0,10,5,0,1
6480bba2f3ed8323f852acfa,2016,,,2,M Vijay,M Vohra,14,13,1,1,1,2,3,0,0,12,10,1,1
6480bb994aafcf67cd092a7d,2023,,,2,B Sai Sudharsan,Shubman Gill,14,13,2,0,1,7,6,1,0,6,7,1,0
6480bba1d21281c7385d5ce4,2014,,,2,MG Johnson,WP Saha,14,8,0,1,1,10,5,0,1,4,3,0,0
6480bb9ab655ac367694708c,2007/08,,,2,M Rawat,RA Jadeja,14,10,1,1,1,2,4,0,0,12,6,1,1
6480bb95f37ebb69ffb216e0,2019,,,1,KD Karthik,PP Chawla,14,5,0,2,1,6,3,0,1,7,2,0,1
6480bb98bd3ca4df44cf9d8f,2022,,,2,AR Patel,SN Thakur,14,10,0,1,1,3,3,0,0,10,7,0,1
6480bb9bee2e48d9c41b1e23,2009,,,2,RJ Harris,TL Suman,14,12,2,0,1,1,4,0,0,13,8,2,0
6480bb982f070b023b901b3e,2021,,,2,PP Shaw,S Dhawan,14,12,1,1,1,6,5,1,0,8,7,0,1
6480bb94c2dcb1007bf6788b,2017,,,1,AB de Villiers,Mandeep Singh,14,12,2,1,1,10,6,1,1,4,6,1,0
6480bb95b1f28cf5bcf5e167,2018,,,1,MK Pandey,Shakib Al Hasan,14,14,2,0,1,2,4,0,0,12,10,2,0
6480bb9bf2869505c9393b7d,2009,,,2,BJ Hodge,LR Shukla,14,10,1,1,1,6,4,1,0,8,6,0,1
6480bb99efa58b95852be382,2023,,,1,DP Conway,RD Gaikwad,14,14,2,0,1,1,6,0,0,12,8,2,0
6480bb9ab655ac367694708c,2007/08,,,2,M Kaif,SR Watson,14,15,2,0,1,1,6,0,0,12,9,2,0
6480bba163bd0c619365a16b,2015,,,2,KA Pollard,RG Sharma,14,12,0,1,1,10,8,0,1,4,4,0,0
6480bb97c92184fed1a879f3,2021,,,1,Abhishek Sharma,JJ Roy,14,11,1,1,1,13,10,1,1,1,1,0,0
6480bb9cc5312f3d7cfb650e,2009/10,,,2,CL White,KP Pietersen,14,7,2,0,0,6,3,1,0,7,4,1,0
6480bb9d967f5a4cfbd8c74d,2011,,,1,DA Warner,V Sehwag,14,12,2,0,1,2,6,0,0,11,6,2,0
6480bb9d867c041656e9a75f,2009/10,,,1,A Mishra,PD Collingwood,14,14,0,1,1,4,9,0,0,9,5,0,1
6480bb9da398a7c3c645732c,2011,,,1,J Botha,R Dravid,14,17,1,0,1,8,10,1,0,6,7,0,0
6480bb989bf19eb260a04f0e,2022,,,1,SS Iyer,VR Iyer,14,17,2,0,1,9,7,1,0,4,10,1,0
6480bba388682c5ca10ff37a,2016,,,1,CJ Jordan,Sachin Baby,14,8,0,1,1,3,4,0,0,10,4,0,1
6480bba11a59d64bb4aa66f4,2014,,,2,STR Binny,SV Samson,14,17,0,0,1,7,10,0,0,6,7,0,0
6480bb9a9514379c05d59c38,2023,,,2,Ishan Kishan,RG Sharma,14,12,2,0,1,9,7,2,0,3,5,0,0
6480bb9aa64355ce98da1141,2007/08,,,1,JH Kallis,V Kohli,14,16,2,0,1,0,3,0,0,12,13,2,0
6480bb99773871f8e2ddc4b1,2022,,,1,Abhishek Sharma,PK Garg,14,16,2,0,1,10,9,2,0,4,7,0,0
6480bb991a4f7e5f59dd1afc,2023,,,2,AD Russell,N Rana,14,12,0,1,1,3,6,0,0,8,6,0,1
6480bb964a4d5a1709db428e,2020/21,,,1,Ishan Kishan,Q de Kock,14,10,1,0,1,7,7,1,0,7,3,0,0
6480bb9ed6aefcc9cd13d851,2012,,,2,M Manhas,SPD Smith,14,6,0,2,1,7,4,0,1,7,2,0,1
6480bb9f6b144f2a6d105b32,2013,,,2,KD Karthik,RT Ponting,14,15,1,0,1,10,9,1,0,3,6,0,0
6480bba0f401cc6b6bc6ed10,2013,,,2,BB Samantray,KV Sharma,14,9,2,0,1,13,8,2,0,1,1,0,0
6480bb9dd10e35e6145534dc,2011,,,1,DT Christian,I Malhotra,14,10,1,0,0,7,6,0,0,7,4,1,0
6480bba0e883438915efc1e6,2013,,,1,SPD Smith,Yuvraj Singh,14,9,3,0,1,9,5,2,0,5,4,1,0
6480bb9dfa7d0510ae3a7b40,2011,,,2,S Dhawan,S Sohal,14,9,3,0,1,8,5,2,0,6,4,1,0
6480bb9c50838010977c168c,2009,,,1,S Badrinath,SK Raina,14,16,1,0,1,4,9,0,0,8,7,1,0
6480bba35038a60ea566794a,2016,,,2,DA Warner,DJ Hooda,14,17,1,0,1,10,8,1,0,4,9,0,0
6480bb973da000031d26fbba,2021,,,1,DJ Hooda,Harpreet Brar,14,20,0,0,1,3,5,0,0,8,15,0,0
6480bb9d038ed22e46cbeccb,2011,,,1,S Dhawan,S Sohal,14,11,2,0,1,9,8,2,0,5,3,0,0
6480bb98d2cd0fa3ed0ffc21,2022,,,2,AM Rahane,VR Iyer,14,12,3,0,1,12,11,3,0,1,1,0,0
6480bb98cbaaf700d226941a,2022,,,2,KA Pollard,Tilak Varma,14,8,1,1,1,0,2,0,0,12,6,1,1
6480bb9f00ef088221497043,2013,,,2,MEK Hussey,MS Dhoni,14,15,0,0,1,5,8,0,0,9,7,0,0
6480bb977f55a1c473670850,2021,,,1,E Lewis,SV Samson,14,11,2,0,1,10,6,2,0,3,5,0,0
6480bba2a01f4062fc561247,2016,,,1,AR Patel,SE Marsh,14,13,0,0,1,9,8,0,0,5,5,0,0
6480bb9b82dc3ec84c520466,2009,,,1,MK Pandey,MV Boucher,14,6,2,0,0,2,2,0,0,12,4,2,0
6480bb99409885bcc7b67109,2023,,,1,Dhruv Jurel,SO Hetmyer,14,14,1,0,1,8,6,1,0,5,8,0,0
6480bba0b2a9d600114a43d7,2013,,,2,KD Karthik,RG Sharma,14,17,1,1,1,10,12,1,1,4,5,0,0
6480bb9affabe4960a987464,2007/08,,,1,CL White,MV Boucher,14,15,1,0,1,4,6,0,0,7,9,1,0
6480bb9d79d603cc45fc9b3c,2011,,,1,A Symonds,RG Sharma,14,11,2,0,1,3,5,0,0,11,6,2,0
6480bb987c52e15a2cac0697,2022,,,2,Abhishek Sharma,KS Williamson,14,19,2,0,1,11,10,2,0,3,9,0,0
6480bba0208e8fbb34afdc50,2013,,,2,AC Gilchrist,R Sathish,14,8,1,1,0,2,2,0,0,12,6,1,1
6480bb97746881ab34c38bf8,2020/21,,,2,Q de Kock,RG Sharma,14,10,1,1,1,5,2,1,0,8,8,0,1
6480bb9c8c6c106c6ffbeae4,2009/10,,,1,MK Pandey,RV Uthappa,14,8,1,1,1,1,2,0,0,13,6,1,1
6480bb98aae066234fd8f11e,2022,,,2,Kuldeep Yadav,Mustafizur Rahman,14,15,0,1,0,11,10,0,1,3,5,0,0
6480bb96e8ba017befb2bc8a,2020/21,,,1,PP Shaw,SS Iyer,14,15,3,0,1,9,10,2,0,4,5,1,0
6480bba265483f7db002ec7c,2015,,,2,A Ashish Reddy,KV Sharma,14,4,0,2,0,13,3,0,2,1,1,0,0
6480bb988545a7776b8c9306,2022,,,2,Anuj Rawat,F du Plessis,14,17,0,0,1,6,8,0,0,8,9,0,0
6480bb958f737f809dfb65e1,2019,,,1,PP Shaw,S Dhawan,14,14,2,0,1,11,11,2,0,3,3,0,0
6480bba2f05e90a9005771d2,2015,,,2,BB McCullum,DR Smith,14,11,3,0,1,12,5,3,0,1,6,0,0
6480bb93f866249511c76dbc,2017,,,2,MK Tiwary,MS Dhoni,14,13,1,0,1,8,5,1,0,5,8,0,0
6480bb974086cbea889134af,2021,,,1,RA Jadeja,SK Raina,14,8,2,0,1,10,5,2,0,3,3,0,0
6480bb9aa37f3b44678752d9,2023,,,2,Shubman Gill,V Shankar,14,8,3,0,1,0,2,0,0,14,6,3,0
6480bb9f210b6e50fb2072ae,2013,,,2,R Bhatia,R McLaren,14,8,2,0,1,12,5,2,0,2,3,0,0
6480bb99f33a7dd80eb0a544,2023,,,2,JM Sharma,M Shahrukh Khan,14,5,0,2,1,13,4,0,2,1,1,0,0
6480bb9eda28fb340ed37b49,2012,,,1,CL White,S Dhawan,14,16,1,0,1,10,9,1,0,4,7,0,0
6480bb995193664eda3e9e10,2022,,,2,Ishan Kishan,TH David,14,11,3,0,1,1,2,0,0,13,9,3,0
6480bb9a9801c2dda3fe88e9,2007/08,,,1,IK Pathan,Yuvraj Singh,14,9,2,0,1,10,7,2,0,2,2,0,0
6480bba0dcd1149b9b0b501f,2013,,,1,AD Mathews,RV Uthappa,14,22,0,0,1,5,10,0,0,9,12,0,0
6480bb96e76ccde6082d7564,2020/21,,,1,KD Karthik,PJ Cummins,14,10,1,0,1,5,6,1,0,5,4,0,0
6480bb9fcb2b412c0ebd4afa,2013,,,2,TM Dilshan,V Kohli,14,15,1,0,1,3,4,0,0,9,11,1,0
6480bb9e300070746cc2eb67,2011,,,2,LA Pomersbach,V Kohli,14,12,0,1,1,2,3,0,0,12,9,0,1
6480bb9740aaba2132c0eb0e,2021,,,2,AB de Villiers,GJ Maxwell,14,15,1,0,1,2,5,0,0,12,10,1,0
6480bba15b304732a6212cdf,2015,,,2,KS Williamson,KV Sharma,14,14,0,0,1,8,8,0,0,4,6,0,0
6480bb9a43249ece8e841e56,2023,,,1,Anuj Rawat,F du Plessis,14,9,3,0,1,6,4,1,0,8,5,2,0
6480bb9561509a2f4f139254,2019,,,2,K Gowtham,S Gopal,14,8,2,0,0,0,1,0,0,13,7,2,0
6480bb9f59fd8000010baf09,2013,,,1,R Rampaul,R Vinay Kumar,14,8,0,1,0,12,7,0,1,1,1,0,0
6480bb97cca23939859c422e,2021,,,1,MP Stoinis,SPD Smith,14,6,1,1,0,2,2,0,0,11,4,1,1
6480bb9a58bc8710c38f4c1c,2023,,,2,TH David,Vishnu Vinod,14,10,0,1,1,8,6,0,1,2,4,0,0
6480bba280f09c38002cf14b,2015,,,1,SA Yadav,YK Pathan,14,12,1,1,1,5,5,1,0,9,7,0,1
6480bb9936b7698da2c2030c,2023,,,2,DP Conway,S Dube,14,13,1,0,1,4,4,0,0,8,9,1,0
6480bb98cce4ab46512c2c03,2022,,,1,MS Dhoni,RA Jadeja,14,6,2,1,1,10,4,1,1,4,2,1,0
6480bb9a6e44b0c8da00ca72,2007/08,,,1,KC Sangakkara,RR Sarwan,14,17,0,0,1,7,8,0,0,7,9,0,0
6480bb9b7557e68b433167d5,2007/08,,,1,PA Patel,SP Fleming,14,10,1,1,1,5,6,1,0,7,4,0,1
6480bb9ee4565d108b29626f,2012,,,1,MS Dhoni,SK Raina,14,17,0,0,1,8,9,0,0,6,8,0,0
6480bb958f737f809dfb65e1,2019,,,1,CA Ingram,SS Iyer,14,16,1,0,1,5,8,0,0,8,8,1,0
6480bb9b3a5e1af467fb027b,2009,,,2,A Flintoff,JA Morkel,14,6,1,1,1,8,3,0,1,5,3,1,0
6480bba119569fcc2d7859a4,2014,,,2,MA Starc,S Rana,14,11,2,0,1,6,6,1,0,8,5,1,0
6480bb9800ba03eb1f9437d2,2022,,,1,AK Markram,Washington Sundar,14,9,0,1,1,11,6,0,1,3,3,0,0
6480bb9ee4565d108b29626f,2012,,,2,BB McCullum,G Gambhir,14,17,2,0,1,2,8,0,0,11,9,2,0
6480bb9d59f2ded94f736145,2011,,,2,B Chipli,KC Sangakkara,14,20,1,0,1,4,9,0,0,7,11,1,0
6480bb9d22388e966342dba8,2009/10,,,2,AT Rayudu,JP Duminy,14,13,0,0,1,7,6,0,0,6,7,0,0
6480bb98b8bb5b0d2c2f0848,2022,,,2,AT Rayudu,RA Jadeja,14,12,1,0,1,10,7,1,0,3,5,0,0
6480bb9a6e44b0c8da00ca72,2007/08,,,2,L Ronchi,ST Jayasuriya,14,15,1,1,1,11,8,1,1,1,7,0,0
6480bba1743abcb135a6a4c7,2015,,,1,GJ Maxwell,M Vijay,14,12,2,0,1,7,5,1,0,7,7,1,0
6480bb9825eb960aded1ff64,2022,,,2,A Manohar,WP Saha,14,14,2,0,1,12,12,2,0,2,2,0,0
6480bb9d76ba2d9dd45c74a8,2011,,,2,BJ Hodge,PA Patel,14,21,1,0,1,8,14,0,0,5,7,1,0
6480bb931e6d2b03141b586d,2017,,,2,G Gambhir,RV Uthappa,14,7,3,0,1,10,5,2,0,4,2,1,0
6480bb9929c7e430acd1ef18,2022,,,2,Kuldeep Yadav,SN Thakur,14,27,0,0,1,5,17,0,0,6,10,0,0
6480bba38ce35716815a1845,2016,,,1,G Gambhir,RV Uthappa,14,14,2,0,1,12,10,2,0,2,4,0,0
6480bb98adf21699eaa67796,2022,,,1,GJ Maxwell,V Kohli,14,10,1,0,1,3,3,0,0,7,7,1,0
6480bb931e6d2b03141b586d,2017,,,1,CH Morris,PJ Cummins,14,10,2,0,1,11,6,2,0,3,4,0,0
6480bb96e8ba017befb2bc8a,2020/21,,,1,K Rabada,P Dubey,14,11,0,1,1,12,7,0,1,2,4,0,0
6480bb9b46b4360184dc19f3,2007/08,,,2,DJ Hussey,LR Shukla,14,3,2,0,0,0,0,0,0,14,3,2,0
6480bb95fa6394e733c532a9,2018,,,1,CR Brathwaite,MK Pandey,14,11,0,1,1,3,4,0,0,9,7,0,1
6480bb99c26e725b7b6f1637,2023,,,1,DJ Hooda,KR Mayers,14,10,2,0,1,2,4,0,0,12,6,2,0
6480bba3b830360cf7031278,2016,,,1,Harbhajan Singh,JJ Bumrah,14,15,2,0,1,6,6,1,0,6,9,1,0
6480bb98f98edd45b1ccb406,2022,,,2,SP Narine,Shivam Mavi,14,9,2,0,1,12,7,2,0,1,2,0,0
6480bb9edd901481f13ce9ba,2012,,,1,Azhar Mahmood,PP Chawla,14,5,1,1,0,7,2,0,1,7,3,1,0
6480bba0b2a9d600114a43d7,2013,,,1,AM Nayar,KW Richardson,14,22,0,0,1,5,6,0,0,8,16,0,0
6480bba29fb420d92aef1d2a,2015,,,2,B Kumar,P Kumar,14,11,1,1,1,11,3,1,1,3,8,0,0
6480bb9f36da1a646c80be45,2013,,,2,A Nehra,M Morkel,14,9,3,0,1,1,5,0,0,13,4,3,0
6480bb99e909d98c8193bac5,2023,,,2,Abdul Samad,B Kumar,14,23,0,0,1,8,13,0,0,6,10,0,0
6480bb993e44f97eccb361fe,2023,,,2,Harpreet Brar,M Shahrukh Khan,14,6,1,1,1,6,4,1,0,7,2,0,1
6480bb9bca2c11520f5b3b9e,2007/08,,,2,RR Powar,S Sreesanth,14,6,3,0,0,12,4,3,0,0,2,0,0
6480bb9a0474602f26069e45,2007/08,,,1,GC Smith,YK Pathan,14,11,0,1,1,4,6,0,0,8,5,0,1
6480bb97aed297ca9686c94a,2021,,,1,M Shahrukh Khan,Mohammed Shami,14,14,1,0,1,8,7,1,0,4,7,0,0
6480bb9ec90f99c5ea40b014,2012,,,1,MK Tiwary,Shakib Al Hasan,14,10,1,0,1,10,7,1,0,4,3,0,0
6480bb9618b5973b98c0ba18,2019,,,1,MJ Guptill,MK Pandey,14,17,2,0,1,5,7,1,0,9,10,1,0
6480bba2db1e2def1b597ed3,2015,,,2,Anureet Singh,SN Thakur,14,8,1,1,0,8,3,0,1,6,5,1,0
6480bb9f3700dfaa08e18c43,2012,,,1,AC Gilchrist,DJ Hussey,14,12,2,0,1,4,3,1,0,9,9,1,0
6480bba0da054e3d917f71fb,2013,,,1,AM Rahane,R Dravid,14,19,2,0,1,9,10,1,0,5,9,1,0
6480bb9c8c6c106c6ffbeae4,2009/10,,,2,AB de Villiers,V Sehwag,14,11,1,0,1,12,6,1,0,2,5,0,0
6480bb9c50838010977c168c,2009,,,1,PA Patel,SK Raina,14,12,2,0,1,7,6,1,0,7,6,1,0
6480bb9a9801c2dda3fe88e9,2007/08,,,2,MF Maharoof,MK Tiwary,14,8,2,0,1,5,4,0,0,9,4,2,0
6480bba278153a5979e31ec9,2016,,,2,DJ Bravo,SK Raina,14,12,1,0,1,7,6,1,0,6,6,0,0
6480bb9e56c724ba25b94666,2011,,,2,Harbhajan Singh,KA Pollard,14,9,1,1,1,12,7,1,1,2,2,0,0
6480bba133267f04941acf7d,2014,,,1,AJ Finch,S Dhawan,14,9,2,0,1,8,8,1,0,4,1,1,0
6480bb9822eeb0c1c117f221,2021,,,1,PP Shaw,SS Iyer,14,13,0,2,1,13,5,0,2,1,8,0,0
6480bba1568e0f3990191600,2014,,,1,AB de Villiers,JA Morkel,14,4,0,2,1,14,4,0,2,0,0,0,0
6480bb9996eb97dd08b62f78,2023,,,1,F du Plessis,KD Karthik,14,7,0,2,1,13,5,0,2,1,2,0,0
6480bba2ad3f26917361061f,2016,,,1,D Wiese,KM Jadhav,14,11,1,0,0,5,4,0,0,7,7,1,0
6480bb93d9581d69657887c3,2017,,,2,A Mishra,RR Pant,14,17,0,1,1,6,12,0,0,8,5,0,1
6480bb9516b0dbc1972e5c3c,2018,,,2,H Klaasen,K Gowtham,14,12,1,0,0,5,5,0,0,9,7,1,0
6480bba296f606ef91305124,2016,,,1,DJ Hooda,EJG Morgan,14,22,0,0,1,6,11,0,0,7,11,0,0
6480bba1551dc12c8f2a7038,2014,,,1,M Vijay,Q de Kock,14,15,2,0,1,4,6,0,0,10,9,2,0
6480bb9d867c041656e9a75f,2009/10,,,1,G Gambhir,M Manhas,14,16,2,0,1,3,8,0,0,11,8,2,0
6480bb9ab34d149420eae546,2023,,,1,KS Sharma,Q de Kock,14,15,0,1,1,3,5,0,0,11,10,0,1
6480bb9ba6cd609c32579bde,2009,,,2,AM Nayar,SR Tendulkar,14,12,1,1,1,1,2,0,0,12,10,1,1
6480bba071a7a0cbb02d505a,2013,,,1,DA Warner,IK Pathan,14,16,1,0,1,5,6,1,0,7,10,0,0
6480bb95833c06e6c5119173,2019,,,2,AD Russell,KD Karthik,14,8,1,1,1,1,2,0,0,11,6,1,1
6480bb99b35dc0981e512451,2022,,,2,MS Wade,Shubman Gill,14,17,0,1,1,8,10,0,1,1,7,0,0
6480bba2e3610f863b52b887,2016,,,2,MS Dhoni,SPD Smith,14,11,2,0,1,5,4,1,0,8,7,1,0
6480bb96686655f09172741d,2020/21,,,1,S Dhawan,SS Iyer,14,18,1,0,1,7,11,0,0,7,7,1,0
6480bb9d86effd7e5e6a5261,2011,,,2,MA Agarwal,V Kohli,14,21,2,0,1,5,11,1,0,9,10,1,0
6480bb94566b0cf89fca84f9,2018,,,1,F du Plessis,SR Watson,14,21,0,1,1,4,6,0,0,9,15,0,1
6480bba1017a98eead1ec861,2015,,,2,AR Patel,DA Miller,14,5,0,2,1,1,1,0,0,13,4,0,2
6480bb96d1b3bea0aa2127e4,2020/21,,,2,SP Narine,Shubman Gill,14,16,1,1,1,7,5,0,1,7,11,1,0
6480bb9ab34d149420eae546,2023,,,1,K Gowtham,Naveen-ul-Haq,14,7,1,1,0,11,4,1,1,2,3,0,0
6480bb981b01a21305fd65d5,2022,,,1,AS Joseph,B Sai Sudharsan,14,11,1,0,0,4,5,0,0,8,6,1,0
6480bb99b3179a9346d8883c,2022,,,1,HE van der Dussen,TA Boult,14,11,1,0,0,9,8,1,0,3,3,0,0
6480bb9d9f4551d7ec79c951,2009/10,,,2,M Vijay,SK Raina,14,7,3,0,1,5,2,1,0,8,5,2,0
6480bba2b341a081c069198d,2015,,,2,AM Rahane,SR Watson,14,12,2,0,1,4,7,0,0,10,5,2,0
6480bb9c5ec0713155cad138,2009/10,,,1,A Symonds,RG Sharma,14,11,1,0,1,4,7,0,0,6,4,1,0
6480bb95c28e7980e1768064,2018,,,1,MS Dhoni,SK Raina,14,9,0,0,1,7,4,0,0,4,5,0,0
6480bb99bb362e3714226928,2022,,,2,DJ Hooda,KL Rahul,14,19,1,1,1,6,5,1,0,8,14,0,1
6480bb9b2e179d359c1d446d,2009,,,2,G Gambhir,TM Dilshan,14,11,3,0,1,8,5,2,0,4,6,1,0
6480bba250b404cdcbff22c8,2015,,,1,MM Sharma,R Ashwin,14,8,0,1,1,2,2,0,0,11,6,0,1
6480bb9eb14c6138aebfbf98,2012,,,1,AD Mascarenhas,P Dogra,14,15,1,0,1,9,10,1,0,5,5,0,0
6480bb96f8379d02d3435ceb,2020/21,,,1,AD Russell,RA Tripathi,14,8,1,1,1,2,4,0,0,12,4,1,1
6480bba31cc11024436836b5,2016,,,2,Q de Kock,SV Samson,14,19,1,0,1,8,8,1,0,6,11,0,0
6480bb9a1a3e8cef5633f4e6,2023,,,1,AK Markram,Sanvir Singh,14,6,1,1,0,9,3,0,1,4,3,1,0
6480bb97372fc5d5ef4c436a,2021,,,2,CH Morris,DA Miller,14,6,0,2,1,1,2,0,0,13,4,0,2
6480bb9f014bd6e0ac2b51a8,2013,,,1,DA Warner,V Sehwag,14,8,2,0,0,7,5,1,0,5,3,1,0
6480bb99fe078839da40e7ab,2023,,,1,JJ Roy,RK Singh,14,12,1,1,1,8,4,0,1,6,8,1,0
6480bb98e87e6f83b61088ea,2022,,,2,CJ Jordan,MS Dhoni,14,8,1,1,1,2,2,0,0,11,6,1,1
6480bba16af3f513920ef499,2015,,,2,MK Pandey,YK Pathan,14,15,0,0,1,8,8,0,0,6,7,0,0
6480bb977453ebef15f59e25,2021,,,2,PP Shaw,RR Pant,14,10,1,1,1,0,5,0,0,12,5,1,1
6480bba154ce29a67e4752df,2015,,,1,KD Karthik,V Kohli,14,14,0,1,1,5,6,0,0,8,8,0,1
6480bb94ebff9a116f68560b,2018,,,2,KS Williamson,S Dhawan,14,12,2,0,1,11,9,2,0,2,3,0,0
6480bb9ddcbb8fbbad6614c8,2009/10,,,1,KD Karthik,PD Collingwood,14,20,0,0,1,6,14,0,0,2,6,0,0
6480bba0cdc200ad3ab8fbf5,2014,,,2,CM Gautam,Z Khan,14,6,1,1,0,6,3,1,0,7,3,0,1
6480bba0295edd6084b9503b,2014,,,2,JP Faulkner,STR Binny,14,6,3,0,0,8,2,2,0,6,4,1,0
6480bba1abec4894f2f69a35,2014,,,2,CH Gayle,PA Patel,14,21,2,0,1,4,7,0,0,10,14,2,0
6480bb9aa64355ce98da1141,2007/08,,,1,R Dravid,Z Khan,14,7,3,0,1,14,6,3,0,0,1,0,0
6480bb9bc80883a975281815,2009,,,2,T Henderson,YK Pathan,14,13,0,1,1,9,5,0,1,4,8,0,0
6480bb958f737f809dfb65e1,2019,,,1,AR Patel,I Sharma,14,4,0,2,0,14,4,0,2,0,0,0,0
6480bb9c12f907c7b81b11a9,2009,,,2,J Botha,NK Patel,14,12,3,0,1,8,6,2,0,6,6,1,0
6480bb9d91920239b62f48ad,2009/10,,,1,KP Pietersen,RV Uthappa,14,10,0,1,1,10,6,0,1,3,4,0,0
6480bb94c5d20726ee59d3d6,2017,,,1,AB de Villiers,Mandeep Singh,14,11,2,0,1,10,8,2,0,4,3,0,0
6480bba2aecb4103bab63c15,2016,,,1,JA Morkel,MS Dhoni,14,6,0,2,1,13,4,0,2,1,2,0,0
6480bb99af95c6c90c4c3924,2023,,,2,MA Agarwal,RA Tripathi,14,12,1,0,1,5,7,0,0,7,5,1,0
6480bb9a2b33e06f46eed54f,2023,,,1,JJ Roy,Rahmanullah Gurbaz,14,14,3,0,1,10,8,2,0,4,6,1,0
6480bb9763013a01eae041f2,2020/21,,,2,DA Warner,PK Garg,14,11,1,0,1,6,4,1,0,8,7,0,0
6480bb9bb070eb19f9ac8a76,2007/08,,,2,LPC Silva,Y Venugopal Rao,14,7,2,0,1,13,5,2,0,1,2,0,0
6480bb9e6d7f7f691dde322d,2012,,,1,KD Karthik,RG Sharma,14,16,0,1,1,2,6,0,0,11,10,0,1
6480bb9623a26d3fbfe59f25,2020/21,,,1,GJ Maxwell,KL Rahul,14,13,1,0,1,5,6,0,0,9,7,1,0
6480bb9a1a3ab2ab8297871d,2007/08,,,2,GC Smith,SR Watson,14,15,1,0,1,10,9,1,0,4,6,0,0
6480bba03a099a1a2e9c3dc5,2013,,,2,CM Gautam,M Morkel,14,5,0,2,1,1,1,0,0,13,4,0,2
6480bb95fa6394e733c532a9,2018,,,1,MK Pandey,S Dhawan,14,14,2,0,1,12,10,2,0,2,4,0,0
6480bb94009d0662ee94f07b,2018,,,2,B Stanlake,DJ Hooda,14,6,1,1,0,5,2,1,0,8,4,0,1
6480bb9809c62ba77e5df472,2021,,,1,AB de Villiers,GJ Maxwell,14,12,1,0,1,11,9,1,0,3,3,0,0
6480bb9e41b781523bd5aafe,2012,,,1,BB McCullum,JH Kallis,14,10,3,0,1,9,7,2,0,4,3,1,0
6480bba141bcb000fa6fe2a4,2015,,,2,CJ Anderson,UBT Chand,14,20,1,0,1,6,12,1,0,7,8,0,0
6480bb9ab34d149420eae546,2023,,,2,RK Singh,SN Thakur,14,12,0,1,1,10,5,0,1,3,7,0,0
6480bb99f47261f111a6cc1a,2023,,,2,C Green,SA Yadav,14,14,0,1,1,10,10,0,1,4,4,0,0
6480bb9541caaeddc9ddaac3,2019,,,2,JC Buttler,SV Samson,14,16,2,0,1,6,6,1,0,8,10,1,0
6480bb9c37b72d7a51019794,2009/10,,,2,M Morkel,SK Trivedi,14,8,2,0,1,2,2,0,0,9,6,2,0
6480bb9c89e2e8ecb04f94cb,2009/10,,,2,KD Karthik,M Manhas,14,15,1,0,1,6,7,0,0,8,8,1,0
6480bb94c2dcb1007bf6788b,2017,,,1,P Negi,S Aravind,14,15,1,0,1,8,9,1,0,4,6,0,0
6480bb9698a1d9136a13faf6,2020/21,,,1,CH Gayle,KL Rahul,14,19,1,0,1,7,9,0,0,7,10,1,0
6480bba0be153677ce53c58e,2014,,,2,AR Patel,GJ Maxwell,14,9,3,0,1,2,3,0,0,12,6,3,0
6480bb97493381c4d7dc7bf4,2021,,,1,JC Buttler,M Vohra,14,15,3,0,1,8,8,2,0,6,7,1,0
6480bba3b818a7cff6fe4f89,2016,,,2,JO Holder,R Sathish,14,12,1,0,1,6,6,1,0,6,6,0,0
6480bba0cdc200ad3ab8fbf5,2014,,,2,KA Pollard,RG Sharma,14,14,1,0,1,10,8,1,0,4,6,0,0
6480bb9a1a3ab2ab8297871d,2007/08,,,2,GC Smith,Kamran Akmal,14,13,1,1,1,0,4,0,0,12,9,1,1
6480bb94dfad571ef76493a9,2017,,,1,KK Nair,RR Pant,14,9,2,1,1,14,6,2,1,0,3,0,0
6480bb94704f6dfeb7f4d270,2017,,,2,C de Grandhomme,CR Woakes,14,11,0,1,0,6,5,0,0,8,6,0,1
6480bb9cdf6c63fec90a42df,2009/10,,,1,AD Mathews,LR Shukla,14,13,2,0,1,2,6,0,0,10,7,2,0
6480bba2557febf92f9f79ab,2015,,,1,F du Plessis,MS Dhoni,14,12,0,0,1,6,6,0,0,3,6,0,0
6480bb9f02801d2090cdba0d,2012,,,1,B Kumar,M Manhas,14,10,1,0,0,10,6,1,0,3,4,0,0
6480bb9eb2690fb1ed356b42,2011,,,2,JP Duminy,S Sohal,14,16,0,1,1,4,8,0,0,9,8,0,1
6480bb9e05381e16815803e9,2011,,,1,DJ Hussey,KD Karthik,14,11,1,0,1,4,5,0,0,9,6,1,0
6480bb9b69f390d624466843,2007/08,,,1,SC Ganguly,Salman Butt,14,16,2,0,1,2,8,0,0,10,8,2,0
6480bb9bca2c11520f5b3b9e,2007/08,,,1,PA Patel,S Vidyut,14,14,2,0,1,7,7,1,0,6,7,1,0
6480bb9d967f5a4cfbd8c74d,2011,,,1,JR Hopes,TR Birt,14,16,0,0,1,4,5,0,0,8,11,0,0
6480bba0c1c8569f19cc70f0,2013,,,1,BJ Hodge,STR Binny,14,7,1,1,1,1,2,0,0,13,5,1,1
6480bb9774a44376e3b5eb6f,2021,,,2,KL Rahul,N Pooran,14,11,0,1,1,2,4,0,0,12,7,0,1
6480bb980095555db76d49cb,2022,,,2,KD Karthik,V Kohli,14,8,0,1,1,7,2,0,1,7,6,0,0
6480bba1b85900d7d83de308,2014,,,1,MC Henriques,NV Ojha,14,4,1,1,1,0,1,0,0,13,3,1,1
6480bb93d9581d69657887c3,2017,,,1,KM Jadhav,SR Watson,14,17,0,1,1,10,10,0,1,4,7,0,0
6480bb94640655c49683aee1,2018,,,2,AM Rahane,RA Tripathi,14,14,1,0,1,4,6,0,0,9,8,1,0
6480bb9c58b62383739c022e,2009,,,1,AM Rahane,YV Takawale,14,21,1,0,1,3,7,0,0,10,14,1,0
6480bb9c757dbd7f92b1130a,2009/10,,,1,KAJ Roach,RG Sharma,14,13,1,0,1,10,8,1,0,4,5,0,0
6480bb9f302200e3bc89464e,2012,,,1,CA Lynn,JP Duminy,14,18,1,0,1,6,9,1,0,7,9,0,0
6480bba0cdc200ad3ab8fbf5,2014,,,2,AP Tare,CJ Anderson,14,16,2,0,1,13,14,2,0,1,2,0,0
6480bba3b818a7cff6fe4f89,2016,,,1,B Kumar,Bipul Sharma,14,6,0,2,1,0,1,0,0,14,5,0,2
6480bb94f1c027945eeb8b10,2017,,,1,S Dhawan,Yuvraj Singh,14,15,1,0,1,3,4,0,0,9,11,1,0
6480bb9edbd8851db7e06741,2012,,,2,DT Christian,S Dhawan,14,15,1,0,1,3,4,0,0,10,11,1,0
6480bb97aed297ca9686c94a,2021,,,1,CH Gayle,KL Rahul,14,13,3,0,1,10,8,2,0,4,5,1,0
6480bb95ff5da0069bc5274e,2018,,,2,AJ Finch,KL Rahul,14,6,0,2,1,1,1,0,0,13,5,0,2
6480bb9adb5d9ca80cb1c6a0,2023,,,2,AK Markram,RA Tripathi,14,9,1,1,1,6,4,1,0,7,5,0,1
6480bb9ef18c54e7aafdd223,2012,,,2,Bipul Sharma,P Dogra,14,14,0,1,1,10,8,0,1,4,6,0,0
6480bb98adf21699eaa67796,2022,,,1,HV Patel,KD Karthik,14,5,0,2,1,0,0,0,0,14,5,0,2
6480bb9edd901481f13ce9ba,2012,,,1,N Saini,PC Valthaty,14,16,1,0,1,14,12,1,0,0,4,0,0
6480bb9baa08d0494c0b8dc3,2007/08,,,2,Abdur Razzak,R Dravid,14,8,2,1,0,0,2,0,0,14,6,2,1
6480bb956e3f7f62e4b24c01,2019,,,2,RR Pant,SE Rutherford,14,8,1,1,1,3,3,0,0,11,5,1,1
6480bb99b35dc0981e512451,2022,,,1,R Parag,TA Boult,14,10,0,1,1,3,3,0,0,11,7,0,1
6480bb9d40fc01528c7b7270,2009/10,,,1,AC Voges,YK Pathan,14,9,2,0,1,2,6,0,0,8,3,2,0
6480bba0b46cf5430edef3f5,2014,,,2,SA Yadav,YK Pathan,14,6,3,0,0,13,5,3,0,1,1,0,0
6480bb9affabe4960a987464,2007/08,,,1,AA Noffke,P Kumar,14,13,2,0,1,8,8,1,0,4,5,1,0
6480bb93ff8d1f4cd07859ce,2017,,,2,SV Samson,SW Billings,14,11,3,0,1,0,2,0,0,13,9,3,0
6480bba280f09c38002cf14b,2015,,,2,DA Miller,GJ Bailey,14,3,2,1,0,14,3,2,1,0,0,0,0
6480bb9aab9770e7260312df,2007/08,,,1,VVS Laxman,Y Venugopal Rao,14,19,2,0,1,2,6,0,0,12,13,2,0
6480bb958f737f809dfb65e1,2019,,,1,AR Patel,CH Morris,14,13,0,1,1,4,7,0,0,9,6,0,1
6480bb9e28b7a946a6921fa6,2011,,,2,JEC Franklin,RG Sharma,14,16,1,0,1,5,7,0,0,9,9,1,0
6480bb983ad1bab18d1d8774,2022,,,1,AM Rahane,VR Iyer,14,19,1,0,1,3,5,0,0,10,14,1,0
6480bb9341152e168005ccc9,2017,,,1,Mandeep Singh,V Kohli,14,11,1,1,1,0,3,0,0,14,8,1,1
6480bb97ea8bfb43e3f7515f,2020/21,,,1,MP Stoinis,RR Pant,14,6,2,0,0,5,3,1,0,5,3,1,0
6480bba2e30bef1d7b3bb753,2015,,,2,SN Khan,V Kohli,14,3,2,1,0,0,0,0,0,14,3,2,1
6480bba0c63a6317296391b7,2013,,,1,Harbhajan Singh,MG Johnson,13,10,1,1,1,11,3,1,1,2,7,0,0
6480bb9a365c63af4b3de24c,2023,,,2,Kuldeep Yadav,Mukesh Kumar,13,16,0,0,0,6,9,0,0,6,7,0,0
6480bb9ba9d43057d652a5fe,2009,,,1,KC Sangakkara,WA Mota,13,11,0,0,1,3,5,0,0,5,6,0,0
6480bb9e32ed1b9e077b8c11,2011,,,1,AS Raut,DH Yagnik,13,10,0,0,0,3,5,0,0,2,5,0,0
6480bba0fbf5f1671e1e557e,2013,,,1,Mandeep Singh,SE Marsh,13,15,2,0,1,7,8,1,0,6,7,1,0
6480bb9c9e328ac30bcaf6b0,2009/10,,,2,KA Pollard,SS Tiwary,13,9,1,0,1,3,2,0,0,8,7,1,0
6480bba2db1e2def1b597ed3,2015,,,1,MA Agarwal,SS Tiwary,13,8,2,0,0,7,4,1,0,5,4,1,0
6480bba255079696d5cfa453,2015,,,2,DA Miller,WP Saha,13,15,2,0,1,7,9,1,0,6,6,1,0
6480bba273adb498d96b27a9,2016,,,2,R Sathish,RV Uthappa,13,13,1,0,1,6,7,1,0,7,6,0,0
6480bba163bd0c619365a16b,2015,,,1,JP Duminy,Yuvraj Singh,13,10,0,1,1,10,6,0,1,2,4,0,0
6480bba0f1ebf9ff255e1c91,2013,,,2,DJG Sammy,DW Steyn,13,7,2,0,1,11,5,2,0,2,2,0,0
6480bb9a0474602f26069e45,2007/08,,,2,M Ntini,MS Gony,13,14,2,0,1,11,12,2,0,1,2,0,0
6480bb9b724406459cd357c9,2007/08,,,2,CL White,V Kohli,13,3,2,0,1,0,0,0,0,8,3,2,0
6480bba2a215721aadf7a90a,2015,,,1,BB McCullum,P Negi,13,6,1,1,1,11,4,1,1,2,2,0,0
6480bb9b6ded6d116cfe02ee,2009,,,2,JP Duminy,S Dhawan,13,11,1,0,1,1,1,0,0,12,10,1,0
6480bb94ca3c1b1eac5e8dd3,2018,,,1,Ishan Kishan,RG Sharma,13,10,0,1,1,4,3,0,0,8,7,0,1
6480bb9fd26b695cee9d8761,2013,,,2,BJ Hodge,DH Yagnik,13,9,2,0,1,1,1,0,0,12,8,2,0
6480bb9b09e6c98206422ae5,2009,,,2,AD Mascarenhas,AS Raut,13,10,1,0,1,10,7,1,0,1,3,0,0
6480bba255079696d5cfa453,2015,,,2,M Vijay,WP Saha,13,10,0,1,1,1,5,0,0,7,5,0,1
6480bba37e4fcb8af147f79b,2016,,,2,KK Nair,RR Pant,13,18,1,0,1,9,9,1,0,4,9,0,0
6480bba2563745309ee2bdfb,2016,,,1,BB McCullum,DR Smith,13,10,1,1,1,1,3,0,0,11,7,1,1
6480bba0ffae8617ee64bd19,2013,,,2,DA Warner,IK Pathan,13,10,0,0,1,8,7,0,0,3,3,0,0
6480bb969d80bbba2884b855,2020/21,,,1,D Padikkal,JR Philippe,13,17,2,0,1,5,8,1,0,8,9,1,0
6480bb9c89e2e8ecb04f94cb,2009/10,,,2,AB de Villiers,KD Karthik,13,13,1,0,1,2,5,0,0,10,8,1,0
6480bb94605dacb25c83dc35,2018,,,1,AJ Tye,R Ashwin,13,10,0,0,1,1,5,0,0,4,5,0,0
6480bb9836d24b9817a35f7d,2022,,,1,E Lewis,Q de Kock,13,14,2,0,1,6,5,1,0,7,9,1,0
6480bb990b96e91d3fbf421b,2022,,,2,JC Buttler,SO Hetmyer,13,8,0,1,0,11,5,0,1,2,3,0,0
6480bb9c8cbb5dec60b7d50a,2009/10,,,2,A Symonds,RG Sharma,13,9,1,0,1,5,3,0,0,8,6,1,0
6480bba373508e4f3f4be6c0,2016,,,2,IK Pathan,MS Dhoni,13,20,0,0,1,6,6,0,0,5,14,0,0
6480bba06e8cb70fb4bdc83e,2013,,,2,A Ashish Reddy,CL White,13,8,0,1,1,3,3,0,0,9,5,0,1
6480bba1e64915b9e7c849ca,2014,,,1,KP Pietersen,M Vijay,13,15,2,0,1,7,7,1,0,5,8,1,0
6480bb9ef7c6084992b7cdf8,2012,,,1,KP Pietersen,V Sehwag,13,15,2,0,1,7,11,1,0,6,4,1,0
6480bb9c620c92d09ba1b6b9,2009,,,1,A Symonds,DR Smith,13,12,1,0,1,9,6,1,0,3,6,0,0
6480bb99f816e64203e3c687,2023,,,2,Mandeep Singh,Rahmanullah Gurbaz,13,7,1,1,1,2,4,0,0,11,3,1,1
6480bb9541caaeddc9ddaac3,2019,,,1,KM Jadhav,SK Raina,13,7,3,0,1,8,3,2,0,5,4,1,0
6480bb984f6c41cd28aa0353,2022,,,2,Abhishek Sharma,RA Tripathi,13,10,1,0,1,5,6,1,0,4,4,0,0
6480bb966f48b8ee03e6dff5,2020/21,,,1,DL Chahar,SM Curran,13,13,0,1,1,0,5,0,0,9,8,0,1
6480bb9fc28e897b3c53f359,2012,,,2,KD Karthik,RG Sharma,13,11,1,0,1,6,4,1,0,7,7,0,0
6480bb9affabe4960a987464,2007/08,,,1,P Kumar,Z Khan,13,12,0,1,1,8,4,0,1,3,8,0,0
6480bb97b97c36ac8be3582f,2021,,,1,GJ Maxwell,HV Patel,13,5,0,1,1,10,5,0,1,0,0,0,0
6480bb9837deb0fb66704166,2022,,,2,E Lewis,Q de Kock,13,17,1,0,1,5,13,0,0,6,4,1,0
6480bb9bbb0ec0266749f518,2007/08,,,1,B Chipli,W Jaffer,13,12,2,0,1,10,7,2,0,3,5,0,0
6480bb9938b659481e3ab6dc,2022,,,2,HH Pandya,MS Wade,13,11,2,0,1,7,4,1,0,5,7,1,0
6480bb9384cbae8edee3707f,2017,,,2,CH Morris,PJ Cummins,13,8,1,0,0,7,3,1,0,4,5,0,0
6480bba278153a5979e31ec9,2016,,,2,JP Faulkner,SK Raina,13,6,2,0,1,6,3,1,0,6,3,1,0
6480bba1dd2f8125fc8b203f,2014,,,2,CA Pujara,V Sehwag,13,13,2,0,1,9,11,2,0,1,2,0,0
6480bb9b69f8ace7659e486d,2009,,,1,PA Patel,SK Raina,13,14,1,1,1,0,6,0,0,13,8,1,1
6480bba2965d1d15aa6f723e,2016,,,2,KD Karthik,RA Jadeja,13,15,1,0,1,9,8,1,0,4,7,0,0
6480bb965f597c872396f67c,2020/21,,,1,CV Varun,LH Ferguson,13,8,0,1,1,2,4,0,0,8,4,0,1
6480bb95b84f125c6212267a,2019,,,2,PA Patel,SO Hetmyer,13,12,2,0,1,11,8,2,0,2,4,0,0
6480bb9827e9fb920cf62809,2021,,,2,KD Karthik,N Rana,13,9,2,0,1,7,4,1,0,6,5,1,0
6480bb9448fe25ec89c5fcff,2017,,,1,N Rana,RG Sharma,13,14,1,0,1,7,7,1,0,5,7,0,0
6480bb9fe3bc767415c60bfa,2012,,,1,LRPL Taylor,P Negi,13,12,0,1,1,11,8,0,1,2,4,0,0
6480bb9b17739118ee6c3bd0,2007/08,,,1,Umar Gul,WP Saha,13,6,0,2,1,7,4,0,1,6,2,0,1
6480bba1f2392e6761d39d66,2014,,,2,AT Rayudu,KA Pollard,13,7,1,1,1,1,1,0,0,12,6,1,1
6480bb984f0f3dc0df6d4531,2022,,,1,M Ashwin,TH David,13,6,0,2,0,0,0,0,0,12,6,0,2
6480bb93d5dc00a79edede9c,2017,,,1,PA Patel,RG Sharma,13,10,2,0,1,9,6,2,0,4,4,0,0
6480bb937dc0a09df8f7aeee,2017,,,2,HM Amla,MP Stoinis,13,15,1,0,1,3,3,0,0,9,12,1,0
6480bb9c5ec0713155cad138,2009/10,,,1,Anirudh Singh,TL Suman,13,10,2,0,1,9,9,1,0,4,1,1,0
6480bb96edb3270eba0af1d4,2020/21,,,1,AJ Finch,D Padikkal,13,17,1,0,1,2,9,0,0,9,8,1,0
6480bb9809c62ba77e5df472,2021,,,2,EJG Morgan,Shakib Al Hasan,13,12,1,0,0,4,6,0,0,9,6,1,0
6480bb971ffe5345804e7f32,2020/21,,,2,R Parag,RV Uthappa,13,10,1,1,1,1,2,0,0,12,8,1,1
6480bb9a365c63af4b3de24c,2023,,,1,JM Sharma,P Simran Singh,13,9,1,1,1,5,5,1,0,7,4,0,1
6480bb9f231505ffc493730f,2012,,,2,A Ashish Reddy,DT Christian,13,7,2,0,1,3,3,0,0,10,4,2,0
6480bb987c52e15a2cac0697,2022,,,1,JM Sharma,LS Livingstone,13,10,2,0,1,11,8,2,0,2,2,0,0
6480bba140ee53a14fe06e0d,2014,,,2,MS Dhoni,R Ashwin,13,3,1,1,0,12,3,1,1,0,0,0,0
6480bb937dc0a09df8f7aeee,2017,,,2,MM Sharma,VR Aaron,13,11,1,0,1,9,7,1,0,4,4,0,0
6480bb96fb897a6ff486ffe4,2020/21,,,1,F du Plessis,SM Curran,13,18,1,0,1,10,9,1,0,3,9,0,0
6480bba1bd00c57fb3301f04,2014,,,1,PP Chawla,SP Narine,13,7,1,1,0,11,3,1,1,2,4,0,0
6480bb9aab9770e7260312df,2007/08,,,1,A Symonds,Y Venugopal Rao,13,17,2,0,1,11,11,2,0,2,6,0,0
6480bba17bce347084729c56,2015,,,1,J Suchith,KA Pollard,13,11,1,1,1,2,6,0,0,11,5,1,1
6480bb9a5d25d853e1cbfe3e,2007/08,,,1,Kamran Akmal,YK Pathan,13,9,2,0,1,4,4,1,0,7,5,1,0
6480bb9be88c31fc563da86f,2009,,,2,IK Pathan,KC Sangakkara,13,7,1,0,1,7,4,1,0,0,3,0,0
6480bb9b2a5f2fd5053534dc,2007/08,,,1,CRD Fernando,SD Chitnis,13,4,1,1,1,0,0,0,0,12,4,1,1
6480bb9e5ad1f3182858e7c9,2012,,,2,Mandeep Singh,SE Marsh,13,16,1,0,1,6,8,0,0,7,8,1,0
6480bba2a01f4062fc561247,2016,,,1,DA Miller,SE Marsh,13,9,2,0,1,6,6,1,0,6,3,1,0
6480bba2e3610f863b52b887,2016,,,1,Bipul Sharma,S Dhawan,13,9,0,1,1,5,5,0,0,8,4,0,1
6480bb94f46306dbde97aa5c,2017,,,1,AT Rayudu,PA Patel,13,8,2,0,1,2,2,0,0,10,6,2,0
6480bb94b9d954a885cc531b,2017,,,1,HH Pandya,KH Pandya,13,14,0,1,1,10,9,0,1,3,5,0,0
6480bb9c9f9d5376b4227724,2009/10,,,1,AD Mathews,DJ Hussey,13,8,0,1,1,4,4,0,0,8,4,0,1
6480bb9538916411f52016bf,2019,,,1,AD Russell,PP Chawla,13,11,0,2,1,13,6,0,2,0,5,0,0
6480bb974e2f8e7f41c506dc,2021,,,1,DA Miller,R Parag,13,8,2,0,0,4,1,1,0,8,7,1,0
6480bb97cca23939859c422e,2021,,,2,Abhishek Sharma,KS Williamson,13,11,0,0,1,5,6,0,0,7,5,0,0
6480bba296f606ef91305124,2016,,,1,A Ashish Reddy,KV Sharma,13,7,0,1,1,10,5,0,1,2,2,0,0
6480bb9bcf9df9e7ae0416ba,2009,,,1,D du Preez,RE van der Merwe,13,15,0,0,1,9,10,0,0,4,5,0,0
6480bb9a5d25d853e1cbfe3e,2007/08,,,2,PP Chawla,S Sohal,13,8,1,0,1,9,5,1,0,4,3,0,0
6480bba2a01f4062fc561247,2016,,,2,MK Pandey,Shakib Al Hasan,13,14,1,0,1,9,8,1,0,4,6,0,0
6480bb9e1d754facf4fad618,2012,,,2,JD Ryder,RV Uthappa,13,8,3,0,1,4,3,1,0,8,5,2,0
6480bb9a8053274c083224d9,2023,,,1,C Green,Ishan Kishan,13,11,2,0,1,6,4,1,0,7,7,1,0
6480bba2a01f4062fc561247,2016,,,2,SA Yadav,Shakib Al Hasan,13,16,2,0,1,6,7,1,0,7,9,1,0
6480bb9dc8b09381d0f01a9d,2011,,,2,MK Pandey,RV Uthappa,13,6,2,0,1,11,5,2,0,0,1,0,0
6480bb9e1d754facf4fad618,2012,,,2,JD Ryder,SC Ganguly,13,14,2,0,1,5,7,1,0,6,7,1,0
6480bb960d9d6af315534958,2019,,,1,CH Gayle,KL Rahul,13,15,2,0,1,11,8,2,0,2,7,0,0
6480bb94ca3c1b1eac5e8dd3,2018,,,2,DJ Bravo,MA Wood,13,10,0,1,1,10,7,0,1,1,3,0,0
6480bba192383a244f185c5a,2014,,,2,MS Dhoni,SK Raina,13,6,1,1,0,12,5,1,1,1,1,0,0
6480bb9a36f2ab9a44baa0f8,2023,,,1,D Padikkal,SV Samson,13,10,2,0,1,6,4,1,0,7,6,1,0
6480bb9edd901481f13ce9ba,2012,,,1,PC Valthaty,SE Marsh,13,14,2,0,1,6,8,1,0,7,6,1,0
6480bb9e4bb50b724830b249,2011,,,2,SR Tendulkar,TL Suman,13,7,3,0,1,8,3,2,0,4,4,1,0
6480bb9827e9fb920cf62809,2021,,,2,EJG Morgan,KD Karthik,13,10,2,0,0,2,2,0,0,11,8,2,0
6480bb95ff5da0069bc5274e,2018,,,1,KD Karthik,N Rana,13,5,1,1,1,1,1,0,0,11,4,1,1
6480bb9af968df9497d2b9c4,2007/08,,,1,AB Agarkar,LR Shukla,13,12,2,0,1,2,6,0,0,10,6,2,0
6480bba16796f9a72374865f,2015,,,1,G Gambhir,RV Uthappa,13,17,0,1,1,2,5,0,0,9,12,0,1
6480bba31cc11024436836b5,2016,,,2,A Mishra,CH Morris,13,15,2,0,1,1,5,0,0,12,10,2,0
6480bba1a6882d256a926a8b,2014,,,2,JP Duminy,KP Pietersen,13,13,0,1,1,8,8,0,1,3,5,0,0
6480bb9ade063258af41163b,2007/08,,,2,A Symonds,AS Yadav,13,17,0,1,1,2,7,0,0,10,10,0,1
6480bb947b065b9dc0256f0d,2018,,,2,AB de Villiers,Mandeep Singh,13,13,1,0,1,9,9,1,0,4,4,0,0
6480bba2c3207713bd927ce5,2015,,,2,GJ Maxwell,WP Saha,13,8,1,1,1,11,6,1,1,2,2,0,0
6480bb9f955d5c84cde78f58,2012,,,2,A Nehra,M Kartik,13,12,1,0,0,9,8,1,0,4,4,0,0
6480bb9da3dc1406b000cc98,2011,,,2,JR Hopes,Y Venugopal Rao,13,5,1,1,1,3,2,0,0,10,3,1,1
6480bb9e34659755628e7471,2012,,,2,Bipul Sharma,P Kumar,13,6,1,1,0,12,4,1,1,1,2,0,0
6480bb9efe3f9991539e7f6c,2012,,,2,JD Ryder,SC Ganguly,13,14,2,0,1,7,11,1,0,5,3,1,0
6480bb9c8f3ef1685cdf4017,2009,,,1,AB de Villiers,DA Warner,13,11,1,0,1,4,4,0,0,9,7,1,0
6480bb9b8860198955e581d8,2007/08,,,2,K Goel,SE Marsh,13,15,2,0,1,1,7,0,0,12,8,2,0
6480bb96c40b697b63d08717,2019,,,1,DJ Hooda,Mohammad Nabi,13,8,0,1,1,4,4,0,0,6,4,0,1
6480bb9f36da1a646c80be45,2013,,,2,DA Warner,DPMD Jayawardene,13,15,2,0,1,9,9,2,0,3,6,0,0
6480bb9541caaeddc9ddaac3,2019,,,1,SK Raina,SR Watson,13,10,1,1,1,0,1,0,0,13,9,1,1
6480bba11a59d64bb4aa66f4,2014,,,2,R Tewatia,SV Samson,13,12,0,0,1,7,7,0,0,4,5,0,0
6480bb9b0e32875998e9bfdc,2009,,,1,AB de Villiers,TM Dilshan,13,17,2,0,1,5,7,1,0,7,10,1,0
6480bb9fa236b26050f19633,2012,,,2,NV Ojha,Y Nagar,13,4,1,1,0,11,3,1,1,2,1,0,0
6480bba29fb420d92aef1d2a,2015,,,2,GH Vihari,MC Henriques,13,21,0,0,1,6,12,0,0,6,9,0,0
6480bb981dc3f7250f93bc92,2022,,,2,Lalit Yadav,RR Pant,13,10,1,0,1,3,4,0,0,10,6,1,0
6480bba278153a5979e31ec9,2016,,,1,AM Rahane,SS Tiwary,13,15,2,0,1,11,13,2,0,1,2,0,0
6480bba3ebbd8e4867dfa673,2016,,,1,RR Pant,SV Samson,13,16,2,0,1,2,8,0,0,10,8,2,0
6480bb9aab9770e7260312df,2007/08,,,1,RP Singh,WPUJC Vaas,13,5,0,1,0,1,1,0,0,11,4,0,1
6480bb94a0422f6d0abe276b,2017,,,2,AR Bawne,CH Morris,13,16,1,0,1,11,11,1,0,2,5,0,0
6480bb9a21e416835389fd53,2023,,,2,Atharva Taide,LS Livingstone,13,11,0,1,1,4,5,0,0,9,6,0,1
6480bb94adb227976b33d30b,2018,,,2,N Rana,SP Narine,13,5,0,2,1,1,1,0,0,12,4,0,2
6480bb94ca96a1c1f17d1294,2017,,,2,P Negi,V Kohli,13,17,0,0,1,3,7,0,0,9,10,0,0
6480bba2e680f2464af841ae,2015,,,1,Q de Kock,SS Iyer,13,16,3,0,1,13,9,3,0,0,7,0,0
6480bb9552e25b3867e5c38a,2019,,,1,HH Pandya,SA Yadav,13,8,1,1,1,1,2,0,0,12,6,1,1
6480bba1ebb63d1bd8c60b9d,2014,,,2,KP Pietersen,MA Agarwal,13,14,2,0,1,11,9,2,0,2,5,0,0
6480bba2256bfaaf14c57ead,2015,,,2,Shakib Al Hasan,YK Pathan,13,10,2,0,1,9,5,2,0,2,5,0,0
6480bb9814efd9a91e8c911f,2021,,,1,N Rana,Shubman Gill,13,6,1,1,1,12,5,1,1,1,1,0,0
6480bba28724848c0f3ef034,2015,,,1,LMP Simmons,RG Sharma,13,9,1,1,1,6,4,0,1,6,5,1,0
6480bba237377ccc608266d2,2016,,,1,DA Miller,MM Sharma,13,6,0,1,0,13,6,0,1,0,0,0,0
6480bb991a76403912eef285,2023,,,2,R Ashwin,YBK Jaiswal,13,9,1,1,1,0,1,0,0,11,8,1,1
6480bb9a0a8baa96f94e8db9,2023,,,1,Anuj Rawat,F du Plessis,13,16,0,0,1,9,11,0,0,4,5,0,0
6480bba0f401cc6b6bc6ed10,2013,,,1,AM Rahane,R Dravid,13,12,3,0,1,1,2,0,0,12,10,3,0
6480bb9a40966b9b90fcdf2e,2023,,,1,S Dhawan,SM Curran,13,13,0,1,1,10,8,0,1,3,5,0,0
6480bb963d224b9be17f2c75,2019,,,1,Rashid Khan,S Kaul,13,3,1,1,0,12,3,1,1,0,0,0,0
6480bb9d038ed22e46cbeccb,2011,,,1,CL White,KC Sangakkara,13,11,1,0,1,1,7,0,0,7,4,1,0
6480bb93575636076d81e4c5,2017,,,1,DA Warner,Rashid Khan,13,3,0,2,0,6,2,0,1,6,1,0,1
6480bb980ea7c3bcea4fdf9c,2022,,,1,KL Rahul,Q de Kock,13,17,1,0,1,6,11,1,0,3,6,0,0
6480bb9a6a7169d0e413bcfa,2023,,,2,A Badoni,Swapnil Singh,13,9,1,1,1,11,6,1,1,1,3,0,0
6480bb9fe8f5df13fc8d1bc3,2012,,,2,F du Plessis,SK Raina,13,16,1,0,1,5,6,0,0,8,10,1,0
6480bba3041017fe2c0593f2,2016,,,1,DR Smith,RA Jadeja,13,12,0,1,1,9,5,0,1,3,7,0,0
6480bba0b2a9d600114a43d7,2013,,,1,AJ Finch,RV Uthappa,13,17,2,0,1,10,11,2,0,3,6,0,0
6480bba265483f7db002ec7c,2015,,,2,A Ashish Reddy,MC Henriques,13,12,1,0,1,9,5,1,0,4,7,0,0
6480bba03b6f98689b851317,2013,,,2,DA Miller,DJ Hussey,13,11,0,1,1,10,8,0,1,3,3,0,0
6480bb9871b0ff7264721cbc,2022,,,2,AK Markram,RA Tripathi,13,16,2,0,1,2,7,0,0,11,9,2,0
6480bb946efcc4cd9aa80399,2018,,,2,KD Karthik,R Vinay Kumar,13,7,2,0,0,6,4,1,0,6,3,1,0
6480bb9c3803ef7726af83ab,2009/10,,,2,AS Raut,NV Ojha,13,9,2,0,0,2,4,0,0,11,5,2,0
6480bb9d02d996f85dd5e945,2011,,,2,MS Dhoni,SK Raina,13,11,1,1,1,1,6,0,0,11,5,1,1
6480bb95ea40317152ed9ca5,2018,,,1,GJ Maxwell,V Shankar,13,17,1,0,1,4,6,0,0,8,11,1,0
6480bba18e95c84faca0bdb6,2015,,,2,AM Rahane,SPD Smith,13,14,2,0,1,3,5,0,0,10,9,2,0
6480bb991a76403912eef285,2023,,,2,JC Buttler,R Ashwin,13,11,1,0,1,13,8,1,0,0,3,0,0
6480bb9a9dc58f49d783faa9,2023,,,2,D Padikkal,JE Root,13,16,2,0,1,4,4,1,0,8,12,1,0
6480bb961cdee4d82c395517,2020/21,,,2,MP Stoinis,RR Pant,13,9,2,0,1,6,4,1,0,6,5,1,0
6480bb9dd4e6757f7ded95e9,2009/10,,,2,AC Gilchrist,MD Mishra,13,9,3,0,1,9,5,2,0,4,4,1,0
6480bb9e173228d1b18e376b,2012,,,1,DPMD Jayawardene,V Sehwag,13,12,2,0,1,6,5,1,0,7,7,1,0
6480bb9be7cbbb90a12dc916,2009,,,2,JP Duminy,SR Tendulkar,13,11,1,0,1,9,7,1,0,4,4,0,0
6480bb9d9f4551d7ec79c951,2009/10,,,2,M Vijay,ML Hayden,13,17,2,0,1,8,9,1,0,5,8,1,0
6480bba1d21281c7385d5ce4,2014,,,1,VR Aaron,YS Chahal,13,4,1,1,0,11,3,1,1,1,1,0,0
6480bb9808d6857eeb335d94,2022,,,1,B Indrajith,SS Iyer,13,17,0,0,1,6,8,0,0,7,9,0,0
6480bb98634dba60191637ad,2021,,,2,JO Holder,Rashid Khan,13,12,0,1,1,10,8,0,1,3,4,0,0
6480bb963d224b9be17f2c75,2019,,,2,AJ Turner,SV Samson,13,13,1,0,0,3,7,0,0,8,6,1,0
6480bb9e95693a2c4c4531e8,2011,,,2,M Morkel,VR Aaron,13,9,1,1,0,13,4,1,1,0,5,0,0
6480bb97b97c36ac8be3582f,2021,,,2,DA Warner,WP Saha,13,14,1,0,1,7,5,1,0,1,9,0,0
6480bb99fa79383bdc7df827,2022,,,2,JR Hazlewood,Mohammed Siraj,13,11,2,0,0,7,4,1,0,6,7,1,0
6480bb988545a7776b8c9306,2022,,,2,KD Karthik,PWH de Silva,13,5,0,2,1,6,2,0,1,7,3,0,1
6480bb984f6c41cd28aa0353,2022,,,2,N Pooran,RA Tripathi,13,18,1,0,1,3,9,0,0,9,9,1,0
6480bb9baccf501985a56d64,2007/08,,,1,RA Jadeja,SR Watson,13,10,1,0,1,6,6,1,0,5,4,0,0
6480bba19e29de4f208211ac,2014,,,2,RR Rossouw,Yuvraj Singh,13,12,0,1,1,9,5,0,1,4,7,0,0
6480bb98e87e6f83b61088ea,2022,,,2,AT Rayudu,S Dube,13,12,3,0,1,5,7,1,0,8,5,2,0
6480bb9d105fba311a23a588,2011,,,1,BB McCullum,DPMD Jayawardene,13,15,1,0,1,4,6,0,0,8,9,1,0
6480bb9dbefe5e2cceb23e01,2011,,,2,JA Morkel,S Badrinath,13,9,1,0,1,3,4,0,0,8,5,1,0
6480bb96acacf3be646d300a,2020/21,,,2,AM Rahane,MP Stoinis,13,9,2,0,1,6,3,1,0,5,6,1,0
6480bba11eff9b230a172302,2014,,,2,AM Rahane,KK Nair,13,13,1,0,1,10,8,1,0,1,5,0,0
6480bb96c95abb10156a6055,2020/21,,,2,F du Plessis,RA Jadeja,13,7,2,0,1,3,2,0,0,10,5,2,0
6480bb9a58bc8710c38f4c1c,2023,,,2,Ishan Kishan,SA Yadav,13,9,2,0,1,10,6,2,0,3,3,0,0
6480bb945f95e767a8a9cc10,2017,,,2,Basil Thampi,KD Karthik,13,11,2,0,1,2,5,0,0,10,6,2,0
6480bb9772f78629131db057,2021,,,2,KL Rahul,MC Henriques,13,5,1,1,0,10,2,1,1,3,3,0,0
6480bb9827e9fb920cf62809,2021,,,1,Abhishek Sharma,PK Garg,13,20,0,0,1,6,10,0,0,7,10,0,0
6480bba19052ba503c5f7c27,2015,,,2,JP Faulkner,STR Binny,13,8,2,0,0,6,5,1,0,6,3,1,0
6480bb9ed74d222a3da56dfa,2012,,,2,G Gambhir,MK Tiwary,13,13,1,0,1,11,9,1,0,2,4,0,0
6480bb9822eeb0c1c117f221,2021,,,2,MS Dhoni,RA Jadeja,13,3,3,0,0,12,3,3,0,0,0,0,0
6480bb9fe489b0d429e97599,2012,,,2,KC Sangakkara,S Dhawan,13,5,1,1,0,10,3,1,1,1,2,0,0
6480bb9765a785922ad360fe,2021,,,1,Abdul Samad,KM Jadhav,13,17,1,0,1,10,9,1,0,3,8,0,0
6480bb95f214d4f82ab97ee5,2018,,,1,AM Rahane,JC Buttler,13,15,1,0,1,11,12,1,0,2,3,0,0
6480bb95e435367dc64d9844,2019,,,1,HH Pandya,KA Pollard,13,14,0,1,1,3,7,0,0,10,7,0,1
6480bba0001885407e860a8d,2013,,,2,BMAJ Mendis,IK Pathan,13,15,0,0,1,7,6,0,0,6,9,0,0
6480bb9ab49fc97bbb30576f,2023,,,1,GJ Maxwell,V Kohli,13,7,1,1,1,11,5,1,1,2,2,0,0
6480bb9dfa7d0510ae3a7b40,2011,,,1,IK Pathan,JR Hopes,13,11,0,1,1,3,6,0,0,9,5,0,1
6480bb9dfb2e8e8c2002df86,2011,,,1,B Chipli,IR Jaggi,13,14,1,0,1,6,9,1,0,3,5,0,0
6480bb98cbaaf700d226941a,2022,,,1,JC Buttler,YBK Jaiswal,13,16,1,1,1,12,14,1,1,1,2,0,0
6480bb9e692eaa193a417426,2012,,,2,AJ Finch,Y Venugopal Rao,13,14,1,0,1,4,6,0,0,8,8,1,0
6480bb965aa0867bce4e79b3,2019,,,1,F du Plessis,MS Dhoni,13,12,0,1,1,8,4,0,1,5,8,0,0
6480bb98adf21699eaa67796,2022,,,2,MM Ali,RA Jadeja,13,11,0,1,1,10,6,0,1,3,5,0,0
6480bb95385ebb9bda58a643,2019,,,2,AR Patel,RR Pant,13,21,0,0,1,6,11,0,0,6,10,0,0
6480bba0bc196f7168b3d989,2013,,,2,LA Pomersbach,Mandeep Singh,13,12,2,0,1,7,9,1,0,5,3,1,0
6480bba296f606ef91305124,2016,,,1,EJG Morgan,MC Henriques,13,16,1,0,1,7,9,0,0,6,7,1,0
6480bba18e95c84faca0bdb6,2015,,,2,CH Morris,TG Southee,13,7,2,0,0,6,3,1,0,7,4,1,0
6480bb9fa236b26050f19633,2012,,,1,AA Chavan,SP Goswami,13,11,1,0,0,7,6,1,0,6,5,0,0
6480bb9da398a7c3c645732c,2011,,,2,M Manhas,NL McCullum,13,7,0,1,1,8,4,0,1,3,3,0,0
6480bb9737b1d7284b5297c1,2021,,,1,KA Pollard,KH Pandya,13,10,2,0,1,5,3,1,0,7,7,1,0
6480bb9506d56930505d45ae,2019,,,1,CH Gayle,KL Rahul,13,10,1,1,1,1,1,0,0,12,9,1,1
6480bba1de7febd9f1f0138e,2014,,,2,KK Nair,SR Watson,13,12,1,1,1,5,6,1,0,8,6,0,1
6480bb9429a15517bb46f3be,2018,,,1,KH Pandya,RG Sharma,13,10,1,0,1,8,6,1,0,5,4,0,0
6480bb94adb227976b33d30b,2018,,,2,KD Karthik,N Rana,13,13,1,0,1,6,7,0,0,7,6,1,0
6480bb976caaa0cc91f652c7,2021,,,1,Ishan Kishan,KA Pollard,13,9,1,1,1,7,5,0,1,6,4,1,0
6480bb951354c40599b60208,2018,,,1,S Dhawan,SP Goswami,13,12,1,0,1,7,7,1,0,5,5,0,0
6480bb9c54a72690027ba3d4,2009/10,,,2,DJ Bravo,SR Tendulkar,13,10,2,0,1,3,4,0,0,10,6,2,0
6480bb947a7c9fe868fc901a,2017,,,2,SR Watson,Sachin Baby,13,7,2,0,1,3,2,0,0,8,5,2,0
6480bb9e1751fd9db64a2834,2011,,,1,JEC Franklin,RG Sharma,13,10,2,0,1,10,4,2,0,3,6,0,0
6480bb99f2a793884331579e,2023,,,1,AD Russell,RK Singh,13,9,1,1,1,12,6,1,1,0,3,0,0
6480bb98f01e4672b988c112,2022,,,2,JO Holder,Q de Kock,13,19,2,0,1,8,14,2,0,4,5,0,0
6480bb9a24adc8d916dfe2db,2023,,,1,DA Miller,Shubman Gill,13,8,2,0,1,7,5,1,0,6,3,1,0
6480bb9623a26d3fbfe59f25,2020/21,,,2,Navdeep Saini,Washington Sundar,13,8,1,1,1,1,2,0,0,12,6,1,1
6480bba0001885407e860a8d,2013,,,2,DPMD Jayawardene,V Sehwag,13,22,1,1,1,11,12,1,1,2,10,0,0
6480bb9f36ad55c3c7fd6548,2012,,,1,KA Pollard,RG Sharma,13,7,2,0,1,8,5,1,0,5,2,1,0
6480bb9ee7a29c9b96ed61e5,2011,,,1,AC Gilchrist,SE Marsh,13,8,3,0,1,0,0,0,0,13,8,3,0
6480bba234aac105851964b1,2015,,,2,HV Patel,SN Khan,13,7,2,0,1,2,2,0,0,10,5,2,0
6480bba1b85900d7d83de308,2014,,,1,IK Pathan,NV Ojha,13,4,1,1,1,1,2,0,0,10,2,1,1
6480bba2e30bef1d7b3bb753,2015,,,1,DA Warner,EJG Morgan,13,9,0,1,1,2,2,0,0,11,7,0,1
6480bb932d6ccb8870dcd72d,2017,,,2,BA Stokes,SPD Smith,13,11,1,0,1,3,3,0,0,9,8,1,0
6480bb999424dd02cf40772a,2022,,,2,E Lewis,PVD Chameera,13,7,1,1,0,1,3,0,0,11,4,1,1
6480bb99358a21ba3487db81,2023,,,2,MP Stoinis,N Pooran,13,10,1,1,0,2,4,0,0,11,6,1,1
6480bb9a3ffea6235f54cc1e,2023,,,2,Abdul Samad,B Kumar,13,9,2,0,1,6,5,1,0,5,4,1,0
6480bb970c637fd0c057dca9,2021,,,2,JM Bairstow,KS Williamson,13,11,1,0,1,6,4,1,0,6,7,0,0
6480bb9ca668b7b36823fb21,2009,,,1,A Mishra,KD Karthik,13,5,1,1,0,13,4,1,1,0,1,0,0
6480bb9a807eb5f39489408a,2023,,,1,AT Rayudu,RA Jadeja,13,12,0,0,1,5,6,0,0,6,6,0,0
6480bba2fc84811f520b04cf,2016,,,1,DA Miller,M Vijay,13,14,1,0,1,8,7,1,0,5,7,0,0
6480bba2b5d601f8354f5b5a,2016,,,1,P Negi,Q de Kock,13,4,1,1,0,8,2,0,1,5,2,1,0
6480bba2f36e449a59f4a812,2015,,,1,A Mishra,KM Jadhav,13,8,2,0,1,2,4,0,0,11,4,2,0
6480bb97372fc5d5ef4c436a,2021,,,2,JC Buttler,M Vohra,13,16,2,0,1,2,5,0,0,9,11,2,0
6480bb938ed49c6d5c211429,2017,,,2,DA Warner,MC Henriques,13,19,1,0,1,5,12,0,0,8,7,1,0
6480bb980b5b26e8c4335a4b,2022,,,1,JM Bairstow,S Dhawan,13,5,1,1,1,6,3,1,0,7,2,0,1
6480bb93c1cc671d66c471ba,2017,,,2,CR Woakes,MK Pandey,13,12,0,0,1,9,8,0,0,4,4,0,0
6480bba0f858e6c12b25d8c3,2014,,,1,JH Kallis,MK Pandey,13,16,2,0,1,4,6,1,0,8,10,1,0
6480bb9a87f64c1a12f62ece,2007/08,,,2,A Nehra,AM Nayar,13,8,2,0,0,1,2,0,0,11,6,2,0
6480bb9ab99ef699d66ad5a0,2023,,,1,P Simran Singh,S Dhawan,13,9,2,0,1,9,7,1,0,4,2,1,0
6480bba0fbf5f1671e1e557e,2013,,,1,DA Miller,DJ Hussey,13,13,0,0,1,8,6,0,0,5,7,0,0
6480bb9516b0dbc1972e5c3c,2018,,,1,CA Lynn,RV Uthappa,13,11,0,0,1,3,4,0,0,3,7,0,0
6480bb9df60a79ae5f20b748,2011,,,1,AJ Finch,NV Ojha,13,14,1,1,1,2,5,0,0,11,9,1,1
6480bb9d40fc01528c7b7270,2009/10,,,2,LRPL Taylor,R Dravid,13,12,1,1,0,8,8,0,1,5,4,1,0
6480bba1105add9a994c58a7,2014,,,2,AJ Finch,S Dhawan,13,11,1,0,1,2,3,0,0,4,8,1,0
6480bb9dec749d630afd07d1,2011,,,1,S Dhawan,S Sohal,13,12,1,0,1,6,7,0,0,7,5,1,0
6480bb99fa79383bdc7df827,2022,,,2,HV Patel,PWH de Silva,13,6,2,0,1,9,3,2,0,1,3,0,0
6480bba2a215721aadf7a90a,2015,,,2,Ankit Sharma,CH Morris,13,7,0,1,1,0,1,0,0,12,6,0,1
6480bb9ee779ef1e445d0506,2012,,,1,JEC Franklin,KA Pollard,13,22,0,0,1,5,11,0,0,8,11,0,0
6480bb9da9ca2f2d3738d79e,2011,,,2,R Sharma,WD Parnell,13,10,1,1,1,8,5,0,1,5,5,1,0
6480bb98d2cd0fa3ed0ffc21,2022,,,2,SS Iyer,SW Billings,13,13,2,0,1,5,6,1,0,8,7,1,0
6480bb9b52b93b56f5a16e52,2007/08,,,1,G Gambhir,S Dhawan,13,16,1,0,1,8,11,1,0,4,5,0,0
6480bba22349149c9ec92d49,2016,,,1,PSP Handscomb,SS Tiwary,13,17,1,0,1,6,12,0,0,7,5,1,0
6480bb9825eb960aded1ff64,2022,,,2,DA Miller,LH Ferguson,13,6,1,1,0,12,6,1,1,0,0,0,0
6480bb9ddfb0f2f6f8e813e5,2011,,,1,DPMD Jayawardene,PA Patel,13,14,2,0,1,11,11,2,0,1,3,0,0
6480bb9cff4ec2f71cdf18d1,2009/10,,,2,PP Chawla,SJ Srivastava,13,7,2,0,1,11,6,2,0,1,1,0,0
6480bb96c95abb10156a6055,2020/21,,,2,F du Plessis,MS Dhoni,13,6,3,0,0,13,4,3,0,0,2,0,0
6480bb9c3b082d71291a593c,2009,,,1,LRPL Taylor,RE van der Merwe,13,10,0,1,1,9,4,0,1,3,6,0,0
6480bba1ebb63d1bd8c60b9d,2014,,,1,M Vohra,V Sehwag,13,14,2,0,1,3,7,0,0,9,7,2,0
6480bba2256bfaaf14c57ead,2015,,,2,MK Pandey,RV Uthappa,13,12,2,0,1,3,7,0,0,9,5,2,0
6480bb9a07d46704efe103ef,2007/08,,,1,AS Yadav,Y Venugopal Rao,13,6,1,1,1,8,4,0,1,4,2,1,0
6480bba1abec4894f2f69a35,2014,,,2,S Rana,Yuvraj Singh,13,10,0,1,1,1,2,0,0,12,8,0,1
6480bb9c50838010977c168c,2009,,,2,LA Pomersbach,Yuvraj Singh,13,26,0,0,1,6,13,0,0,4,13,0,0
6480bb95833c06e6c5119173,2019,,,1,AB de Villiers,MP Stoinis,13,10,1,0,1,2,2,0,0,10,8,1,0
6480bb94fbd0b904d63e0e07,2017,,,1,Anureet Singh,MM Sharma,13,10,2,0,1,11,6,2,0,2,4,0,0
6480bb99f2a793884331579e,2023,,,1,AD Russell,SP Narine,13,7,2,0,0,9,5,2,0,2,2,0,0
6480bb96b7b695186bbb6a3e,2019,,,2,RA Jadeja,SR Watson,13,8,0,0,1,5,5,0,0,4,3,0,0
6480bb9525c593ee45bb038c,2019,,,1,HH Pandya,MJ McClenaghan,13,7,1,1,1,12,7,1,1,0,0,0,0
6480bb9abfe839459b1a28f6,2007/08,,,1,RG Sharma,VVS Laxman,13,12,1,0,1,4,5,0,0,9,7,1,0
6480bba3041017fe2c0593f2,2016,,,2,AB de Villiers,CH Gayle,13,12,1,1,1,8,6,0,1,4,6,1,0
6480bba0d2cdb40c68c4739c,2013,,,2,KA Pollard,PP Ojha,13,3,0,2,0,12,2,0,2,1,1,0,0
6480bb9e8dfd9ba30b93cbd8,2012,,,1,PA Patel,S Dhawan,13,14,2,0,1,5,6,1,0,7,8,1,0
6480bb97aa725a640d0f8e2f,2021,,,1,MK Lomror,SV Samson,13,10,0,1,1,3,4,0,0,9,6,0,1
6480bba2eea6f31945e4c5e2,2016,,,1,C Munro,YK Pathan,13,10,1,0,1,4,5,0,0,8,5,1,0
6480bb962831291a868490e7,2020/21,,,2,S Dhawan,SS Iyer,13,14,2,0,1,6,6,1,0,7,8,1,0
6480bba163bd0c619365a16b,2015,,,2,PA Patel,UBT Chand,13,10,1,1,1,11,7,1,1,2,3,0,0
6480bb995193664eda3e9e10,2022,,,1,AD Russell,N Rana,13,7,1,1,1,9,5,0,1,4,2,1,0
6480bb9a8ac627a1ebf8dacf,2007/08,,,1,B Chipli,W Jaffer,13,19,1,0,1,8,11,1,0,3,8,0,0
6480bba16af3f513920ef499,2015,,,1,RS Bopara,S Dhawan,13,11,1,0,1,2,4,0,0,11,7,1,0
6480bb9ddcbb8fbbad6614c8,2009/10,,,1,KD Karthik,M Manhas,13,20,0,0,1,5,10,0,0,8,10,0,0
6480bb97dee20878b0c4246c,2021,,,1,PP Shaw,RR Pant,13,7,1,1,1,8,4,0,1,5,3,1,0
6480bb9c266a85f1960d87e9,2009,,,2,LA Pomersbach,S Sohal,13,9,2,0,1,9,6,2,0,1,3,0,0
6480bb9bcc2f6123673672d0,2007/08,,,2,A Nel,RV Uthappa,13,3,0,2,1,0,0,0,0,13,3,0,2
6480bba1d3370c13ea1f79f3,2014,,,1,AB de Villiers,Yuvraj Singh,13,11,2,0,1,4,4,1,0,9,7,1,0
6480bb9f03dd3a09740f0bd0,2013,,,2,B Lee,EJG Morgan,13,8,3,0,1,5,6,1,0,8,2,2,0
6480bb9b4fc6889967a3cd54,2007/08,,,1,AC Gilchrist,RG Sharma,13,18,2,0,1,7,9,1,0,6,9,1,0
6480bb9a596c087c0396ec2e,2007/08,,,1,Harbhajan Singh,SM Pollock,13,7,1,1,1,2,2,0,0,11,5,1,1
6480bb9866dd8ba9b48863c2,2022,,,2,JO Holder,MP Stoinis,13,10,1,0,1,3,3,0,0,8,7,1,0
6480bb9d182be5b0fbe5a4e2,2011,,,2,A Symonds,R Sathish,13,10,1,0,1,6,5,1,0,7,5,0,0
6480bb96fb897a6ff486ffe4,2020/21,,,1,SM Curran,SR Watson,13,6,3,0,1,5,3,1,0,8,3,2,0
6480bb9ef18c54e7aafdd223,2012,,,1,G Gambhir,JH Kallis,13,12,2,0,1,12,7,2,0,1,5,0,0
6480bb9c7b7d7712bdc663de,2009/10,,,2,A Symonds,MD Mishra,13,11,0,0,1,6,6,0,0,5,5,0,0
6480bb9e565ef5f11c5c8f55,2011,,,2,SS Tiwary,V Kohli,13,15,2,0,1,0,4,0,0,11,11,2,0
6480bb9a6a7169d0e413bcfa,2023,,,2,A Badoni,N Pooran,13,8,0,1,1,10,5,0,1,2,3,0,0
6480bb96902b7c96b94f406a,2019,,,1,RK Singh,RV Uthappa,13,15,0,0,1,4,5,0,0,4,10,0,0
6480bb9f7bae5ad85c4473ba,2012,,,1,KD Karthik,RG Sharma,13,7,2,0,1,11,5,2,0,2,2,0,0
6480bb9b7557e68b433167d5,2007/08,,,1,JA Morkel,MS Gony,13,9,0,1,1,9,5,0,1,2,4,0,0
6480bb9553f3fc8903579544,2018,,,2,KD Karthik,N Rana,13,7,1,1,1,5,3,1,0,8,4,0,1
6480bb979e8cc2484c1a8c7b,2020/21,,,2,BA Stokes,RV Uthappa,13,11,2,0,1,0,0,0,0,13,11,2,0
6480bba3e9fa951efcfc8bfb,2016,,,2,KK Nair,SW Billings,13,11,1,0,1,8,8,1,0,2,3,0,0
6480bb9498a98d52f9285b52,2017,,,1,MC Henriques,Yuvraj Singh,13,10,0,1,1,4,6,0,0,9,4,0,1
6480bb9d0f6794fbf429449b,2011,,,1,MK Tiwary,Shakib Al Hasan,13,16,2,0,1,11,11,2,0,2,5,0,0
6480bb9f231505ffc493730f,2012,,,1,DJ Bravo,S Badrinath,13,5,0,1,0,12,4,0,1,1,1,0,0
6480bb9e692eaa193a417426,2012,,,2,AJ Finch,V Sehwag,13,5,3,0,1,13,4,3,0,0,1,0,0
6480bba0a3e806f41a4dab41,2013,,,1,R Bhatia,RN ten Doeschate,13,10,2,0,0,3,4,0,0,10,6,2,0
6480bb94bf9a1728b1b12f4d,2018,,,2,AM Rahane,RA Tripathi,13,14,2,0,1,9,9,2,0,4,5,0,0
6480bb9c2778066dafd78a71,2009/10,,,1,ML Hayden,S Badrinath,13,9,1,1,1,8,4,0,1,5,5,1,0
6480bba2eea6f31945e4c5e2,2016,,,2,KA Pollard,RG Sharma,13,4,3,0,0,1,1,0,0,12,3,3,0
6480bb9a807eb5f39489408a,2023,,,1,AM Rahane,S Dube,13,9,0,1,1,4,5,0,0,9,4,0,1
6480bb962a1612c936d161ba,2019,,,2,M Vijay,SK Raina,13,14,1,0,1,11,10,1,0,2,4,0,0
6480bb9c9685addc4a78d7d0,2009/10,,,1,KC Sangakkara,MS Bisla,13,11,2,0,1,4,3,1,0,8,8,1,0
6480bb9d69cb9046a72d8fbe,2009/10,,,1,M Vijay,SK Raina,13,7,1,1,1,13,7,1,1,0,0,0,0
6480bb9f302200e3bc89464e,2012,,,2,R Dravid,STR Binny,13,15,1,0,1,5,7,0,0,7,8,1,0
6480bb9d61e9b86b0f0aae49,2009/10,,,1,HH Gibbs,RG Sharma,13,10,1,1,1,11,7,1,1,0,3,0,0
6480bb9ddfb0f2f6f8e813e5,2011,,,2,IK Pathan,TR Birt,13,5,0,2,1,7,3,0,1,6,2,0,1
6480bb9fa1611443840261b7,2012,,,1,KC Sangakkara,PA Reddy,13,15,1,0,1,6,6,1,0,6,9,0,0
6480bb9d85a6220ec9bc7dcb,2011,,,1,MK Pandey,Yuvraj Singh,13,12,1,0,1,4,6,0,0,9,6,1,0
6480bb99cf7659c6e45bd01d,2023,,,1,AK Markram,RA Tripathi,13,12,1,0,1,9,8,1,0,4,4,0,0
6480bba1d21281c7385d5ce4,2014,,,1,AB de Villiers,S Rana,13,8,0,1,1,4,3,0,0,9,5,0,1
6480bb9f9a70ecf3467829df,2013,,,2,DH Yagnik,SR Watson,13,13,1,0,1,7,8,1,0,4,5,0,0
6480bb9d967f5a4cfbd8c74d,2011,,,2,G Gambhir,SP Goswami,13,10,2,0,1,8,6,1,0,5,4,1,0
6480bb947a7c9fe868fc901a,2017,,,2,KM Jadhav,Sachin Baby,13,7,0,1,1,7,4,0,1,4,3,0,0
6480bb9fc9e4047271240a59,2012,,,1,JH Kallis,LR Shukla,13,10,2,0,1,10,4,2,0,3,6,0,0
6480bb9b1fc007965b68d4d9,2009,,,2,DJ Bravo,JP Duminy,13,12,0,0,1,6,6,0,0,5,6,0,0
6480bb9ac9149c73fdf073b3,2023,,,2,DA Warner,Lalit Yadav,13,14,0,0,1,4,7,0,0,5,7,0,0
6480bb9ce544a2fc17a48bee,2009,,,2,BB McCullum,SC Ganguly,13,15,3,0,1,9,9,2,0,4,6,1,0
6480bb9553f3fc8903579544,2018,,,2,Kuldeep Yadav,TK Curran,13,18,1,0,1,4,12,0,0,8,6,1,0
6480bb9dd778cb6c44535092,2009/10,,,2,DJ Bravo,R Sathish,12,15,0,0,1,5,9,0,0,5,6,0,0
6480bb9a8ac627a1ebf8dacf,2007/08,,,1,P Kumar,Z Khan,12,9,1,0,1,4,3,0,0,8,6,1,0
6480bba08cc4182f0127f2e2,2013,,,2,MS Dhoni,RA Jadeja,12,13,1,0,1,7,6,1,0,5,7,0,0
6480bb9a81d7fd0ac0307b4d,2023,,,2,KR Mayers,PN Mankad,12,11,2,0,1,9,5,2,0,3,6,0,0
6480bb97fb920d483d0da2af,2020/21,,,1,Abdul Samad,KS Williamson,12,10,1,0,1,8,6,1,0,4,4,0,0
6480bb9480627b50308b7903,2017,,,1,JP Faulkner,RA Jadeja,12,16,1,0,1,3,9,0,0,8,7,1,0
6480bba3e9fa951efcfc8bfb,2016,,,2,CH Morris,CR Brathwaite,12,6,1,1,1,2,2,0,0,10,4,1,1
6480bb990942cd416cf5f447,2022,,,2,Avesh Khan,PVD Chameera,12,4,0,2,1,12,4,0,2,0,0,0,0
6480bb948211fe47e65f2e77,2018,,,2,KA Pollard,SA Yadav,12,8,0,1,1,9,6,0,1,3,2,0,0
6480bb94f27c8167d1685878,2017,,,1,RR Pant,SS Iyer,12,7,1,1,1,10,5,1,1,1,2,0,0
6480bb96c95abb10156a6055,2020/21,,,1,KA Pollard,KH Pandya,12,8,0,1,1,9,5,0,1,3,3,0,0
6480bba0b2a9d600114a43d7,2013,,,1,MK Pandey,RV Uthappa,12,12,1,0,1,3,5,0,0,8,7,1,0
6480bba2704d23da78c3eb15,2016,,,2,M Vijay,M Vohra,12,14,1,0,1,5,9,1,0,0,5,0,0
6480bb99f649ea7a6d79892f,2023,,,1,JM Sharma,S Dhawan,12,15,3,0,1,4,9,1,0,8,6,2,0
6480bb9d1ed71a4f47892d00,2009/10,,,2,FY Fazal,P Dogra,12,11,0,0,1,5,5,0,0,7,6,0,0
6480bba3aa840e4e9450a200,2016,,,2,AB de Villiers,V Kohli,12,9,1,0,1,6,8,1,0,1,1,0,0
6480bba29fb420d92aef1d2a,2015,,,2,KV Sharma,MC Henriques,12,13,0,0,1,6,6,0,0,6,7,0,0
6480bb95ff5da0069bc5274e,2018,,,1,KD Karthik,Shubman Gill,12,9,2,0,1,5,4,1,0,7,5,1,0
6480bb966c9efd5bf35d10b9,2019,,,1,CR Brathwaite,KD Karthik,12,4,1,1,1,5,3,1,0,6,1,0,1
6480bb9f7258f976eb8fe943,2012,,,1,AM Rahane,STR Binny,12,18,0,0,1,4,8,0,0,6,10,0,0
6480bb97af05ebd5c4f575c4,2021,,,2,V Shankar,Virat Singh,12,16,0,0,1,5,10,0,0,5,6,0,0
6480bb9a7577454a5220c94b,2007/08,,,2,SA Asnodkar,SK Warne,12,12,1,0,1,4,5,0,0,7,7,1,0
6480bb957e6d387fe3a6b26e,2018,,,1,JJ Roy,SS Iyer,12,10,1,1,1,10,7,1,1,1,3,0,0
6480bb9359a2cade3b5213d3,2017,,,1,KM Jadhav,P Negi,12,11,0,0,1,6,5,0,0,4,6,0,0
6480bb965f597c872396f67c,2020/21,,,1,KL Nagarkoti,Shubman Gill,12,20,0,0,1,6,13,0,0,6,7,0,0
6480bb97c48a16e84b55a325,2020/21,,,2,KS Williamson,MK Pandey,12,17,0,0,1,5,11,0,0,2,6,0,0
6480bba1b8e3071cc513602a,2014,,,2,KL Rahul,NV Ojha,12,15,0,0,1,7,9,0,0,5,6,0,0
6480bb99fa79383bdc7df827,2022,,,1,JM Sharma,LS Livingstone,12,8,2,0,1,9,5,2,0,3,3,0,0
6480bba19701e99975ce7c59,2015,,,1,DJ Hooda,SPD Smith,12,9,1,0,1,1,3,0,0,10,6,1,0
6480bb9ab83a3072124dda22,2023,,,2,KR Mayers,Q de Kock,12,20,1,0,1,2,14,0,0,8,6,1,0
6480bb9b46b4360184dc19f3,2007/08,,,1,AC Gilchrist,HH Gibbs,12,14,2,0,1,6,7,1,0,5,7,1,0
6480bb9b69f8ace7659e486d,2009,,,2,AD Mascarenhas,RA Jadeja,12,12,1,0,1,8,8,1,0,4,4,0,0
6480bb974123cbc9756ceefa,2021,,,2,Harpreet Brar,MC Henriques,12,5,0,1,0,3,2,0,0,9,3,0,1
6480bb96267b63eb2c6747b0,2019,,,1,CA Ingram,SE Rutherford,12,8,1,1,1,10,5,1,1,2,3,0,0
6480bb9c94ef2c2e850189ff,2009/10,,,2,RS Bopara,Yuvraj Singh,12,10,1,0,1,3,4,0,0,9,6,1,0
6480bb9827e9fb920cf62809,2021,,,1,B Kumar,S Kaul,12,10,1,0,0,5,5,0,0,7,5,1,0
6480bba01a3f8444c7a33ba6,2014,,,1,R Bhatia,SPD Smith,12,13,1,0,1,4,6,0,0,8,7,1,0
6480bb9c454e9eefca545bde,2009/10,,,1,DPMD Jayawardene,S Sreesanth,12,8,0,1,1,11,7,0,1,0,1,0,0
6480bb95960e393c939ab44c,2018,,,2,E Lewis,SA Yadav,12,4,1,1,1,0,0,0,0,12,4,1,1
6480bb9f03dd3a09740f0bd0,2013,,,2,EJG Morgan,LR Shukla,12,21,0,0,1,5,12,0,0,2,9,0,0
6480bb97220be892fbfc2a36,2021,,,2,N Rana,RA Tripathi,12,10,1,0,1,7,5,1,0,5,5,0,0
6480bba35038a60ea566794a,2016,,,1,BB McCullum,SK Raina,12,14,2,0,1,10,9,2,0,1,5,0,0
6480bb9c0dec1a788da66d33,2009/10,,,1,AA Jhunjhunwala,P Dogra,12,6,2,0,1,7,3,1,0,5,3,1,0
6480bba09d6b23c8722fd208,2013,,,2,AP Tare,DR Smith,12,10,2,0,1,7,7,1,0,5,3,1,0
6480bb9c17dcdfd5b06984f0,2009/10,,,1,DA Warner,G Gambhir,12,6,2,0,1,10,4,2,0,1,2,0,0
6480bb99f33a7dd80eb0a544,2023,,,1,DJ Hooda,N Pooran,12,8,2,0,1,11,6,2,0,1,2,0,0
6480bb9ba9d43057d652a5fe,2009,,,2,JP Duminy,SS Tiwary,12,9,0,0,1,8,7,0,0,3,2,0,0
6480bb99695e001cdaca81e0,2022,,,1,AT Rayudu,RD Gaikwad,12,15,2,0,1,6,10,1,0,6,5,1,0
6480bb948a69b3d86293b12b,2017,,,2,CJ Anderson,SS Iyer,12,10,2,0,1,6,6,1,0,6,4,1,0
6480bba19e29de4f208211ac,2014,,,2,HV Patel,RR Rossouw,12,5,1,1,1,6,2,0,1,6,3,1,0
6480bba1448ab5c40ac64696,2014,,,2,CM Gautam,LMP Simmons,12,14,1,0,1,8,9,1,0,1,5,0,0
6480bba141bcb000fa6fe2a4,2015,,,2,CJ Anderson,J Suchith,12,4,1,1,1,12,4,1,1,0,0,0,0
6480bb9e9162dceff15dc334,2011,,,1,DPMD Jayawardene,RV Gomez,12,9,1,0,1,10,6,1,0,2,3,0,0
6480bba1670ace74604a420f,2015,,,2,DJ Muthuswami,JA Morkel,12,3,1,1,0,0,0,0,0,12,3,1,1
6480bb9e19dd5297ba8ca5f7,2011,,,2,B Chipli,DT Christian,12,10,1,0,0,5,4,1,0,7,6,0,0
6480bba06e8cb70fb4bdc83e,2013,,,2,PA Patel,PA Reddy,12,13,2,0,1,0,2,0,0,12,11,2,0
6480bb96f1eadf803ffc292c,2020/21,,,1,PP Shaw,S Dhawan,12,9,2,0,1,7,5,1,0,5,4,1,0
6480bb99695e001cdaca81e0,2022,,,1,AT Rayudu,MS Dhoni,12,9,2,0,1,4,4,1,0,6,5,1,0
6480bb9fc9e4047271240a59,2012,,,1,JH Kallis,YK Pathan,12,5,1,1,1,11,3,1,1,1,2,0,0
6480bb97c48a16e84b55a325,2020/21,,,2,KS Williamson,PK Garg,12,20,0,0,1,4,6,0,0,7,14,0,0
6480bb9dd778cb6c44535092,2009/10,,,2,S Dhawan,SS Tiwary,12,12,1,0,1,9,9,1,0,3,3,0,0
6480bb9b62eb35d78fcd7df0,2007/08,,,1,SC Ganguly,Salman Butt,12,6,0,1,1,7,4,0,1,2,2,0,0
6480bb94fc240a33621b10a6,2018,,,1,AD Russell,KD Karthik,12,9,2,0,1,10,7,2,0,1,2,0,0
6480bba1551dc12c8f2a7038,2014,,,1,KP Pietersen,M Vijay,12,18,2,0,1,6,12,1,0,6,6,1,0
6480bba24f6e6e2c212c7469,2016,,,2,CR Brathwaite,SV Samson,12,5,0,1,1,6,4,0,1,1,1,0,0
6480bb9a365c63af4b3de24c,2023,,,1,Harpreet Brar,P Simran Singh,12,9,2,0,1,2,5,0,0,10,4,2,0
6480bb9a87f64c1a12f62ece,2007/08,,,1,JDP Oram,MS Dhoni,12,5,1,1,1,5,2,1,0,6,3,0,1
6480bb9a58bc8710c38f4c1c,2023,,,2,N Wadhera,SA Yadav,12,18,1,0,1,8,12,1,0,4,6,0,0
6480bba0fbf5f1671e1e557e,2013,,,1,Gurkeerat Singh,Mandeep Singh,12,11,2,0,1,2,7,0,0,9,4,2,0
6480bb9f022f0e8cd6e9cdeb,2012,,,1,AD Russell,IK Pathan,12,9,1,0,1,8,5,1,0,4,4,0,0
6480bb98af25209ef756aa2c,2021,,,2,KH Pandya,SA Yadav,12,16,0,0,1,5,11,0,0,5,5,0,0
6480bb9fe3bc767415c60bfa,2012,,,1,P Negi,Y Venugopal Rao,12,13,1,0,1,8,5,1,0,3,8,0,0
6480bb9a77f349a0fd8d96d6,2023,,,2,JC Buttler,YBK Jaiswal,12,10,3,0,1,0,4,0,0,12,6,3,0
6480bba2a215721aadf7a90a,2015,,,1,BB McCullum,DR Smith,12,16,2,0,1,6,6,1,0,6,10,1,0
6480bb9ef7c6084992b7cdf8,2012,,,2,B Chipli,DT Christian,12,15,1,0,1,8,9,1,0,4,6,0,0
6480bb96c0ffb76dab723a2b,2019,,,1,A Mishra,TA Boult,12,5,1,1,1,6,2,1,0,6,3,0,1
6480bb9809c62ba77e5df472,2021,,,2,RA Tripathi,VR Iyer,12,10,1,0,1,6,5,1,0,6,5,0,0
6480bba1bd00c57fb3301f04,2014,,,1,MK Pandey,RN ten Doeschate,12,6,1,1,1,8,3,0,1,4,3,1,0
6480bb978c66ea3d9c85132d,2020/21,,,2,DA Warner,PK Garg,12,7,0,1,1,2,3,0,0,8,4,0,1
6480bb942fc9529eb2869c17,2018,,,1,Mohammed Siraj,Washington Sundar,12,3,1,1,0,0,0,0,0,12,3,1,1
6480bb96f8379d02d3435ceb,2020/21,,,1,KD Karthik,RA Tripathi,12,9,1,0,1,5,5,0,0,7,4,1,0
6480bb9c71030f4c6f018f55,2009,,,2,S Sohal,SM Katich,12,12,0,1,1,9,12,0,1,0,0,0,0
6480bb984a44a355b856fd1a,2022,,,1,GJ Maxwell,SS Prabhudessai,12,14,2,0,1,11,9,2,0,1,5,0,0
6480bb94ee669473878c11c2,2017,,,2,CH Gayle,KM Jadhav,12,11,2,0,1,1,4,0,0,9,7,2,0
6480bb94d8ce46258c13e90e,2017,,,2,MK Tiwary,MS Dhoni,12,8,2,0,1,12,7,2,0,0,1,0,0
6480bb949a2d28d1ad7d367f,2018,,,1,G Gambhir,R Tewatia,12,10,1,0,1,4,5,0,0,8,5,1,0
6480bba2557febf92f9f79ab,2015,,,2,RN ten Doeschate,UT Yadav,12,6,1,1,1,12,5,1,1,0,1,0,0
6480bba07b5396a7b65684d3,2013,,,2,DB Das,R McLaren,12,10,1,1,1,11,8,1,1,1,2,0,0
6480bb94ca96a1c1f17d1294,2017,,,2,KM Jadhav,V Kohli,12,18,1,0,1,7,12,1,0,4,6,0,0
6480bb958c7b985a2b586a02,2018,,,2,CA Lynn,SP Narine,12,6,0,2,1,12,6,0,2,0,0,0,0
6480bb9e591b94e62772e66a,2012,,,1,KP Pietersen,NV Ojha,12,10,1,0,0,7,6,1,0,5,4,0,0
6480bba20130c44ed20c9bcf,2016,,,1,HH Pandya,PA Patel,12,12,2,0,1,2,6,0,0,9,6,2,0
6480bb99358a21ba3487db81,2023,,,1,Abdul Samad,B Kumar,12,5,0,2,0,12,5,0,2,0,0,0,0
6480bba34d78f594b07da1bc,2016,,,1,KL Rahul,SR Watson,12,6,2,0,0,11,4,2,0,1,2,0,0
6480bb9ab34d149420eae546,2023,,,2,AD Russell,RK Singh,12,12,1,1,1,7,9,0,1,5,3,1,0
6480bb9ee7a29c9b96ed61e5,2011,,,1,BA Bhatt,PP Chawla,12,11,0,2,1,0,5,0,0,12,6,0,2
6480bba3041017fe2c0593f2,2016,,,2,CH Gayle,V Kohli,12,8,1,0,1,5,6,1,0,0,2,0,0
6480bb9814efd9a91e8c911f,2021,,,1,KD Karthik,RA Tripathi,12,9,0,1,1,10,5,0,1,2,4,0,0
6480bba08ffdd4393211d261,2014,,,2,DR Smith,MS Dhoni,12,9,0,1,1,9,5,0,1,3,4,0,0
6480bba2ebdcfb98389cee5a,2015,,,2,F du Plessis,SK Raina,12,7,2,0,1,6,3,1,0,6,4,1,0
6480bb9be7cbbb90a12dc916,2009,,,1,JDP Oram,MS Dhoni,12,11,0,1,1,8,6,0,1,4,5,0,0
6480bb9deba74e341b44c765,2009/10,,,2,A Symonds,Anirudh Singh,12,17,2,0,1,2,8,0,0,9,9,2,0
6480bb97fcc6fccd233157f9,2021,,,1,Lalit Yadav,R Ashwin,12,10,0,0,0,4,4,0,0,6,6,0,0
6480bba388682c5ca10ff37a,2016,,,1,KL Rahul,SR Watson,12,10,0,1,1,4,5,0,0,8,5,0,1
6480bb99ecbdaaf953b8eee5,2023,,,1,AT Rayudu,BA Stokes,12,10,2,0,1,6,6,1,0,6,4,1,0
6480bb9f8ab73cf7c77cef03,2012,,,1,DH Yagnik,OA Shah,12,6,1,0,1,6,3,1,0,5,3,0,0
6480bb962a1612c936d161ba,2019,,,2,AT Rayudu,M Vijay,12,8,1,1,1,0,3,0,0,12,5,1,1
6480bba065b341458c934986,2013,,,2,MS Bisla,YK Pathan,12,12,2,0,1,0,5,0,0,11,7,2,0
6480bb9cb881721acc1bab60,2009,,,1,A Symonds,RG Sharma,12,5,1,1,1,7,4,0,1,4,1,1,0
6480bb9b62eb35d78fcd7df0,2007/08,,,1,DJ Hussey,T Taibu,12,15,0,0,1,5,6,0,0,7,9,0,0
6480bb9d5cca30c933d4baf4,2011,,,2,R Dravid,SA Asnodkar,12,12,2,0,1,8,7,2,0,4,5,0,0
6480bb9e5ab10d1241d6509d,2012,,,2,AD Mathews,M Manhas,12,8,0,1,1,10,5,0,1,2,3,0,0
6480bba10e78f50f124b406a,2015,,,1,SN Khan,V Kohli,12,12,0,1,1,11,7,0,1,1,5,0,0
6480bba2bbd9d85769220a68,2015,,,2,JP Duminy,SS Iyer,12,10,1,1,1,10,5,1,1,0,5,0,0
6480bb9b6ded6d116cfe02ee,2009,,,2,JP Duminy,SS Tiwary,12,7,0,0,0,8,4,0,0,4,3,0,0
6480bb9f00ef088221497043,2013,,,1,L Balaji,SMSM Senanayake,12,15,1,0,0,9,7,1,0,3,8,0,0
6480bb99e909d98c8193bac5,2023,,,1,D Padikkal,SV Samson,12,10,0,1,1,2,5,0,0,9,5,0,1
6480bb9a7194d8b20952afae,2007/08,,,1,MK Tiwary,R Bhatia,12,10,1,0,0,4,5,0,0,8,5,1,0
6480bb980ea7c3bcea4fdf9c,2022,,,2,JM Bairstow,PBB Rajapaksa,12,9,1,0,1,2,2,0,0,9,7,1,0
6480bba1ece63aa1c77a954e,2015,,,1,AM Rahane,SPD Smith,12,12,0,0,1,6,5,0,0,6,7,0,0
6480bb96e18d7a1b3e62552d,2019,,,2,DA Miller,KL Rahul,12,12,1,0,1,11,11,1,0,1,1,0,0
6480bb973da000031d26fbba,2021,,,1,Harpreet Brar,NT Ellis,12,8,0,0,0,6,4,0,0,6,4,0,0
6480bb99c6aa5989a16174d1,2023,,,1,F du Plessis,Shahbaz Ahmed,12,12,2,0,1,10,8,2,0,2,4,0,0
6480bb9561509a2f4f139254,2019,,,1,HH Pandya,KH Pandya,12,4,1,1,0,10,4,1,1,0,0,0,0
6480bb9b9dd7fe8c5cbdbab0,2009,,,1,JA Morkel,S Badrinath,12,15,0,0,1,5,7,0,0,7,8,0,0
6480bba1105add9a994c58a7,2014,,,2,AJ Finch,DA Warner,12,10,0,0,1,2,4,0,0,6,6,0,0
6480bb9763013a01eae041f2,2020/21,,,2,Abhishek Sharma,DA Warner,12,9,0,0,1,5,4,0,0,3,5,0,0
6480bb9c12f907c7b81b11a9,2009,,,1,BJ Hodge,Yashpal Singh,12,24,1,0,1,5,4,1,0,6,20,0,0
6480bb9c7ac2dca34620d56e,2009/10,,,2,JH Kallis,MK Pandey,12,15,2,0,1,7,8,1,0,5,7,1,0
6480bba3d3dc891a3092643e,2016,,,2,KJ Abbott,R Dhawan,12,5,0,1,0,1,1,0,0,11,4,0,1
6480bb9384cbae8edee3707f,2017,,,1,HH Pandya,Harbhajan Singh,12,12,0,1,1,9,10,0,1,2,2,0,0
6480bb9d918bd358d046889d,2011,,,2,AB de Villiers,V Kohli,12,8,2,0,1,5,2,1,0,7,6,1,0
6480bb982f070b023b901b3e,2021,,,1,KA Pollard,SS Tiwary,12,14,1,0,1,3,5,0,0,7,9,1,0
6480bb9c2778066dafd78a71,2009/10,,,1,M Vijay,ML Hayden,12,13,0,1,1,3,6,0,0,9,7,0,1
6480bba03ef1ed797291b091,2013,,,2,CL White,NLTC Perera,12,9,0,1,0,8,4,0,1,2,5,0,0
6480bb9b7b8617115de9683b,2007/08,,,1,RP Singh,Shahid Afridi,12,5,1,1,1,10,3,1,1,1,2,0,0
6480bb9561509a2f4f139254,2019,,,1,HH Pandya,Ishan Kishan,12,5,1,1,1,7,2,0,1,5,3,1,0
6480bb9e95693a2c4c4531e8,2011,,,1,KD Karthik,RJ Harris,12,6,2,0,1,11,5,2,0,1,1,0,0
6480bb9faf20f0bc714af2ea,2013,,,2,DPMD Jayawardene,S Nadeem,12,7,1,1,1,11,4,1,1,1,3,0,0
6480bb9a4de9fe3e7319ce39,2007/08,,,1,P Kumar,SB Joshi,12,14,0,1,1,9,6,0,1,3,8,0,0
6480bb960d5042aa46b7776b,2020/21,,,1,Q de Kock,RG Sharma,12,15,1,0,1,8,8,1,0,4,7,0,0
6480bb963c729ccbcb9446f8,2020/21,,,2,JM Bairstow,PK Garg,12,15,1,0,1,8,8,1,0,4,7,0,0
6480bb948211fe47e65f2e77,2018,,,2,E Lewis,SA Yadav,12,17,2,0,1,5,9,1,0,6,8,1,0
6480bb94566b0cf89fca84f9,2018,,,2,DJ Hooda,KS Williamson,12,13,2,0,1,1,7,0,0,10,6,2,0
6480bb99f47261f111a6cc1a,2023,,,1,Shubman Gill,WP Saha,12,13,1,0,1,8,6,1,0,4,7,0,0
6480bb96ef6f4c2c85264241,2019,,,2,E Lewis,RG Sharma,12,13,1,1,1,8,8,0,1,4,5,1,0
6480bb9ae4498012aa089436,2023,,,2,JJ Roy,N Rana,12,10,0,1,1,3,6,0,0,8,4,0,1
6480bb9ef18c54e7aafdd223,2012,,,2,DJ Hussey,P Dogra,12,13,0,1,1,7,8,0,1,2,5,0,0
6480bba0404171e13faa181e,2013,,,2,AT Rayudu,Harbhajan Singh,12,4,1,1,0,5,2,1,0,7,2,0,1
6480bb9558345af5a1bb044d,2019,,,1,PA Patel,V Kohli,12,13,1,0,1,3,4,0,0,8,9,1,0
6480bb9996eb97dd08b62f78,2023,,,1,KD Karthik,MK Lomror,12,9,2,0,1,6,3,1,0,5,6,1,0
6480bba090c88df75eba18e6,2014,,,2,S Rana,V Kohli,12,18,1,0,1,3,8,0,0,8,10,1,0
6480bba2bae80e615447f251,2015,,,2,D Wiese,MA Starc,12,12,2,0,1,11,5,2,0,1,7,0,0
6480bb9bcf9df9e7ae0416ba,2009,,,1,MV Boucher,V Kohli,12,16,0,0,1,6,8,0,0,6,8,0,0
6480bb99349f00f851e8d2fd,2023,,,1,JM Sharma,M Shahrukh Khan,12,4,0,2,1,12,4,0,2,0,0,0,0
6480bb9f210b6e50fb2072ae,2013,,,1,CH Gayle,MA Agarwal,12,15,2,0,1,5,7,1,0,6,8,1,0
6480bba2d313234709068efb,2015,,,1,LMP Simmons,MJ McClenaghan,12,4,0,2,0,0,0,0,0,12,4,0,2
6480bba1670ace74604a420f,2015,,,2,JA Morkel,Yuvraj Singh,12,8,1,0,1,2,2,0,0,9,6,1,0
6480bb980d1be75574871dcc,2022,,,1,GJ Maxwell,Shahbaz Ahmed,12,6,2,0,1,11,5,2,0,1,1,0,0
6480bb94834e2b780c4782b5,2017,,,1,CA Lynn,RV Uthappa,12,9,2,0,1,10,5,2,0,2,4,0,0
6480bb961cdee4d82c395517,2020/21,,,2,AR Patel,K Rabada,12,9,1,0,1,2,3,0,0,9,6,1,0
6480bb99cf7659c6e45bd01d,2023,,,2,AT Rayudu,DP Conway,12,14,1,0,1,9,9,1,0,3,5,0,0
6480bb9871b0ff7264721cbc,2022,,,2,N Pooran,S Gopal,12,7,1,1,1,12,5,1,1,0,2,0,0
6480bba2965d1d15aa6f723e,2016,,,2,Ishan Kishan,KD Karthik,12,13,0,1,1,2,6,0,0,9,7,0,1
6480bb9d1f9a3cf1fa86e11c,2011,,,2,DL Vettori,V Kohli,12,4,1,1,1,0,0,0,0,12,4,1,1
6480bb96fed7a7ee65076e4a,2020/21,,,2,JM Bairstow,MK Pandey,12,12,1,1,1,10,7,1,1,1,5,0,0
6480bb953b102c650968cba2,2019,,,2,KM Jadhav,RA Jadeja,12,20,0,0,0,4,5,0,0,6,15,0,0
6480bb9eee740f701b0ee154,2011,,,1,MS Dhoni,WP Saha,12,2,0,2,0,12,2,0,2,0,0,0,0
6480bba2a01f4062fc561247,2016,,,1,SE Marsh,WP Saha,12,17,0,0,1,2,3,0,0,8,14,0,0
6480bb9c761c43b2dfb9767d,2009,,,1,WA Mota,Yuvraj Singh,12,12,1,0,1,4,7,0,0,6,5,1,0
6480bb9a7194d8b20952afae,2007/08,,,1,G Gambhir,MK Tiwary,12,7,2,0,1,5,3,1,0,7,4,1,0
6480bb9575ad32214d0f6ec0,2019,,,2,S Gopal,STR Binny,12,4,0,2,1,0,1,0,0,12,3,0,2
6480bb94c008939d7976abfe,2018,,,2,CH Morris,RR Pant,12,8,2,0,1,7,4,1,0,5,4,1,0
6480bb94009d0662ee94f07b,2018,,,2,MK Pandey,Shakib Al Hasan,12,9,1,0,1,10,7,1,0,2,2,0,0
6480bba3d3dc891a3092643e,2016,,,1,GJ Bailey,UT Khawaja,12,14,2,0,1,9,11,2,0,3,3,0,0
6480bb9affabe4960a987464,2007/08,,,1,P Kumar,SB Joshi,12,12,0,1,1,6,6,0,1,3,6,0,0
6480bb9f6f311344dac147cc,2012,,,1,DB Das,YK Pathan,12,18,0,0,1,5,12,0,0,4,6,0,0
6480bb9c13fa57328b17e4e2,2009/10,,,2,JA Morkel,SK Raina,12,11,2,0,1,0,3,0,0,11,8,2,0
6480bb9f146f5849bb759148,2013,,,1,CL White,PA Reddy,12,19,0,0,1,8,14,0,0,4,5,0,0
6480bb947b065b9dc0256f0d,2018,,,2,Mandeep Singh,P Negi,12,10,0,1,1,9,6,0,1,3,4,0,0
6480bba18a289cc4b8d173a4,2014,,,2,JP Duminy,KM Jadhav,12,9,1,0,0,4,4,0,0,7,5,1,0
6480bb9506d56930505d45ae,2019,,,2,RR Pant,SS Iyer,12,10,2,0,1,6,7,1,0,5,3,1,0
6480bb9746dfc5c467942a84,2021,,,1,RD Gaikwad,SN Thakur,12,4,1,1,0,10,3,1,1,1,1,0,0
6480bb9d7aa8d2c4c947d164,2009/10,,,1,CL White,P Kumar,12,2,0,2,0,12,2,0,2,0,0,0,0
6480bba2b5d601f8354f5b5a,2016,,,2,P Sahu,Sandeep Sharma,12,7,0,1,0,11,5,0,1,1,2,0,0
6480bba21bbf76a62abea528,2016,,,1,AM Rahane,F du Plessis,12,10,2,0,1,10,7,2,0,2,3,0,0
6480bb9f54d17f50da495682,2012,,,2,DPMD Jayawardene,NV Ojha,12,17,1,0,1,8,8,1,0,3,9,0,0
6480bba10e78f50f124b406a,2015,,,2,BB McCullum,DR Smith,12,11,1,0,1,4,6,1,0,4,5,0,0
6480bb94ca96a1c1f17d1294,2017,,,2,S Aravind,YS Chahal,12,13,1,0,0,8,4,1,0,4,9,0,0
6480bb9b7557e68b433167d5,2007/08,,,2,Kamran Akmal,T Kohli,12,10,1,0,1,9,7,1,0,3,3,0,0
6480bb9ee4565d108b29626f,2012,,,2,G Gambhir,YK Pathan,12,12,0,0,1,4,6,0,0,7,6,0,0
6480bb94834e2b780c4782b5,2017,,,2,LMP Simmons,SS Tiwary,12,14,2,0,1,0,5,0,0,9,9,2,0
6480bba2679194b06d4834db,2016,,,2,HH Pandya,KH Pandya,12,10,1,0,1,2,5,0,0,9,5,1,0
6480bb94b882fb725e3f98e5,2018,,,2,KS Williamson,WP Saha,12,6,2,0,1,7,3,1,0,5,3,1,0
6480bb97e5be965d3c00760e,2021,,,2,AD Russell,VR Iyer,12,5,3,0,0,0,0,0,0,12,5,3,0
6480bb9f6b144f2a6d105b32,2013,,,1,DJ Bravo,MEK Hussey,12,19,1,0,1,5,8,0,0,6,11,1,0
6480bb9bfcaabf33b5687e32,2007/08,,,1,SA Asnodkar,YK Pathan,12,12,1,0,1,8,8,1,0,2,4,0,0
6480bb9e83b8575f74b8e962,2012,,,2,AB de Villiers,V Kohli,12,6,1,0,1,4,2,1,0,4,4,0,0
6480bb95945c5e5dc4d8c7d6,2019,,,2,AB de Villiers,S Dube,12,9,0,1,0,3,4,0,0,9,5,0,1
6480bb9d716a89dbf5e486d0,2011,,,2,IK Pathan,RE van der Merwe,12,7,2,0,0,8,4,2,0,2,3,0,0
6480bb9fe7d0f611ba6ad229,2012,,,1,AD Mathews,AP Majumdar,12,16,1,0,1,4,10,0,0,7,6,1,0
6480bb976caaa0cc91f652c7,2021,,,2,N Rana,RA Tripathi,12,6,2,0,0,5,2,1,0,7,4,1,0
6480bb97c48a16e84b55a325,2020/21,,,1,AB de Villiers,Washington Sundar,12,9,1,0,1,7,3,1,0,5,6,0,0
6480bba3412663673a969a24,2016,,,2,AM Rahane,MS Dhoni,12,10,0,1,1,2,2,0,0,9,8,0,1
6480bb9ddfb0f2f6f8e813e5,2011,,,2,IK Pathan,RE van der Merwe,12,8,1,0,1,6,4,1,0,2,4,0,0
6480bb9de80788b3c3ebe4e1,2009/10,,,2,SR Tendulkar,ST Jayasuriya,12,9,2,0,1,10,7,2,0,1,2,0,0
6480bba1587a54176a9badf4,2014,,,1,MK Pandey,RV Uthappa,12,17,1,0,1,2,7,0,0,9,10,1,0
6480bb9e713e850d3dd0cba9,2012,,,1,KK Cooper,OA Shah,12,9,0,0,0,5,5,0,0,6,4,0,0
6480bb953b102c650968cba2,2019,,,1,MM Ali,PA Patel,12,11,0,1,1,9,8,0,1,3,3,0,0
6480bba1d3370c13ea1f79f3,2014,,,1,PA Patel,V Kohli,12,16,0,0,1,1,5,0,0,10,11,0,0
6480bb9c13817091131f76e3,2009/10,,,2,Bipul Sharma,S Sreesanth,12,5,3,0,0,0,0,0,0,12,5,3,0
6480bb9c8c6c106c6ffbeae4,2009/10,,,1,R Vinay Kumar,V Kohli,12,7,1,0,1,2,2,0,0,9,5,1,0
6480bba20130c44ed20c9bcf,2016,,,2,AJ Finch,BB McCullum,12,9,1,1,1,6,5,1,0,6,4,0,1
6480bba120182b9ca0b70004,2014,,,2,DJG Sammy,KL Rahul,12,4,1,1,1,10,4,1,1,0,0,0,0
6480bb9cf1471ad233c7b0af,2009,,,1,G Gambhir,V Sehwag,12,15,1,0,1,8,8,1,0,2,7,0,0
6480bb9a6e44b0c8da00ca72,2007/08,,,1,B Lee,VRV Singh,12,4,1,1,1,7,2,0,1,4,2,1,0
6480bba2aecb4103bab63c15,2016,,,2,PP Chawla,R Sathish,12,5,1,1,1,5,2,1,0,7,3,0,1
6480bb95c28e7980e1768064,2018,,,2,JC Archer,JC Buttler,12,5,0,1,0,0,0,0,0,12,5,0,1
6480bba19cc161a3fb8a8795,2014,,,1,GJ Bailey,WP Saha,12,22,0,0,1,8,14,0,0,3,8,0,0
6480bb9c5ec0713155cad138,2009/10,,,1,Anirudh Singh,RG Sharma,12,13,1,0,1,5,5,0,0,7,8,1,0
6480bb9a7577454a5220c94b,2007/08,,,2,GC Smith,SA Asnodkar,12,14,1,0,1,5,9,0,0,7,5,1,0
6480bb9ee779ef1e445d0506,2012,,,2,RV Uthappa,WD Parnell,12,7,2,0,1,7,4,1,0,5,3,1,0
6480bba273adb498d96b27a9,2016,,,2,PP Chawla,RV Uthappa,12,10,2,0,1,8,5,2,0,3,5,0,0
6480bb984f0f3dc0df6d4531,2022,,,1,Ishan Kishan,Tilak Varma,12,9,2,0,1,5,5,1,0,7,4,1,0
6480bb97372fc5d5ef4c436a,2021,,,1,Lalit Yadav,TK Curran,12,13,2,0,1,6,9,1,0,6,4,1,0
6480bb98f98edd45b1ccb406,2022,,,2,AJ Finch,N Rana,12,12,1,0,1,10,7,1,0,1,5,0,0
6480bb9e95693a2c4c4531e8,2011,,,2,M Morkel,Y Nagar,12,5,2,0,1,3,2,0,0,8,3,2,0
6480bb95fa6394e733c532a9,2018,,,2,KD Karthik,N Rana,12,10,1,0,1,4,5,0,0,7,5,1,0
6480bb9894cc2d00f057a1f1,2021,,,1,S Dhawan,SS Iyer,12,16,0,0,1,4,5,0,0,8,11,0,0
6480bb9f5867d07199aa832a,2013,,,1,MS Dhoni,RA Jadeja,12,10,0,1,1,4,6,0,0,8,4,0,1
6480bb99d43295fa2d82c9dc,2023,,,2,Aman Hakim Khan,Lalit Yadav,12,11,0,1,1,8,4,0,1,4,7,0,0
6480bba2a215721aadf7a90a,2015,,,2,DJ Hooda,KK Nair,12,11,1,0,1,8,6,1,0,2,5,0,0
6480bba3de527604cd2f96f3,2016,,,2,DA Warner,EJG Morgan,12,11,0,0,1,9,8,0,0,3,3,0,0
6480bb95f2e3c32afe233820,2018,,,1,Shakib Al Hasan,YK Pathan,12,8,2,0,1,9,5,2,0,3,3,0,0
6480bba237377ccc608266d2,2016,,,1,M Vohra,SE Marsh,12,12,0,0,1,6,7,0,0,6,5,0,0
6480bb957e6d387fe3a6b26e,2018,,,2,PA Patel,V Kohli,12,9,2,0,1,5,4,1,0,7,5,1,0
6480bb9a1e358307d26cd50d,2023,,,2,C Green,RG Sharma,12,6,2,0,0,4,3,1,0,7,3,1,0
6480bba0a9f68a29bda72302,2013,,,1,DB Das,R Bhatia,12,11,1,0,1,2,2,0,0,10,9,1,0
6480bb96b7b695186bbb6a3e,2019,,,1,Ishan Kishan,KA Pollard,12,13,0,1,1,3,6,0,0,9,7,0,1
6480bb9bb070eb19f9ac8a76,2007/08,,,1,DPMD Jayawardene,LA Pomersbach,12,8,0,1,1,3,4,0,0,7,4,0,1
6480bb983ad1bab18d1d8774,2022,,,1,N Rana,SS Iyer,12,6,1,1,1,10,5,1,1,1,1,0,0
6480bb9bcf9df9e7ae0416ba,2009,,,1,JH Kallis,RV Uthappa,12,15,0,1,1,9,9,0,1,2,6,0,0
6480bb990942cd416cf5f447,2022,,,2,DJ Hooda,KH Pandya,12,10,2,0,1,7,5,1,0,5,5,1,0
6480bba0c7bf2b92ac8d836a,2013,,,2,DH Yagnik,SV Samson,12,9,2,0,1,10,6,2,0,2,3,0,0
6480bb97c92184fed1a879f3,2021,,,2,D Padikkal,DT Christian,12,14,2,0,1,10,10,2,0,1,4,0,0
6480bb9a58bc8710c38f4c1c,2023,,,1,DJ Hooda,Q de Kock,12,13,0,1,1,5,7,0,0,7,6,0,1
6480bba06e8cb70fb4bdc83e,2013,,,2,CL White,KC Sangakkara,12,15,1,0,1,7,8,1,0,5,7,0,0
6480bb9f014bd6e0ac2b51a8,2013,,,2,AT Rayudu,KA Pollard,12,6,0,1,0,2,2,0,0,10,4,0,1
6480bb9b1fc007965b68d4d9,2009,,,1,HH Gibbs,RG Sharma,12,11,1,0,1,8,6,1,0,3,5,0,0
6480bb96e76ccde6082d7564,2020/21,,,1,RA Tripathi,Shubman Gill,12,16,2,0,1,4,10,1,0,7,6,1,0
6480bb9506d56930505d45ae,2019,,,1,GC Viljoen,Harpreet Brar,12,5,0,1,0,2,3,0,0,7,2,0,1
6480bb95b33a36f0dd77d1a1,2018,,,1,HH Pandya,KH Pandya,12,15,0,0,1,8,8,0,0,3,7,0,0
6480bba3b818a7cff6fe4f89,2016,,,1,DA Warner,S Dhawan,12,12,2,0,1,2,2,0,0,10,10,2,0
6480bb9e21655ee16a96b2c3,2012,,,2,AM Rahane,BJ Hodge,12,8,2,0,0,11,6,2,0,1,2,0,0
6480bb9ee4565d108b29626f,2012,,,2,DB Das,YK Pathan,12,8,1,0,1,7,3,1,0,5,5,0,0
6480bb979e91d1ff9b54c737,2020/21,,,1,AR Patel,SS Iyer,12,12,1,0,1,9,9,1,0,2,3,0,0
6480bb95ea40317152ed9ca5,2018,,,2,DJ Bravo,RA Jadeja,12,8,0,1,1,1,2,0,0,10,6,0,1
6480bb95385ebb9bda58a643,2019,,,1,Q de Kock,SA Yadav,12,12,1,0,1,7,5,1,0,5,7,0,0
6480bb9ab34d149420eae546,2023,,,1,K Gowtham,N Pooran,12,3,0,2,1,0,0,0,0,12,3,0,2
6480bb9bb070eb19f9ac8a76,2007/08,,,2,LPC Silva,SB Styris,12,7,0,1,0,10,5,0,1,1,2,0,0
6480bb9c1e676472f4841aa9,2009/10,,,2,M Vijay,SK Raina,12,11,0,1,1,2,4,0,0,9,7,0,1
6480bb9e59fe7a0f48b7f9b9,2012,,,1,DPMD Jayawardene,V Sehwag,12,13,2,0,1,7,7,1,0,5,6,1,0
6480bb9cdf6c63fec90a42df,2009/10,,,1,OA Shah,SC Ganguly,12,8,2,0,1,5,4,1,0,7,4,1,0
6480bb9db6a011b38afed5dc,2011,,,1,RV Uthappa,Yuvraj Singh,12,9,1,0,1,6,3,1,0,6,6,0,0
6480bb9c4934a2adde9d76ce,2009/10,,,1,KA Pollard,SR Tendulkar,12,11,1,0,1,7,7,1,0,5,4,0,0
6480bb9a4de9fe3e7319ce39,2007/08,,,1,MV Boucher,V Kohli,12,14,0,1,1,3,4,0,0,9,10,0,1
6480bb99f816e64203e3c687,2023,,,2,Rahmanullah Gurbaz,VR Iyer,12,14,2,0,1,11,13,2,0,1,1,0,0
6480bb97b97c36ac8be3582f,2021,,,2,B Kumar,Rashid Khan,12,8,1,0,1,1,1,0,0,10,7,1,0
6480bb9d69cb9046a72d8fbe,2009/10,,,1,M Vijay,ML Hayden,12,12,2,0,1,2,3,0,0,8,9,2,0
6480bb9480627b50308b7903,2017,,,2,HH Pandya,KH Pandya,12,11,1,0,1,4,5,0,0,8,6,1,0
6480bb9fd9db46138a9bb209,2013,,,1,MS Dhoni,S Badrinath,12,11,1,0,1,3,3,0,0,9,8,1,0
6480bba0e52e9733fc6d9937,2013,,,2,Mandeep Singh,SE Marsh,12,12,2,0,1,9,8,2,0,2,4,0,0
6480bb93d9581d69657887c3,2017,,,2,PJ Cummins,RR Pant,12,9,2,0,1,6,6,1,0,6,3,1,0
6480bb9dfa7d0510ae3a7b40,2011,,,2,B Chipli,CL White,12,8,1,0,0,5,3,0,0,7,5,1,0
6480bb954817ed0a4ba25bc2,2018,,,1,KH Pandya,RG Sharma,12,16,0,0,1,6,6,0,0,6,10,0,0
6480bb9ed74d222a3da56dfa,2012,,,1,AB de Villiers,V Kohli,12,14,2,0,1,6,4,1,0,6,10,1,0
6480bba1d3b4ddc36050e3f3,2014,,,2,PP Chawla,SP Narine,12,7,2,0,1,12,7,2,0,0,0,0,0
6480bb98c0ad46409044aad2,2022,,,1,MS Dhoni,RA Jadeja,12,12,1,0,1,3,6,0,0,9,6,1,0
6480bba177ab201442a0e3c8,2015,,,2,KS Williamson,S Dhawan,12,12,0,0,1,5,9,0,0,3,3,0,0
6480bb9dd89d4266d59a4592,2011,,,1,AB de Villiers,M Kaif,12,8,0,1,1,8,4,0,1,3,4,0,0
6480bb9ca21b98f1be8254e2,2009/10,,,2,JH Kallis,V Kohli,12,9,1,0,1,4,4,0,0,8,5,1,0
6480bba10e78f50f124b406a,2015,,,2,F du Plessis,R Ashwin,12,5,2,0,1,5,2,1,0,5,3,1,0
6480bb9c6f1c8ea3dc73226f,2009/10,,,2,KA Pollard,SS Tiwary,12,9,1,0,1,6,5,1,0,4,4,0,0
6480bb9d8f5769d3a514fd88,2009/10,,,1,DW Steyn,LRPL Taylor,12,9,2,0,1,5,5,1,0,7,4,1,0
6480bba2256bfaaf14c57ead,2015,,,1,SR Watson,SV Samson,12,12,1,0,1,4,3,0,0,8,9,1,0
6480bb9eeeaf037e5e41ab86,2012,,,2,JP Faulkner,P Kumar,12,7,0,1,1,2,1,0,0,10,6,0,1
6480bb94aad1a08ca4276b4e,2018,,,1,AR Patel,R Ashwin,12,8,2,0,1,1,2,0,0,11,6,2,0
6480bb9c968c81bdfcc6df5b,2009,,,1,KD Karthik,TM Dilshan,12,11,0,1,1,9,8,0,1,2,3,0,0
6480bb998454ba791a8fdbf8,2023,,,1,DA Warner,Lalit Yadav,12,11,1,0,1,10,7,1,0,2,4,0,0
6480bb99ecbdaaf953b8eee5,2023,,,1,AT Rayudu,MS Dhoni,12,3,0,2,1,0,0,0,0,12,3,0,2
6480bb949a2d28d1ad7d367f,2018,,,1,C Munro,G Gambhir,12,15,0,0,1,4,6,0,0,7,9,0,0
6480bba0404171e13faa181e,2013,,,1,DB Das,MK Tiwary,12,10,1,0,1,6,6,1,0,5,4,0,0
6480bba07fa24b891b818984,2013,,,2,Harbhajan Singh,NM Coulter-Nile,12,9,0,1,1,3,3,0,0,9,6,0,1
6480bba2e8614b1263627c1b,2015,,,1,STR Binny,SV Samson,12,3,0,2,1,0,0,0,0,12,3,0,2
6480bba28257fe87dd859e3e,2015,,,2,KA Pollard,LMP Simmons,12,9,1,0,1,6,5,0,0,6,4,1,0
6480bb963c729ccbcb9446f8,2020/21,,,2,DA Warner,MK Pandey,12,13,0,0,1,4,6,0,0,6,7,0,0
6480bb93ff8d1f4cd07859ce,2017,,,1,DA Warner,S Dhawan,12,12,1,0,1,4,7,0,0,7,5,1,0
6480bb9f23c17ccb47aa9e58,2013,,,2,Azhar Mahmood,RJ Harris,12,9,2,0,1,10,6,2,0,2,3,0,0
6480bb9834c7569d5fa64353,2022,,,1,MS Wade,Shubman Gill,12,8,3,0,1,12,6,3,0,0,2,0,0
6480bb976caaa0cc91f652c7,2021,,,1,Q de Kock,SA Yadav,11,17,0,0,1,5,7,0,0,5,10,0,0
6480bb9a7d91d721555835e5,2007/08,,,1,GC Smith,SA Asnodkar,11,12,2,0,1,2,7,0,0,9,5,2,0
6480bb9e300070746cc2eb67,2011,,,1,JA Morkel,SK Raina,11,8,0,1,1,2,4,0,0,8,4,0,1
6480bb945f95e767a8a9cc10,2017,,,2,JP Faulkner,KD Karthik,11,14,0,0,1,6,7,0,0,4,7,0,0
6480bb95085c25712f29bd36,2019,,,2,AT Rayudu,KM Jadhav,11,11,2,0,1,2,2,0,0,9,9,2,0
6480bb96d1b3bea0aa2127e4,2020/21,,,2,KD Karthik,SP Narine,11,13,2,0,1,9,8,2,0,2,5,0,0
6480bb957e6d387fe3a6b26e,2018,,,1,SS Iyer,V Shankar,11,13,1,0,1,3,4,0,0,8,9,1,0
6480bb9ee779ef1e445d0506,2012,,,2,MN Samuels,SPD Smith,11,7,1,0,1,4,4,0,0,7,3,1,0
6480bb984f6c41cd28aa0353,2022,,,1,KL Rahul,MK Pandey,11,10,1,1,1,0,0,0,0,11,10,1,1
6480bba0fbf5f1671e1e557e,2013,,,2,AB de Villiers,V Kohli,11,10,1,0,1,8,7,1,0,2,3,0,0
6480bb9b166300b6298fc71a,2009,,,2,NV Ojha,RA Jadeja,11,4,1,1,1,6,2,0,1,5,2,1,0
6480bb9fc28e897b3c53f359,2012,,,1,MEK Hussey,MS Dhoni,11,6,2,0,1,6,4,1,0,5,2,1,0
6480bb982f070b023b901b3e,2021,,,1,J Yadav,KH Pandya,11,4,1,1,1,11,4,1,1,0,0,0,0
6480bb9a81d7fd0ac0307b4d,2023,,,2,KH Pandya,KR Mayers,11,9,1,0,1,0,1,0,0,9,8,1,0
6480bb98de3641699db2c5a1,2021,,,1,RD Gaikwad,RV Uthappa,11,12,1,0,1,6,5,1,0,5,7,0,0
6480bb97ea8bfb43e3f7515f,2020/21,,,2,F du Plessis,M Vijay,11,10,1,0,1,9,5,1,0,1,5,0,0
6480bb9873e53eace3a69dc7,2022,,,1,A Manohar,R Tewatia,11,8,1,0,1,2,4,0,0,8,4,1,0
6480bb9c13817091131f76e3,2009/10,,,2,AB Barath,RS Bopara,11,15,1,0,1,7,10,1,0,4,5,0,0
6480bb9797043717cd96890a,2021,,,1,E Lewis,YBK Jaiswal,11,7,2,0,1,6,4,1,0,5,3,1,0
6480bb94009d0662ee94f07b,2018,,,1,E Lewis,RG Sharma,11,12,1,1,1,0,2,0,0,11,10,1,1
6480bba2b7be71a15b2bb3de,2015,,,2,MS Dhoni,SK Raina,11,10,1,0,1,5,6,0,0,6,4,1,0
6480bb954714437843ab3647,2019,,,1,PP Shaw,S Dhawan,11,11,1,0,1,4,5,0,0,7,6,1,0
6480bba234aac105851964b1,2015,,,2,CH Gayle,Mandeep Singh,11,13,1,0,1,7,6,1,0,4,7,0,0
6480bb9ff2e0b1df0c3972c9,2012,,,2,DJ Hussey,N Saini,11,11,1,0,1,2,2,0,0,9,9,1,0
6480bba21bbf76a62abea528,2016,,,1,MS Dhoni,NLTC Perera,11,7,0,1,1,2,3,0,0,8,4,0,1
6480bb9ce544a2fc17a48bee,2009,,,1,LRPL Taylor,RV Uthappa,11,10,0,0,1,7,4,0,0,4,6,0,0
6480bb99a620a7afdb3217fe,2023,,,2,AR Patel,DA Warner,11,11,1,0,1,2,6,0,0,7,5,1,0
6480bb9574ca455ec008e942,2018,,,1,DJ Hooda,YK Pathan,11,10,0,1,1,9,6,0,1,2,4,0,0
6480bba19cc161a3fb8a8795,2014,,,2,KA Pollard,LMP Simmons,11,10,0,1,0,8,6,0,1,3,4,0,0
6480bba20130c44ed20c9bcf,2016,,,1,AT Rayudu,KH Pandya,11,8,1,0,1,5,5,0,0,5,3,1,0
6480bba090c88df75eba18e6,2014,,,2,JA Morkel,V Kohli,11,20,1,0,1,7,13,1,0,2,7,0,0
6480bb9b0e32875998e9bfdc,2009,,,2,GC Smith,SA Asnodkar,11,8,1,1,1,0,0,0,0,11,8,1,1
6480bb9e28b7a946a6921fa6,2011,,,2,R Sathish,SL Malinga,11,7,0,1,1,4,2,0,0,7,5,0,1
6480bb9c7a11e1cbeea46b0e,2009/10,,,1,R Sathish,SS Tiwary,11,6,1,0,1,5,4,1,0,1,2,0,0
6480bb9d918bd358d046889d,2011,,,2,CA Pujara,SS Tiwary,11,20,0,0,1,7,12,0,0,4,8,0,0
6480bba33195e5ebac1da82a,2016,,,1,JC Buttler,N Rana,11,11,0,1,1,3,5,0,0,8,6,0,1
6480bb974123cbc9756ceefa,2021,,,1,GJ Maxwell,Shahbaz Ahmed,11,6,1,0,1,7,4,1,0,2,2,0,0
6480bb9dc4ec5a52f8bcc465,2009/10,,,1,IK Pathan,RS Sodhi,11,5,2,0,0,7,3,1,0,4,2,1,0
6480bba287d112bccc55ccd2,2015,,,2,AB de Villiers,CH Gayle,11,10,0,0,1,5,5,0,0,4,5,0,0
6480bba1dd2f8125fc8b203f,2014,,,2,CA Pujara,WP Saha,11,8,2,0,1,10,7,2,0,1,1,0,0
6480bb9d1ed71a4f47892d00,2009/10,,,2,FY Fazal,SK Warne,11,11,1,0,1,8,8,1,0,1,3,0,0
6480bba0ddcc30675d83403c,2013,,,1,MEK Hussey,SK Raina,11,11,0,0,1,1,3,0,0,9,8,0,0
6480bb9f895e5780080c8059,2012,,,1,AC Gilchrist,PC Valthaty,11,14,2,0,1,9,6,2,0,2,8,0,0
6480bb9bfcaabf33b5687e32,2007/08,,,2,DR Smith,MK Pandey,11,10,1,0,1,7,4,1,0,3,6,0,0
6480bb9996eb97dd08b62f78,2023,,,1,MK Lomror,Shahbaz Ahmed,11,6,0,0,0,2,3,0,0,5,3,0,0
6480bba2ad3f26917361061f,2016,,,2,Q de Kock,SS Iyer,11,6,1,0,1,5,2,1,0,0,4,0,0
6480bb948a69b3d86293b12b,2017,,,2,KK Nair,SV Samson,11,9,2,0,1,1,2,0,0,10,7,2,0
6480bb9d3c4dfa9f054aa47f,2011,,,2,AL Menaria,AM Rahane,11,14,0,0,1,5,5,0,0,6,9,0,0
6480bb9db6a011b38afed5dc,2011,,,2,BJ Hodge,PA Patel,11,12,2,0,1,1,3,0,0,10,9,2,0
6480bb9edd901481f13ce9ba,2012,,,1,DJ Hussey,Mandeep Singh,11,6,1,0,1,7,4,1,0,3,2,0,0
6480bb945460b25d997060fb,2018,,,2,Mohammed Shami,S Nadeem,11,12,1,0,1,6,5,1,0,5,7,0,0
6480bba192383a244f185c5a,2014,,,1,LR Shukla,M Vijay,11,6,0,1,1,0,2,0,0,9,4,0,1
6480bb97fb920d483d0da2af,2020/21,,,2,Mujeeb Ur Rahman,N Pooran,11,8,2,0,1,1,3,0,0,10,5,2,0
6480bba000b91f6c5cf57fdb,2013,,,2,SR Watson,SV Samson,11,19,0,0,1,6,12,0,0,5,7,0,0
6480bb9fc3369c6f5a549d05,2013,,,1,DA Warner,V Sehwag,11,9,0,1,1,1,4,0,0,8,5,0,1
6480bb94f06c6048c8088194,2018,,,1,BA Stokes,SV Samson,11,13,1,0,1,5,8,0,0,6,5,1,0
6480bb95fa6394e733c532a9,2018,,,2,AD Russell,KD Karthik,11,7,2,0,1,4,4,1,0,6,3,1,0
6480bb9f02801d2090cdba0d,2012,,,1,M Manhas,WD Parnell,11,8,1,0,1,8,4,1,0,2,4,0,0
6480bb9bc80883a975281815,2009,,,1,R Dravid,V Kohli,11,18,0,0,1,8,10,0,0,3,8,0,0
6480bba0295edd6084b9503b,2014,,,2,AM Rahane,SV Samson,11,18,1,0,1,8,9,1,0,3,9,0,0
6480bb9a6e44b0c8da00ca72,2007/08,,,2,MA Khote,SM Pollock,11,12,1,0,1,3,4,0,0,8,8,1,0
6480bb94ca96a1c1f17d1294,2017,,,2,S Badree,V Kohli,11,11,0,1,1,2,7,0,0,8,4,0,1
6480bb9a36f2ab9a44baa0f8,2023,,,1,JC Buttler,YBK Jaiswal,11,10,2,0,1,8,6,2,0,1,4,0,0
6480bb98373b1ea5035ab3da,2021,,,2,EJG Morgan,KD Karthik,11,9,0,1,1,2,2,0,0,9,7,0,1
6480bb951354c40599b60208,2018,,,1,DJ Hooda,YK Pathan,11,7,0,1,1,3,4,0,0,8,3,0,1
6480bb980ea7c3bcea4fdf9c,2022,,,2,JM Bairstow,R Dhawan,11,12,2,0,1,11,7,2,0,0,5,0,0
6480bb9525c593ee45bb038c,2019,,,1,Q de Kock,SA Yadav,11,6,2,0,1,0,0,0,0,11,6,2,0
6480bb9da9ca2f2d3738d79e,2011,,,2,RV Uthappa,WD Parnell,11,8,1,0,1,7,5,1,0,4,3,0,0
6480bb9d1f9a3cf1fa86e11c,2011,,,2,MA Agarwal,V Kohli,11,12,1,0,1,8,5,1,0,3,7,0,0
6480bb971ffe5345804e7f32,2020/21,,,2,RV Uthappa,SV Samson,11,9,1,0,1,6,5,1,0,3,4,0,0
6480bb9f777b7b1e89543a6e,2013,,,1,AM Rahane,STR Binny,11,9,0,0,1,6,5,0,0,4,4,0,0
6480bb972a7d4e1071ea662e,2021,,,2,PP Shaw,S Dhawan,11,9,2,0,1,7,5,1,0,4,4,1,0
6480bb9cff4ec2f71cdf18d1,2009/10,,,1,DJ Bravo,SS Tiwary,11,7,0,1,1,8,4,0,1,2,3,0,0
6480bb951677500061c85592,2019,,,1,KA Pollard,RD Chahar,11,9,2,0,1,1,2,0,0,10,7,2,0
6480bb9575ad32214d0f6ec0,2019,,,1,DA Miller,N Pooran,11,8,1,0,1,5,2,1,0,5,6,0,0
6480bb9d40fc01528c7b7270,2009/10,,,2,KP Pietersen,V Kohli,11,7,2,0,1,1,2,0,0,10,5,2,0
6480bb98adf21699eaa67796,2022,,,2,M Theekshana,Simarjeet Singh,11,4,0,1,0,7,4,0,1,0,0,0,0
6480bb95b33a36f0dd77d1a1,2018,,,1,HH Pandya,Ishan Kishan,11,6,2,0,1,4,1,1,0,7,5,1,0
6480bba328f7475f4b87d3ff,2016,,,2,MK Pandey,RV Uthappa,11,7,1,1,1,1,3,0,0,10,4,1,1
6480bba00be5cdbaf6648462,2013,,,2,M Vijay,MEK Hussey,11,9,1,0,1,5,4,0,0,6,5,1,0
6480bb9ec07aa72ec89917f0,2012,,,2,DJ Bravo,JA Morkel,11,9,1,0,1,9,7,1,0,2,2,0,0
6480bb9836d24b9817a35f7d,2022,,,2,MS Wade,V Shankar,11,10,1,0,1,5,4,1,0,4,6,0,0
6480bba3041017fe2c0593f2,2016,,,1,DS Kulkarni,P Kumar,11,5,2,0,1,9,3,2,0,1,2,0,0
6480bba097818bcc0db9555d,2014,,,2,AJ Finch,S Dhawan,11,8,0,1,1,9,5,0,1,1,3,0,0
6480bb9fe489b0d429e97599,2012,,,1,TM Dilshan,V Kohli,11,15,1,0,1,2,6,0,0,9,9,1,0
6480bb96e834e1c16b33f325,2020/21,,,1,GJ Maxwell,KL Rahul,11,9,2,0,1,10,5,2,0,1,4,0,0
6480bb945460b25d997060fb,2018,,,2,G Gambhir,RR Pant,11,7,1,0,1,1,2,0,0,7,5,1,0
6480bb99af95c6c90c4c3924,2023,,,2,HC Brook,MA Agarwal,11,10,2,0,1,9,7,2,0,1,3,0,0
6480bb9c963968000dfd00d1,2009/10,,,2,PP Chawla,RR Powar,11,5,2,0,0,8,4,2,0,2,1,0,0
6480bb9d22388e966342dba8,2009/10,,,1,S Anirudha,SK Raina,11,3,1,0,0,6,3,1,0,0,0,0,0
6480bb9a1032ce724214f6dd,2007/08,,,2,PJ Sangwan,R Bhatia,11,7,0,1,1,2,4,0,0,7,3,0,1
6480bb99b4febfb641fddd39,2023,,,1,Ishan Kishan,RG Sharma,11,15,2,0,1,10,13,2,0,1,2,0,0
6480bba31cc11024436836b5,2016,,,2,Q de Kock,RR Pant,11,9,0,1,1,2,5,0,0,8,4,0,1
6480bb9e502d7987de08e5d5,2012,,,2,CL White,PA Patel,11,12,2,0,1,5,7,1,0,5,5,1,0
6480bba069c0322e91e50958,2013,,,1,GH Vihari,PA Patel,11,12,0,0,1,3,9,0,0,2,3,0,0
6480bb97e5be965d3c00760e,2021,,,1,GJ Maxwell,Sachin Baby,11,19,0,0,1,4,7,0,0,6,12,0,0
6480bb9f6b144f2a6d105b32,2013,,,1,AS Rajpoot,MS Dhoni,11,8,0,1,1,0,1,0,0,9,7,0,1
6480bb9a0a8baa96f94e8db9,2023,,,2,MP Stoinis,N Pooran,11,11,0,1,1,2,4,0,0,9,7,0,1
6480bb9f5867d07199aa832a,2013,,,1,JA Morkel,MS Dhoni,11,10,0,1,1,9,6,0,1,2,4,0,0
6480bba2a94dd2c01769b3ae,2016,,,1,Ishan Kishan,RA Jadeja,11,6,0,1,1,2,2,0,0,8,4,0,1
6480bb9e713e850d3dd0cba9,2012,,,2,MK Tiwary,R Bhatia,11,12,1,0,1,3,4,0,0,8,8,1,0
6480bb97372fc5d5ef4c436a,2021,,,1,AM Rahane,S Dhawan,11,7,2,0,1,5,3,1,0,6,4,1,0
6480bb98c0ad46409044aad2,2022,,,1,MM Ali,RD Gaikwad,11,12,1,0,1,5,7,0,0,6,5,1,0
6480bb9b95eac8df5d0180b0,2007/08,,,1,TM Dilshan,V Sehwag,11,9,1,0,1,8,6,1,0,2,3,0,0
6480bb96e18d7a1b3e62552d,2019,,,2,CH Gayle,KL Rahul,11,13,2,0,1,4,3,1,0,5,10,1,0
6480bba0ad06ad631cf7665f,2014,,,1,M Manhas,R Ashwin,11,5,1,0,1,9,4,1,0,1,1,0,0
6480bb9be88c31fc563da86f,2009,,,2,KC Sangakkara,SM Katich,11,10,1,0,1,6,8,1,0,1,2,0,0
6480bb991a4f7e5f59dd1afc,2023,,,1,HC Brook,RA Tripathi,11,5,2,0,1,1,1,0,0,9,4,2,0
6480bb9c620c92d09ba1b6b9,2009,,,2,M Morkel,RA Jadeja,11,10,1,0,1,8,8,1,0,2,2,0,0
6480bb94009d0662ee94f07b,2018,,,2,KS Williamson,S Dhawan,11,7,2,0,1,6,4,1,0,5,3,1,0
6480bb9932735ca83d38f6e7,2022,,,1,SS Iyer,SW Billings,11,12,1,0,1,8,7,1,0,3,5,0,0
6480bba0a4e7c61a5656729e,2014,,,1,V Sehwag,WP Saha,11,10,2,0,1,9,4,2,0,2,6,0,0
6480bb9bfcaabf33b5687e32,2007/08,,,2,AM Nayar,SR Tendulkar,11,11,1,0,1,8,6,1,0,3,5,0,0
6480bba08ffdd4393211d261,2014,,,1,AJ Finch,DJG Sammy,11,14,1,0,1,3,8,0,0,6,6,1,0
6480bb9e9f1ef9ac02266570,2011,,,1,B Chipli,DW Steyn,11,6,1,0,1,0,0,0,0,11,6,1,0
6480bb9993e6e474a4e37366,2023,,,1,T Stubbs,TH David,11,18,0,0,1,5,10,0,0,6,8,0,0
6480bb9f03dd3a09740f0bd0,2013,,,1,AM Rahane,SR Watson,11,15,1,0,1,4,5,0,0,5,10,1,0
6480bba0587190387a754733,2013,,,1,DA Warner,UBT Chand,11,9,1,1,1,4,6,1,0,7,3,0,1
6480bb9938b659481e3ab6dc,2022,,,1,JC Buttler,YBK Jaiswal,11,12,2,0,1,8,4,2,0,3,8,0,0
6480bb9bcf9df9e7ae0416ba,2009,,,1,D du Preez,R Vinay Kumar,11,12,0,1,1,1,3,0,0,10,9,0,1
6480bb94ca96a1c1f17d1294,2017,,,2,TM Head,V Kohli,11,12,1,0,1,2,5,0,0,9,7,1,0
6480bb949f5853dfe76c99d9,2017,,,1,MS Dhoni,RA Tripathi,11,14,1,0,1,8,10,1,0,2,4,0,0
6480bba25855b7a7195a9bc5,2016,,,1,Q de Kock,SS Iyer,11,12,2,0,1,9,7,2,0,2,5,0,0
6480bb9d867c041656e9a75f,2009/10,,,2,AC Gilchrist,MD Mishra,11,10,2,0,1,10,9,2,0,1,1,0,0
6480bb9c442caaabe9eb2275,2009,,,1,AB de Villiers,KD Karthik,11,6,2,0,0,6,3,1,0,5,3,1,0
6480bb982fc21d541267f7b9,2022,,,2,AM Rahane,SS Iyer,11,10,1,0,1,9,7,1,0,2,3,0,0
6480bba2f39653e2f61baca2,2015,,,1,Harbhajan Singh,RG Sharma,11,6,1,1,1,5,4,1,0,6,2,0,1
6480bb97ce981c1918dce924,2021,,,2,MK Pandey,Rashid Khan,11,7,2,0,1,2,2,0,0,9,5,2,0
6480bb9f022f0e8cd6e9cdeb,2012,,,2,CH Gayle,TM Dilshan,11,14,2,0,1,1,7,0,0,10,7,2,0
6480bb9ed74d222a3da56dfa,2012,,,2,B Lee,R Bhatia,11,3,1,1,0,7,2,0,1,4,1,1,0
6480bba19cc161a3fb8a8795,2014,,,1,AR Patel,GJ Bailey,11,9,2,0,1,6,6,1,0,5,3,1,0
6480bb9b6ded6d116cfe02ee,2009,,,2,DJ Bravo,JP Duminy,11,11,1,0,1,3,5,0,0,7,6,1,0
6480bb9b2ca4a7b325526f1f,2009,,,2,AS Raut,SM Harwood,11,10,1,0,0,6,3,1,0,3,7,0,0
6480bb9fe8f5df13fc8d1bc3,2012,,,1,JH Kallis,MK Tiwary,11,15,1,0,1,4,8,0,0,7,7,1,0
6480bb9f5867d07199aa832a,2013,,,1,CH Morris,R Ashwin,11,5,2,0,0,0,0,0,0,11,5,2,0
6480bb9822eeb0c1c117f221,2021,,,2,MM Ali,MS Dhoni,11,6,1,1,1,5,3,1,0,6,3,0,1
6480bb94cfe5aeb50e36aef3,2017,,,1,Ankit Soni,RA Jadeja,11,11,1,0,1,0,6,0,0,8,5,1,0
6480bb980ea7c3bcea4fdf9c,2022,,,2,JM Bairstow,S Dhawan,11,11,2,0,1,10,7,2,0,0,4,0,0
6480bb9f4bdcea2f81049fe9,2012,,,1,DPMD Jayawardene,NV Ojha,11,10,0,1,1,2,5,0,0,7,5,0,1
6480bba1a6882d256a926a8b,2014,,,2,KD Karthik,KP Pietersen,11,13,1,0,1,3,8,0,0,7,5,1,0
6480bb9a7f7a862ba0b2c59e,2007/08,,,1,S Anirudha,SP Fleming,11,15,0,0,1,1,7,0,0,5,8,0,0
6480bb9c07d77f83fb139c41,2009,,,2,DPMD Jayawardene,WA Mota,11,12,0,0,1,8,8,0,0,3,4,0,0
6480bb97ce981c1918dce924,2021,,,1,Ishan Kishan,KA Pollard,11,4,1,0,1,1,2,0,0,5,2,1,0
6480bb9d80536875f41bc605,2011,,,1,RV Uthappa,SB Wagh,11,5,0,1,1,11,4,0,1,0,1,0,0
6480bb953b102c650968cba2,2019,,,1,PA Patel,UT Yadav,11,19,1,0,1,9,9,1,0,1,10,0,0
6480bb9d03ce4b87b32b91f5,2009/10,,,2,S Badrinath,SK Raina,11,13,1,0,1,6,6,1,0,4,7,0,0
6480bb9f014bd6e0ac2b51a8,2013,,,2,KD Karthik,SR Tendulkar,11,11,1,0,1,2,6,0,0,9,5,1,0
6480bba31cc11024436836b5,2016,,,2,MA Agarwal,Q de Kock,11,9,0,1,1,8,5,0,1,3,4,0,0
6480bb96e2809aa0bc35c7e9,2019,,,1,KH Pandya,Q de Kock,11,5,0,1,0,9,3,0,1,2,2,0,0
6480bb978c66ea3d9c85132d,2020/21,,,1,RR Pant,SO Hetmyer,11,9,0,0,0,2,3,0,0,7,6,0,0
6480bb9baccf501985a56d64,2007/08,,,1,GC Smith,YK Pathan,11,19,1,0,1,2,6,0,0,8,13,1,0
6480bb94fbd0b904d63e0e07,2017,,,1,M Vohra,SE Marsh,11,9,2,0,1,0,3,0,0,10,6,2,0
6480bb98dd9a2108c79e1014,2022,,,1,JM Bairstow,LS Livingstone,11,6,2,0,1,9,3,2,0,2,3,0,0
6480bba1b8e3071cc513602a,2014,,,1,DS Kulkarni,PV Tambe,11,11,1,0,1,6,4,1,0,3,7,0,0
6480bb9fe31a789bcb52d583,2012,,,1,JD Ryder,RV Uthappa,11,14,1,0,1,1,6,0,0,8,8,1,0
6480bb9c13817091131f76e3,2009/10,,,2,IK Pathan,RS Bopara,11,11,1,0,1,3,5,0,0,8,6,1,0
6480bba22349149c9ec92d49,2016,,,1,MS Dhoni,NLTC Perera,11,11,0,0,1,4,4,0,0,6,7,0,0
6480bb9d05f8e769574069fa,2009/10,,,1,JH Kallis,S Sriram,11,17,0,0,1,8,11,0,0,3,6,0,0
6480bb9bc8bcea920f081be8,2009,,,2,G Gambhir,V Sehwag,11,10,0,1,1,3,5,0,0,7,5,0,1
6480bba0e52e9733fc6d9937,2013,,,1,DR Smith,SR Tendulkar,11,16,2,0,1,2,6,0,0,9,10,2,0
6480bba18a431be2cc738de0,2014,,,1,KM Jadhav,WD Parnell,11,3,1,1,0,11,3,1,1,0,0,0,0
6480bba2c5a614e0fd10cd19,2016,,,1,KH Pandya,RG Sharma,11,13,1,0,1,6,5,1,0,5,8,0,0
6480bb9bcf9df9e7ae0416ba,2009,,,1,RV Uthappa,V Kohli,11,14,2,0,1,9,9,2,0,1,5,0,0
6480bb9e5ad1f3182858e7c9,2012,,,1,AT Rayudu,NLTC Perera,11,8,0,0,0,3,3,0,0,4,5,0,0
6480bb94c008939d7976abfe,2018,,,1,AM Rahane,DJM Short,11,8,1,0,1,5,5,0,0,6,3,1,0
6480bb9ade063258af41163b,2007/08,,,2,A Symonds,SB Styris,11,18,1,0,1,3,11,0,0,6,7,1,0
6480bb98a95cb1650c81c926,2022,,,1,M Prasidh Krishna,R Parag,11,9,0,1,1,2,5,0,0,9,4,0,1
6480bb9a2b33e06f46eed54f,2023,,,1,AS Roy,RK Singh,11,12,0,1,1,3,3,0,0,8,9,0,1
6480bb9772f78629131db057,2021,,,1,F du Plessis,MM Ali,11,11,2,0,1,11,5,2,0,0,6,0,0
6480bba0fee4ae82492a666f,2013,,,1,A Mishra,KV Sharma,11,15,0,0,1,6,8,0,0,5,7,0,0
6480bb94bf9a1728b1b12f4d,2018,,,2,AM Rahane,K Gowtham,11,8,1,0,1,3,3,0,0,8,5,1,0
6480bba20130c44ed20c9bcf,2016,,,1,AT Rayudu,Harbhajan Singh,11,17,1,0,1,3,4,0,0,8,13,1,0
6480bba32e54551792a9e915,2016,,,1,DR Smith,SK Raina,11,8,0,1,1,9,5,0,1,2,3,0,0
6480bb9b7b8617115de9683b,2007/08,,,1,AC Gilchrist,HH Gibbs,11,14,2,0,1,2,4,0,0,8,10,2,0
6480bb9df60a79ae5f20b748,2011,,,1,DA Warner,V Sehwag,11,8,0,1,1,1,3,0,0,10,5,0,1
6480bb95816d3ad3bc382ab6,2018,,,2,AB de Villiers,C de Grandhomme,11,9,1,0,1,9,6,1,0,2,3,0,0
6480bb9a24adc8d916dfe2db,2023,,,1,MD Shanaka,Shubman Gill,11,10,1,0,1,8,6,1,0,3,4,0,0
6480bb9e34659755628e7471,2012,,,1,RV Uthappa,SPD Smith,11,11,1,0,1,5,5,1,0,6,6,0,0
6480bb9d182be5b0fbe5a4e2,2011,,,2,AG Murtaza,Harbhajan Singh,11,11,0,1,0,2,5,0,0,9,6,0,1
6480bba09d6b23c8722fd208,2013,,,2,AT Rayudu,MG Johnson,11,11,0,0,1,4,4,0,0,6,7,0,0
6480bb9439fcd1191cf17a90,2017,,,2,HM Amla,M Vohra,11,8,2,0,1,9,4,2,0,2,4,0,0
6480bb9ba9d43057d652a5fe,2009,,,1,DPMD Jayawardene,KC Sangakkara,11,12,0,0,1,7,9,0,0,2,3,0,0
6480bb9a596c087c0396ec2e,2007/08,,,1,DJ Thornely,ST Jayasuriya,11,11,1,0,1,0,5,0,0,6,6,1,0
6480bb9f146f5849bb759148,2013,,,1,CL White,NLTC Perera,11,8,2,0,1,2,4,0,0,9,4,2,0
6480bb984f6c41cd28aa0353,2022,,,2,R Shepherd,Washington Sundar,11,9,0,1,1,7,6,0,1,2,3,0,0
6480bb94009d0662ee94f07b,2018,,,1,JJ Bumrah,M Markande,11,8,1,0,0,4,5,0,0,6,3,1,0
6480bb9552e25b3867e5c38a,2019,,,2,MM Sharma,SN Thakur,11,5,1,1,0,0,2,0,0,11,3,1,1
6480bb9e1d754facf4fad618,2012,,,2,MN Samuels,SC Ganguly,11,21,0,0,1,6,11,0,0,4,10,0,0
6480bb990b96e91d3fbf421b,2022,,,1,KD Karthik,MK Lomror,11,13,0,0,1,6,6,0,0,5,7,0,0
6480bb9e4bb50b724830b249,2011,,,2,KA Pollard,SR Tendulkar,11,13,1,0,1,3,6,0,0,7,7,1,0
6480bb9f36da1a646c80be45,2013,,,2,M Morkel,UT Yadav,11,5,1,1,0,6,1,0,1,5,4,1,0
6480bba1bd00c57fb3301f04,2014,,,1,MK Pandey,SA Yadav,11,3,1,1,1,10,3,1,1,0,0,0,0
6480bb97ce981c1918dce924,2021,,,2,MK Pandey,S Kaul,11,8,2,0,0,10,5,2,0,1,3,0,0
6480bb989bf19eb260a04f0e,2022,,,1,AD Russell,PJ Cummins,11,7,1,0,1,7,4,1,0,3,3,0,0
6480bba27b4786f36f706f8e,2016,,,1,AT Rayudu,S Gopal,11,23,1,0,1,9,7,1,0,2,16,0,0
6480bb99433f6e11060ba714,2022,,,2,Arshdeep Singh,RD Chahar,11,12,1,0,0,2,3,0,0,8,9,1,0
6480bb9ba6cd609c32579bde,2009,,,1,BB McCullum,BJ Hodge,11,10,1,0,1,4,5,0,0,7,5,1,0
6480bba2a94dd2c01769b3ae,2016,,,1,JP Faulkner,RA Jadeja,11,9,0,0,1,7,6,0,0,4,3,0,0
6480bb99b3179a9346d8883c,2022,,,1,JC Buttler,YBK Jaiswal,11,17,1,0,1,7,11,1,0,2,6,0,0
6480bb96ec7d98e34055e8fc,2020/21,,,1,SPD Smith,YBK Jaiswal,11,14,1,0,1,4,8,0,0,6,6,1,0
6480bb9fc9e4047271240a59,2012,,,1,JH Kallis,Shakib Al Hasan,11,10,0,0,1,7,6,0,0,4,4,0,0
6480bb9f79be50f1621abcc6,2012,,,1,AM Nayar,P Kumar,11,11,1,0,0,2,3,0,0,7,8,1,0
6480bb9a87f64c1a12f62ece,2007/08,,,2,AM Nayar,MA Khote,11,7,0,1,1,2,2,0,0,9,5,0,1
6480bb9f8d3b0a3d1e28a4b7,2013,,,1,JH Kallis,YK Pathan,11,8,1,0,1,8,5,1,0,3,3,0,0
6480bb9f6b144f2a6d105b32,2013,,,1,MS Dhoni,R Ashwin,11,9,0,1,1,9,4,0,1,2,5,0,0
6480bba2a215721aadf7a90a,2015,,,2,SPD Smith,SR Watson,11,13,0,0,1,4,6,0,0,7,7,0,0
6480bb948f3284f793b2763c,2018,,,2,V Kohli,Washington Sundar,11,11,1,0,1,3,3,0,0,7,8,1,0
6480bb98373b1ea5035ab3da,2021,,,2,EJG Morgan,Shubman Gill,11,11,1,0,1,1,2,0,0,10,9,1,0
6480bb9db9ed29ce1ee8764f,2011,,,2,AM Nayar,Sunny Singh,11,9,2,0,1,9,5,2,0,2,4,0,0
6480bb9b77a0ff5cb3d0e3e0,2009,,,1,M Muralitharan,SB Jakati,11,6,2,0,1,2,2,0,0,9,4,2,0
6480bb9d02d996f85dd5e945,2011,,,2,M Vijay,MEK Hussey,11,14,2,0,1,2,4,0,0,8,10,2,0
6480bba0fee4ae82492a666f,2013,,,1,PA Patel,S Dhawan,11,11,2,0,1,8,8,2,0,3,3,0,0
6480bb97372fc5d5ef4c436a,2021,,,1,CR Woakes,K Rabada,11,6,1,0,0,2,2,0,0,9,4,1,0
6480bb95a8153d4daac6e4f7,2019,,,1,PP Chawla,Shubman Gill,11,15,0,0,1,4,4,0,0,6,11,0,0
6480bba119569fcc2d7859a4,2014,,,1,AJ Finch,DJG Sammy,11,6,0,1,0,1,2,0,0,10,4,0,1
6480bb9bf2869505c9393b7d,2009,,,2,CH Gayle,SC Ganguly,11,15,1,1,1,10,8,1,1,1,7,0,0
6480bb9dd10e35e6145534dc,2011,,,2,JR Hopes,Y Nagar,11,7,0,1,0,4,4,0,0,7,3,0,1
6480bb9f7258f976eb8fe943,2012,,,1,AL Menaria,DH Yagnik,11,9,2,0,0,1,2,0,0,10,7,2,0
6480bb9b2e179d359c1d446d,2009,,,1,AA Bilakhia,HH Gibbs,11,11,1,0,1,10,7,1,0,0,4,0,0
6480bba296f606ef91305124,2016,,,1,A Ashish Reddy,EJG Morgan,11,7,0,1,1,3,3,0,0,8,4,0,1
6480bba1bd00c57fb3301f04,2014,,,2,GJ Maxwell,WP Saha,11,5,2,0,1,0,1,0,0,11,4,2,0
6480bb9c3803ef7726af83ab,2009/10,,,2,NV Ojha,YK Pathan,11,4,1,1,1,7,2,0,1,4,2,1,0
6480bba38056992b92414bab,2016,,,1,Shakib Al Hasan,YK Pathan,11,15,0,0,1,7,10,0,0,4,5,0,0
6480bb9c44492d9e5fc4bb60,2009/10,,,1,BJ Hodge,SC Ganguly,11,14,0,0,1,2,4,0,0,6,10,0,0
6480bb9442c4889bcbb4a784,2017,,,2,DT Christian,RA Tripathi,11,15,0,1,1,3,9,0,0,8,6,0,1
6480bb9e41b781523bd5aafe,2012,,,1,G Gambhir,YK Pathan,11,7,1,0,1,6,3,1,0,0,4,0,0
6480bb9db6a011b38afed5dc,2011,,,2,PA Patel,VVS Laxman,11,13,2,0,1,11,10,2,0,0,3,0,0
6480bb95e435367dc64d9844,2019,,,1,Q de Kock,RG Sharma,11,15,1,0,1,6,8,0,0,5,7,1,0
6480bb99350726d00af209bf,2022,,,2,B Kumar,Fazalhaq Farooqi,11,16,1,0,1,8,8,1,0,2,8,0,0
6480bba1a6882d256a926a8b,2014,,,2,MK Tiwary,S Nadeem,11,10,0,1,1,10,6,0,1,1,4,0,0
6480bb962a1612c936d161ba,2019,,,2,KM Jadhav,M Vijay,11,17,1,0,1,6,11,0,0,5,6,1,0
6480bba29f384ce360fa8131,2016,,,2,F du Plessis,NLTC Perera,11,13,1,0,1,3,4,0,0,8,9,1,0
6480bba0cdc200ad3ab8fbf5,2014,,,2,AP Tare,MEK Hussey,11,12,2,0,1,10,5,2,0,1,7,0,0
6480bb9936b7698da2c2030c,2023,,,1,JC Buttler,YBK Jaiswal,11,10,2,0,1,1,2,0,0,10,8,2,0
6480bb94f27c8167d1685878,2017,,,2,AJ Finch,RA Jadeja,11,8,2,0,1,9,6,2,0,2,2,0,0
6480bb9eeeaf037e5e41ab86,2012,,,1,KK Cooper,OA Shah,11,3,1,1,0,11,3,1,1,0,0,0,0
6480bba1d9f266a28a109f29,2015,,,1,DA Miller,V Sehwag,11,7,0,1,1,3,3,0,0,7,4,0,1
6480bba0b5eabeb0a150b93f,2013,,,1,CH Gayle,SS Tiwary,11,5,0,1,1,7,3,0,1,2,2,0,0
6480bba286cca051953c976a,2015,,,2,AR Patel,WP Saha,11,14,0,1,1,9,10,0,1,2,4,0,0
6480bb9ca21b98f1be8254e2,2009/10,,,1,DA Warner,G Gambhir,11,9,2,0,1,9,8,2,0,1,1,0,0
6480bb9bd918d2e963f0218a,2009,,,1,KV Sharma,V Kohli,11,7,1,0,1,1,3,0,0,9,4,1,0
6480bb957ae1619e0d648dec,2019,,,2,KL Rahul,SM Curran,11,5,1,0,0,6,2,1,0,5,3,0,0
6480bb96c3293977af83acbf,2019,,,1,AM Rahane,LS Livingstone,11,12,0,1,1,2,4,0,0,9,8,0,1
6480bb95085c25712f29bd36,2019,,,2,AT Rayudu,F du Plessis,11,18,0,0,1,1,5,0,0,4,13,0,0
6480bb9ee779ef1e445d0506,2012,,,1,Harbhajan Singh,JEC Franklin,11,9,1,0,1,9,6,1,0,1,3,0,0
6480bb9a61edc0c77bc4bc86,2007/08,,,1,KD Karthik,MK Tiwary,11,5,2,0,0,6,3,1,0,5,2,1,0
6480bb9f60d58ee39ba047b9,2013,,,2,A Mishra,NLTC Perera,11,10,1,0,1,10,9,1,0,0,1,0,0
6480bb98adf21699eaa67796,2022,,,2,MM Ali,MS Dhoni,11,8,0,1,1,10,7,0,1,1,1,0,0
6480bb980d1be75574871dcc,2022,,,1,F du Plessis,V Kohli,11,11,2,0,1,0,4,0,0,10,7,2,0
6480bba2fc84811f520b04cf,2016,,,2,DJ Bravo,KD Karthik,11,5,2,0,0,2,2,0,0,9,3,2,0
6480bb94605dacb25c83dc35,2018,,,1,DA Miller,R Ashwin,11,8,1,0,1,8,6,1,0,2,2,0,0
6480bb99773871f8e2ddc4b1,2022,,,1,AK Markram,N Pooran,11,15,0,0,1,5,5,0,0,5,10,0,0
6480bb9c968c81bdfcc6df5b,2009,,,2,AC Gilchrist,TL Suman,11,12,1,0,1,9,7,1,0,2,5,0,0
6480bba15b304732a6212cdf,2015,,,1,BB McCullum,DJ Bravo,11,3,1,1,0,11,3,1,1,0,0,0,0
6480bb945460b25d997060fb,2018,,,2,GJ Maxwell,R Tewatia,11,6,0,1,1,10,4,0,1,1,2,0,0
6480bb9edbd8851db7e06741,2012,,,1,AM Rahane,OA Shah,11,8,1,0,1,1,3,0,0,8,5,1,0
6480bb9f9a70ecf3467829df,2013,,,1,CH Morris,DJ Bravo,11,5,0,1,0,1,1,0,0,10,4,0,1
6480bb9d7aa8d2c4c947d164,2009/10,,,2,AC Gilchrist,MD Mishra,11,13,2,0,1,2,2,0,0,9,11,2,0
6480bb9e5ad1f3182858e7c9,2012,,,1,JEC Franklin,KA Pollard,11,14,1,0,1,4,4,0,0,7,10,1,0
6480bb95085c25712f29bd36,2019,,,1,PA Patel,V Kohli,11,15,2,0,1,2,7,0,0,9,8,2,0
6480bb96ef6f4c2c85264241,2019,,,2,BB Sran,KH Pandya,11,10,0,1,1,2,2,0,0,9,8,0,1
6480bb97746881ab34c38bf8,2020/21,,,1,D Padikkal,V Kohli,11,20,0,0,1,7,9,0,0,3,11,0,0
6480bba0587190387a754733,2013,,,1,KM Jadhav,UBT Chand,11,12,0,0,1,6,6,0,0,5,6,0,0
6480bba2e30bef1d7b3bb753,2015,,,2,KD Karthik,V Kohli,11,7,0,1,1,2,2,0,0,9,5,0,1
6480bb954817ed0a4ba25bc2,2018,,,2,AR Patel,MK Tiwary,11,3,1,1,0,6,2,0,1,4,1,1,0
6480bb9a365c63af4b3de24c,2023,,,1,M Shahrukh Khan,Sikandar Raza,11,9,0,1,1,1,3,0,0,9,6,0,1
6480bb99b0fa4d217ed7f255,2023,,,2,M Jansen,Washington Sundar,11,9,1,0,0,2,3,0,0,9,6,1,0
6480bb9c71030f4c6f018f55,2009,,,2,SM Katich,Yuvraj Singh,11,9,2,0,1,10,7,2,0,1,2,0,0
6480bb9aa37f3b44678752d9,2023,,,1,SA Yadav,TH David,11,6,2,0,1,6,3,1,0,5,3,1,0
6480bb9737b1d7284b5297c1,2021,,,1,CA Lynn,Ishan Kishan,11,11,1,0,1,7,6,1,0,4,5,0,0
6480bb96b56e8d513b451da1,2020/21,,,1,KD Karthik,T Banton,11,7,1,1,1,0,1,0,0,10,6,1,1
6480bb9d8f5769d3a514fd88,2009/10,,,1,LRPL Taylor,MK Pandey,11,13,0,0,1,4,4,0,0,5,9,0,0
6480bb962831291a868490e7,2020/21,,,1,N Rana,Shubman Gill,11,11,2,0,1,2,3,0,0,9,8,2,0
6480bb9f8d3b0a3d1e28a4b7,2013,,,2,CL White,KC Sangakkara,11,9,2,0,1,10,8,2,0,1,1,0,0
6480bba1abec4894f2f69a35,2014,,,1,MS Dhoni,SK Raina,11,11,1,0,1,7,6,1,0,3,5,0,0
6480bb9ded279701c84af803,2011,,,2,CL White,KC Sangakkara,11,15,1,0,1,9,11,1,0,2,4,0,0
6480bb966539f85263cb6429,2019,,,2,RR Pant,SS Iyer,11,5,2,0,1,5,3,1,0,6,2,1,0
6480bba0e883438915efc1e6,2013,,,1,LJ Wright,SPD Smith,11,16,1,0,1,2,6,0,0,8,10,1,0
6480bba3aa840e4e9450a200,2016,,,1,Q de Kock,RR Pant,11,8,1,0,1,9,6,1,0,1,2,0,0
6480bb9dc4ec5a52f8bcc465,2009/10,,,2,JP Duminy,SR Tendulkar,11,13,2,0,1,2,6,0,0,9,7,2,0
6480bba2b7be71a15b2bb3de,2015,,,1,AT Rayudu,Harbhajan Singh,11,4,0,1,0,1,1,0,0,6,3,0,1
6480bb9442c4889bcbb4a784,2017,,,2,AM Rahane,RA Tripathi,11,10,2,0,1,11,9,2,0,0,1,0,0
6480bb94f46306dbde97aa5c,2017,,,1,LMP Simmons,PA Patel,11,9,1,0,1,3,6,0,0,4,3,1,0
6480bb9ee7a29c9b96ed61e5,2011,,,1,Mandeep Singh,R McLaren,11,12,1,0,1,7,7,1,0,4,5,0,0
6480bb973d64aa91e60b4088,2021,,,1,DJ Bravo,SM Curran,11,4,2,0,1,8,3,2,0,1,1,0,0
6480bb94ee669473878c11c2,2017,,,1,MK Pandey,SA Yadav,11,12,1,0,1,7,6,1,0,4,6,0,0
6480bb9fcb2b412c0ebd4afa,2013,,,2,MC Henriques,R Vinay Kumar,11,7,1,0,1,6,5,0,0,5,2,1,0
6480bb9c13817091131f76e3,2009/10,,,2,RS Bopara,Yuvraj Singh,11,12,2,0,1,6,6,1,0,4,6,1,0
6480bb9c454e9eefca545bde,2009/10,,,1,DPMD Jayawardene,M Kaif,11,11,1,0,1,3,3,0,0,8,8,1,0
6480bba1d21281c7385d5ce4,2014,,,1,AB de Villiers,Yuvraj Singh,11,16,1,0,1,8,5,1,0,3,11,0,0
6480bb970c637fd0c057dca9,2021,,,1,DA Miller,R Parag,11,6,0,1,0,7,3,0,1,4,3,0,0
6480bb9b0e32875998e9bfdc,2009,,,1,AB de Villiers,KD Karthik,11,9,1,0,1,7,4,1,0,4,5,0,0
6480bba2b99fcf06aaeac805,2015,,,1,RG Sharma,UBT Chand,11,9,1,0,1,5,5,0,0,5,4,1,0
6480bb976344f6d667dfd965,2021,,,1,RR Pant,SO Hetmyer,11,9,1,0,1,7,4,1,0,4,5,0,0
6480bb9d80536875f41bc605,2011,,,2,AT Rayudu,RG Sharma,11,16,0,0,1,6,8,0,0,5,8,0,0
6480bb9aa64355ce98da1141,2007/08,,,2,JR Hopes,SE Marsh,11,8,1,0,1,5,4,1,0,1,4,0,0
6480bb981f136a7564719d7f,2022,,,1,MA Agarwal,S Dhawan,11,12,2,0,1,5,9,1,0,5,3,1,0
6480bb9927b39ebcfd7820b0,2022,,,2,AD Russell,SW Billings,11,12,0,1,1,3,8,0,0,8,4,0,1
6480bb9f014bd6e0ac2b51a8,2013,,,2,DR Smith,SR Tendulkar,11,20,1,0,1,8,12,1,0,3,8,0,0
6480bb9740aaba2132c0eb0e,2021,,,2,GJ Maxwell,Washington Sundar,11,8,2,0,1,10,5,2,0,1,3,0,0
6480bb95c701f5c8388f7f88,2018,,,1,AJ Finch,MA Agarwal,11,12,0,1,1,8,6,0,1,2,6,0,0
6480bb966c9efd5bf35d10b9,2019,,,1,KD Karthik,N Rana,11,20,1,0,1,1,7,0,0,9,13,1,0
6480bb9a0a8baa96f94e8db9,2023,,,2,A Mishra,Ravi Bishnoi,11,21,0,0,1,6,13,0,0,5,8,0,0
6480bb99bb362e3714226928,2022,,,1,JC Buttler,YBK Jaiswal,11,14,2,0,1,2,6,0,0,9,8,2,0
6480bb95f282ca61c07afe9b,2018,,,1,C de Grandhomme,PA Patel,11,11,1,0,1,7,5,1,0,4,6,0,0
6480bb9a81d7fd0ac0307b4d,2023,,,1,N Wadhera,Tilak Varma,11,6,0,1,1,8,5,0,1,0,1,0,0
6480bb9b62eb35d78fcd7df0,2007/08,,,2,AB de Villiers,MK Tiwary,11,10,2,0,1,1,4,0,0,9,6,2,0
6480bb9fe489b0d429e97599,2012,,,1,AB de Villiers,TM Dilshan,11,9,1,0,1,2,3,0,0,7,6,1,0
6480bba08ffdd4393211d261,2014,,,2,MS Dhoni,RA Jadeja,11,16,0,0,1,5,7,0,0,6,9,0,0
6480bb9b52b93b56f5a16e52,2007/08,,,2,SR Watson,Sohail Tanvir,11,11,2,0,1,6,6,1,0,5,5,1,0
6480bb9e65a802582c071438,2012,,,1,N Saini,SE Marsh,11,14,2,0,1,5,5,1,0,6,9,1,0
6480bb9a9801c2dda3fe88e9,2007/08,,,2,G Gambhir,V Sehwag,11,10,1,0,1,3,4,0,0,6,6,1,0
6480bb94d8ce46258c13e90e,2017,,,2,MS Dhoni,SPD Smith,11,9,1,0,1,2,3,0,0,9,6,1,0
6480bb9e88141830a7a309b5,2011,,,1,AT Rayudu,JEC Franklin,11,12,2,0,1,9,9,2,0,2,3,0,0
6480bb9ec90f99c5ea40b014,2012,,,1,RN ten Doeschate,YK Pathan,11,4,1,1,0,7,3,0,1,4,1,1,0
6480bb9deba74e341b44c765,2009/10,,,2,Anirudh Singh,RG Sharma,11,13,1,0,1,9,9,1,0,0,4,0,0
6480bb94aad1a08ca4276b4e,2018,,,1,MM Sharma,R Ashwin,11,6,0,1,1,0,1,0,0,10,5,0,1
6480bba065b341458c934986,2013,,,2,EJG Morgan,JH Kallis,11,11,2,0,1,10,9,2,0,1,2,0,0
6480bb9c17dcdfd5b06984f0,2009/10,,,1,DA Warner,KM Jadhav,11,4,1,1,0,7,3,0,1,4,1,1,0
6480bb975156c246a0ee40b1,2021,,,1,AD Russell,N Rana,11,6,1,0,1,5,5,1,0,1,1,0,0
6480bb98f98edd45b1ccb406,2022,,,2,AJ Finch,SS Iyer,11,16,1,0,1,4,7,0,0,6,9,1,0
6480bb96e8ba017befb2bc8a,2020/21,,,1,HV Patel,SO Hetmyer,11,14,1,0,1,5,9,1,0,5,5,0,0
6480bb98a95cb1650c81c926,2022,,,1,D Padikkal,JC Buttler,11,10,0,1,1,7,7,0,1,3,3,0,0
6480bb9c3b082d71291a593c,2009,,,2,JA Morkel,JDP Oram,11,9,1,0,1,9,7,1,0,2,2,0,0
6480bb94738952e740c68749,2018,,,1,MK Pandey,WP Saha,11,15,1,0,1,9,9,1,0,2,6,0,0
6480bb989bf19eb260a04f0e,2022,,,1,AJ Finch,VR Iyer,11,8,0,1,1,7,5,0,1,2,3,0,0
6480bb9a3d3f26063faa9f71,2007/08,,,1,BJ Hodge,SC Ganguly,11,8,2,0,1,4,3,1,0,6,5,1,0
6480bb9932735ca83d38f6e7,2022,,,1,RK Singh,SW Billings,11,9,1,0,1,5,6,0,0,5,3,1,0
6480bb99f2a793884331579e,2023,,,1,N Jagadeesan,Rahmanullah Gurbaz,11,11,0,0,1,0,5,0,0,5,6,0,0
6480bb9ea1e127d68e288e04,2011,,,2,BB McCullum,PA Patel,11,14,0,0,1,3,7,0,0,6,7,0,0
6480bb954e496ec9b12aa120,2019,,,2,MJ Santner,RA Jadeja,11,3,0,1,0,10,3,0,1,0,0,0,0
6480bb9be88c31fc563da86f,2009,,,1,JH Kallis,SP Goswami,11,9,1,0,1,7,4,1,0,4,5,0,0
6480bba03a099a1a2e9c3dc5,2013,,,2,DPMD Jayawardene,UBT Chand,11,16,0,1,1,4,8,0,0,7,8,0,1
6480bba071a7a0cbb02d505a,2013,,,2,DA Miller,PP Chawla,11,7,2,0,0,6,4,1,0,5,3,1,0
6480bb94dfad571ef76493a9,2017,,,1,CJ Anderson,KK Nair,11,8,2,0,1,6,3,1,0,5,5,1,0
6480bb9be2940d96c1f903ca,2007/08,,,2,R Dravid,V Kohli,11,16,0,0,1,5,9,0,0,3,7,0,0
6480bb9eeeaf037e5e41ab86,2012,,,2,AM Nayar,SE Marsh,11,9,1,0,1,4,6,0,0,5,3,1,0
6480bba328f7475f4b87d3ff,2016,,,2,PP Chawla,YK Pathan,11,18,0,0,1,4,8,0,0,5,10,0,0
6480bb9bf2869505c9393b7d,2009,,,1,HH Gibbs,VVS Laxman,11,12,1,1,1,1,2,0,0,10,10,1,1
6480bb9d8f5769d3a514fd88,2009/10,,,2,S Dhawan,SR Tendulkar,11,11,2,0,1,1,2,0,0,9,9,2,0
6480bb9814efd9a91e8c911f,2021,,,2,LS Livingstone,S Dube,11,13,1,0,1,6,6,1,0,5,7,0,0
6480bb95d4da0397e79acffa,2019,,,2,CH Gayle,KL Rahul,11,10,1,1,1,10,5,1,1,1,5,0,0
6480bb97fcc6fccd233157f9,2021,,,2,DA Miller,SV Samson,11,19,0,0,1,7,10,0,0,4,9,0,0
6480bb9d0f6794fbf429449b,2011,,,1,MK Tiwary,YK Pathan,11,5,0,1,1,3,2,0,0,8,3,0,1
6480bb9fa3a890f94f179477,2013,,,1,Azhar Mahmood,R Sathish,11,9,1,0,1,5,5,0,0,6,4,1,0
6480bb94a964c10b5f10ae52,2017,,,2,AR Patel,Swapnil Singh,11,13,0,0,1,5,5,0,0,6,8,0,0
6480bb97fb920d483d0da2af,2020/21,,,2,KL Rahul,MA Agarwal,11,9,1,0,1,2,3,0,0,9,6,1,0
6480bb9e59fe7a0f48b7f9b9,2012,,,1,LRPL Taylor,P Negi,10,9,1,0,1,3,3,0,0,7,6,1,0
6480bb9c3b082d71291a593c,2009,,,2,M Muralitharan,SB Jakati,10,6,2,0,1,4,2,1,0,6,4,1,0
6480bb9809c62ba77e5df472,2021,,,1,GJ Maxwell,Shahbaz Ahmed,10,14,1,0,1,2,7,0,0,7,7,1,0
6480bb9c2778066dafd78a71,2009/10,,,2,A Symonds,RG Sharma,10,5,0,1,1,9,3,0,1,1,2,0,0
6480bb966c9efd5bf35d10b9,2019,,,2,JC Archer,JD Unadkat,10,3,1,1,0,10,2,1,1,0,1,0,0
6480bb975156c246a0ee40b1,2021,,,2,DA Warner,WP Saha,10,9,0,1,1,3,4,0,0,7,5,0,1
6480bba0ca27548122e36880,2013,,,1,MS Dhoni,RA Jadeja,10,4,0,1,0,9,3,0,1,1,1,0,0
6480bb98c0ad46409044aad2,2022,,,1,MM Ali,S Dube,10,8,0,1,1,8,5,0,1,2,3,0,0
6480bb9d4e112d675b2925df,2009/10,,,2,KD Karthik,KM Jadhav,10,10,1,0,1,5,2,1,0,5,8,0,0
6480bb9fa3a890f94f179477,2013,,,1,Azhar Mahmood,Gurkeerat Singh,10,6,1,0,1,3,2,0,0,6,4,1,0
6480bb948a69b3d86293b12b,2017,,,1,Ishan Kishan,KD Karthik,10,4,2,0,1,6,3,1,0,4,1,1,0
6480bb980b5b26e8c4335a4b,2022,,,2,RD Gaikwad,S Dube,10,9,1,0,1,1,2,0,0,8,7,1,0
6480bb9c2f07203e8e510386,2009/10,,,1,S Sreesanth,YA Abdulla,10,6,1,0,0,9,5,1,0,0,1,0,0
6480bb965aa0867bce4e79b3,2019,,,2,MA Agarwal,N Pooran,10,10,1,0,1,7,6,1,0,3,4,0,0
6480bb95d675b7da24db1a57,2019,,,1,CR Brathwaite,PP Chawla,10,6,1,0,1,1,2,0,0,9,4,1,0
6480bb941ab79050c3c90ee5,2018,,,2,AT Rayudu,SK Raina,10,16,0,0,1,6,10,0,0,4,6,0,0
6480bba328f7475f4b87d3ff,2016,,,2,PP Chawla,RV Uthappa,10,12,1,0,1,7,8,1,0,2,4,0,0
6480bb980b5b26e8c4335a4b,2022,,,2,RD Gaikwad,RV Uthappa,10,11,2,0,1,9,4,2,0,1,7,0,0
6480bba000b91f6c5cf57fdb,2013,,,2,BJ Hodge,Sachin Baby,10,11,1,0,1,6,4,1,0,3,7,0,0
6480bb966c197bad273f91f1,2020/21,,,2,R Tewatia,TK Curran,10,7,2,0,1,4,3,1,0,6,4,1,0
6480bba0295edd6084b9503b,2014,,,2,R Bhatia,STR Binny,10,5,2,0,1,4,3,1,0,6,2,1,0
6480bb981b01a21305fd65d5,2022,,,1,B Sai Sudharsan,HH Pandya,10,15,0,0,1,6,8,0,0,1,7,0,0
6480bb938ed49c6d5c211429,2017,,,1,SA Yadav,YK Pathan,10,7,1,0,1,4,3,1,0,4,4,0,0
6480bb973d98bfd2d4a5f108,2020/21,,,2,KL Nagarkoti,RA Tripathi,10,13,1,0,1,1,2,0,0,8,11,1,0
6480bb979e91d1ff9b54c737,2020/21,,,2,Ishan Kishan,KA Pollard,10,5,2,0,1,1,1,0,0,9,4,2,0
6480bb9affc08d6384ac3992,2023,,,2,GJ Maxwell,MG Bracewell,10,6,1,0,0,5,2,1,0,4,4,0,0
6480bb9eb2690fb1ed356b42,2011,,,1,AT Rayudu,SR Tendulkar,10,11,1,0,1,2,8,0,0,7,3,1,0
6480bb99ecbdaaf953b8eee5,2023,,,2,K Gowtham,MA Wood,10,3,1,1,0,0,0,0,0,10,3,1,1
6480bb9f2305d07e3c65be11,2013,,,2,Azhar Mahmood,Gurkeerat Singh,10,7,2,0,1,4,4,1,0,5,3,1,0
6480bb987c52e15a2cac0697,2022,,,1,P Simran Singh,S Dhawan,10,16,1,0,1,2,5,0,0,8,11,1,0
6480bba388682c5ca10ff37a,2016,,,2,BCJ Cutting,NV Ojha,10,6,1,0,1,0,2,0,0,7,4,1,0
6480bb9813fa79617f791851,2022,,,1,JC Buttler,SV Samson,10,10,0,1,1,2,2,0,0,8,8,0,1
6480bb984a44a355b856fd1a,2022,,,1,JR Hazlewood,PWH de Silva,10,19,1,0,1,2,10,0,0,8,9,1,0
6480bb99fe078839da40e7ab,2023,,,1,JJ Roy,VR Iyer,10,9,2,0,1,9,7,2,0,0,2,0,0
6480bb9d5d93b08a19c16313,2009/10,,,2,AB Agarkar,AD Mathews,10,7,2,0,1,4,3,1,0,5,4,1,0
6480bb98d8f59b81335f4a3d,2021,,,1,GJ Maxwell,TH David,10,8,0,1,1,9,5,0,1,1,3,0,0
6480bba2704d23da78c3eb15,2016,,,2,DA Miller,Gurkeerat Singh,10,11,1,0,1,2,5,0,0,7,6,1,0
6480bb9797043717cd96890a,2021,,,1,LS Livingstone,SV Samson,10,9,1,0,1,4,6,0,0,5,3,1,0
6480bb958c7b985a2b586a02,2018,,,1,AT Rayudu,SK Raina,10,8,1,0,1,6,4,1,0,4,4,0,0
6480bb9d362f72789dcdc5a7,2009/10,,,1,M Vijay,SK Raina,10,8,1,0,1,7,4,1,0,3,4,0,0
6480bb9ca181f55cb21526f5,2009/10,,,1,Harbhajan Singh,Z Khan,10,8,1,0,1,3,4,0,0,7,4,1,0
6480bb9e335bec070f88430f,2011,,,2,MS Dhoni,R Ashwin,10,7,0,1,1,8,3,0,1,2,4,0,0
6480bb9b4b74852492343291,2007/08,,,1,JH Kallis,SP Goswami,10,8,2,0,1,4,2,1,0,6,6,1,0
6480bb94ce8e0a620532955b,2018,,,2,C Munro,PP Shaw,10,10,2,0,1,0,5,0,0,9,5,2,0
6480bb95e25835586d412978,2018,,,1,MP Stoinis,R Ashwin,10,2,1,1,0,10,2,1,1,0,0,0,0
6480bb974e2f8e7f41c506dc,2021,,,1,DA Miller,S Dube,10,7,0,1,1,3,3,0,0,7,4,0,1
6480bb99efa58b95852be382,2023,,,1,MS Dhoni,S Dube,10,5,0,1,1,1,1,0,0,9,4,0,1
6480bb9cdf6c63fec90a42df,2009/10,,,1,LR Shukla,RS Gavaskar,10,13,1,0,1,8,5,1,0,2,8,0,0
6480bb9fa1611443840261b7,2012,,,1,A Ashish Reddy,PA Patel,10,6,0,0,1,4,3,0,0,1,3,0,0
6480bb9f87652064dab6c573,2013,,,2,EJG Morgan,MK Tiwary,10,11,1,0,1,7,5,1,0,1,6,0,0
6480bba34d78f594b07da1bc,2016,,,2,DA Miller,HM Amla,10,6,0,1,1,2,4,0,0,6,2,0,1
6480bb9e173228d1b18e376b,2012,,,2,AM Rahane,OA Shah,10,6,0,1,1,9,5,0,1,1,1,0,0
6480bb9fe7d0f611ba6ad229,2012,,,1,AC Thomas,SPD Smith,10,9,1,0,1,7,6,1,0,2,3,0,0
6480bb9e28b7a946a6921fa6,2011,,,2,JEC Franklin,R Sathish,10,11,0,1,1,8,4,0,1,2,7,0,0
6480bb95a09b947e0837a38a,2019,,,1,KK Nair,KL Rahul,10,11,0,0,1,5,6,0,0,5,5,0,0
6480bba3b818a7cff6fe4f89,2016,,,2,MK Pandey,R Sathish,10,9,1,0,1,7,6,1,0,2,3,0,0
6480bb9384cbae8edee3707f,2017,,,2,KK Nair,SS Iyer,10,13,1,0,1,4,6,0,0,6,7,1,0
6480bb9f895e5780080c8059,2012,,,2,NV Ojha,Y Venugopal Rao,10,9,2,0,0,5,6,1,0,5,3,1,0
6480bb97aa725a640d0f8e2f,2021,,,2,KS Bharat,V Kohli,10,9,0,0,1,5,4,0,0,5,5,0,0
6480bb9435048f20502ba1e1,2018,,,2,BCJ Cutting,MJ McClenaghan,10,5,1,1,0,10,5,1,1,0,0,0,0
6480bba2b341a081c069198d,2015,,,2,Ankit Sharma,DS Kulkarni,10,13,1,0,1,6,4,1,0,3,9,0,0
6480bb9b77a0ff5cb3d0e3e0,2009,,,1,JDP Oram,MS Dhoni,10,12,0,0,1,3,7,0,0,6,5,0,0
6480bb97aa725a640d0f8e2f,2021,,,1,LS Livingstone,R Parag,10,14,0,0,1,4,6,0,0,5,8,0,0
6480bb99350726d00af209bf,2022,,,2,RA Tripathi,Shashank Singh,10,8,0,1,1,1,2,0,0,8,6,0,1
6480bba29f384ce360fa8131,2016,,,2,AM Rahane,F du Plessis,10,13,2,0,1,9,11,2,0,1,2,0,0
6480bb931e6d2b03141b586d,2017,,,1,KK Nair,SV Samson,10,10,1,0,1,3,5,0,0,7,5,1,0
6480bb9df57ec21d17310ad2,2011,,,2,IR Jaggi,S Dhawan,10,15,1,0,1,3,9,0,0,6,6,1,0
6480bb97ce981c1918dce924,2021,,,2,JO Holder,MK Pandey,10,6,1,0,1,1,2,0,0,7,4,1,0
6480bb963d224b9be17f2c75,2019,,,1,B Kumar,Rashid Khan,10,8,0,0,1,1,4,0,0,5,4,0,0
6480bb98c0ad46409044aad2,2022,,,2,N Pooran,RA Tripathi,10,3,2,0,0,5,2,1,0,4,1,1,0
6480bb9737b1d7284b5297c1,2021,,,1,Ishan Kishan,KA Pollard,10,10,1,0,1,7,5,1,0,2,5,0,0
6480bb9c761c43b2dfb9767d,2009,,,1,K Goel,LA Pomersbach,10,17,0,0,1,5,10,0,0,5,7,0,0
6480bb9a8053274c083224d9,2023,,,2,MS Dhoni,S Dube,10,7,0,1,0,2,3,0,0,8,4,0,1
6480bb99f649ea7a6d79892f,2023,,,1,NT Ellis,S Dhawan,10,13,2,0,1,0,5,0,0,10,8,2,0
6480bb9d4e112d675b2925df,2009/10,,,1,BB McCullum,SC Ganguly,10,9,1,0,1,2,4,0,0,7,5,1,0
6480bb9bc74c35e494cec477,2007/08,,,2,PP Ojha,Y Venugopal Rao,10,5,0,1,0,1,2,0,0,7,3,0,1
6480bb9a24adc8d916dfe2db,2023,,,2,H Klaasen,M Jansen,10,14,0,0,1,7,8,0,0,3,6,0,0
6480bb9618b5973b98c0ba18,2019,,,1,KS Williamson,Mohammad Nabi,10,7,2,0,1,6,4,1,0,4,3,1,0
6480bb9ff2e0b1df0c3972c9,2012,,,2,DJ Hussey,P Awana,10,11,1,0,0,6,6,1,0,4,5,0,0
6480bba0b2a9d600114a43d7,2013,,,1,AM Nayar,Parvez Rasool,10,12,0,0,1,6,8,0,0,3,4,0,0
6480bb97ea8bfb43e3f7515f,2020/21,,,2,F du Plessis,RD Gaikwad,10,19,0,0,1,5,9,0,0,5,10,0,0
6480bba1ff89cb428182daa6,2014,,,2,BB McCullum,F du Plessis,10,7,0,0,1,4,3,0,0,6,4,0,0
6480bb9f146f5849bb759148,2013,,,2,AD Mathews,B Kumar,10,7,1,0,1,7,4,1,0,3,3,0,0
6480bb9d3c4dfa9f054aa47f,2011,,,2,AS Raut,FY Fazal,10,13,1,0,1,8,10,1,0,2,3,0,0
6480bb9e56c724ba25b94666,2011,,,2,AT Rayudu,TL Suman,10,8,1,0,1,5,4,1,0,4,4,0,0
6480bb9eb559e2934b31c47c,2012,,,1,MS Dhoni,S Badrinath,10,15,0,0,1,4,6,0,0,5,9,0,0
6480bb9574ca455ec008e942,2018,,,1,CR Brathwaite,YK Pathan,10,6,0,1,1,8,4,0,1,1,2,0,0
6480bba11eff9b230a172302,2014,,,2,AM Rahane,STR Binny,10,8,1,0,1,10,7,1,0,0,1,0,0
6480bb9cd0eb4289b2222e37,2009/10,,,2,DR Martyn,P Dogra,10,13,1,0,1,6,5,1,0,3,8,0,0
6480bb9b77a0ff5cb3d0e3e0,2009,,,1,ML Hayden,SK Raina,10,6,2,0,1,10,4,2,0,0,2,0,0
6480bba19701e99975ce7c59,2015,,,1,SPD Smith,SR Watson,10,4,1,1,1,0,0,0,0,10,4,1,1
6480bb980d1be75574871dcc,2022,,,2,B Sai Sudharsan,HH Pandya,10,9,1,0,1,7,4,1,0,3,5,0,0
6480bb945901306d3cb2b759,2018,,,1,SR Watson,SW Billings,10,11,1,0,1,7,4,1,0,3,7,0,0
6480bb9e1751fd9db64a2834,2011,,,1,AT Rayudu,SR Tendulkar,10,15,1,0,1,2,8,0,0,7,7,1,0
6480bba28724848c0f3ef034,2015,,,2,AD Russell,YK Pathan,10,9,1,0,1,2,4,0,0,8,5,1,0
6480bb9c7b7d7712bdc663de,2009/10,,,2,R Sharma,TL Suman,10,11,1,0,1,5,7,1,0,3,4,0,0
6480bb9b8860198955e581d8,2007/08,,,1,SK Raina,SP Fleming,10,10,1,0,1,8,6,1,0,1,4,0,0
6480bb9b166300b6298fc71a,2009,,,1,DPMD Jayawardene,Yuvraj Singh,10,10,0,1,1,7,8,0,1,1,2,0,0
6480bb96a467817b9b68ca94,2020/21,,,1,F du Plessis,SM Curran,10,13,1,0,1,0,1,0,0,9,12,1,0
6480bba2fc84811f520b04cf,2016,,,1,DA Miller,GJ Maxwell,10,6,0,1,1,7,2,0,1,2,4,0,0
6480bb980095555db76d49cb,2022,,,1,D Brevis,Ishan Kishan,10,13,1,0,1,8,11,1,0,2,2,0,0
6480bba1a6882d256a926a8b,2014,,,2,LRPL Taylor,MK Tiwary,10,10,0,0,1,4,5,0,0,4,5,0,0
6480bb9f58a3e7ea877fc9dc,2012,,,1,DJ Harris,S Dhawan,10,11,1,0,1,2,5,0,0,8,6,1,0
6480bba03b6f98689b851317,2013,,,1,G Gambhir,MS Bisla,10,8,2,0,1,8,6,2,0,2,2,0,0
6480bb96e18d7a1b3e62552d,2019,,,1,Abhishek Sharma,V Shankar,10,5,1,0,0,5,3,1,0,3,2,0,0
6480bb9574ca455ec008e942,2018,,,2,AD Russell,Shubman Gill,10,14,0,0,1,3,7,0,0,7,7,0,0
6480bb9c50838010977c168c,2009,,,2,KC Sangakkara,WA Mota,10,15,0,0,1,5,6,0,0,5,9,0,0
6480bb9506d56930505d45ae,2019,,,2,SE Rutherford,SS Iyer,10,6,1,0,0,2,2,0,0,8,4,1,0
6480bb9f70156528a31bb270,2013,,,2,KD Karthik,RT Ponting,10,14,0,0,1,6,7,0,0,1,7,0,0
6480bb98d2cd0fa3ed0ffc21,2022,,,1,Harpreet Brar,OF Smith,10,13,1,0,1,6,7,1,0,2,6,0,0
6480bb97220be892fbfc2a36,2021,,,1,Q de Kock,RG Sharma,10,12,1,0,1,2,6,0,0,8,6,1,0
6480bb9df46e9f48932124df,2009/10,,,2,AB de Villiers,KD Karthik,10,12,0,0,1,4,7,0,0,4,5,0,0
6480bb9442c4889bcbb4a784,2017,,,1,CR Woakes,SA Yadav,10,8,0,1,1,1,3,0,0,9,5,0,1
6480bb99695e001cdaca81e0,2022,,,1,MS Dhoni,S Dube,10,11,1,0,1,0,2,0,0,10,9,1,0
6480bb96c0ffb76dab723a2b,2019,,,1,A Mishra,I Sharma,10,3,1,1,0,0,0,0,0,10,3,1,1
6480bb9c7b7d7712bdc663de,2009/10,,,2,AC Gilchrist,VVS Laxman,10,10,1,0,1,6,3,1,0,4,7,0,0
6480bb9b4b74852492343291,2007/08,,,2,AB de Villiers,G Gambhir,10,12,0,0,1,4,4,0,0,6,8,0,0
6480bb9aef150645306cc170,2023,,,2,MR Marsh,PK Garg,10,5,0,1,1,9,4,0,1,1,1,0,0
6480bb9f302200e3bc89464e,2012,,,1,A Ashish Reddy,PA Patel,10,4,2,0,0,10,4,2,0,0,0,0,0
6480bba20559f15c3489f637,2015,,,2,B Kumar,KV Sharma,10,8,1,0,0,6,4,1,0,2,4,0,0
6480bb9827e9fb920cf62809,2021,,,1,Abdul Samad,JO Holder,10,11,0,1,1,6,2,0,1,2,9,0,0
6480bb9d0f6794fbf429449b,2011,,,1,MK Tiwary,MS Bisla,10,10,0,1,1,8,8,0,1,2,2,0,0
6480bba133267f04941acf7d,2014,,,1,IK Pathan,KV Sharma,10,8,0,0,1,4,4,0,0,4,4,0,0
6480bb98291bb8b3f3e8145d,2022,,,2,AD Russell,SS Iyer,10,7,0,1,1,2,2,0,0,8,5,0,1
6480bb97b945155c90dccd3d,2021,,,1,Shubman Gill,VR Iyer,10,6,2,0,1,9,5,2,0,1,1,0,0
6480bb9e88141830a7a309b5,2011,,,1,AT Rayudu,SR Tendulkar,10,15,1,0,1,3,7,0,0,7,8,1,0
6480bb9ade063258af41163b,2007/08,,,1,RT Ponting,WP Saha,10,5,1,0,1,0,1,0,0,6,4,1,0
6480bb9e692eaa193a417426,2012,,,1,AB de Villiers,V Kohli,10,8,1,0,1,4,5,0,0,6,3,1,0
6480bba33195e5ebac1da82a,2016,,,1,Harbhajan Singh,JJ Bumrah,10,9,0,1,0,8,7,0,1,2,2,0,0
6480bb9a7f7a862ba0b2c59e,2007/08,,,1,S Badrinath,SK Raina,10,7,2,0,1,0,4,0,0,9,3,2,0
6480bb9b9ca80d1c48994e04,2007/08,,,2,SK Raina,SP Fleming,10,18,1,0,1,1,6,0,0,9,12,1,0
6480bb9341152e168005ccc9,2017,,,1,SR Watson,STR Binny,10,6,2,0,1,4,3,1,0,6,3,1,0
6480bb94ca96a1c1f17d1294,2017,,,2,AF Milne,V Kohli,10,14,0,0,1,5,8,0,0,5,6,0,0
6480bba3aa840e4e9450a200,2016,,,1,Q de Kock,SW Billings,10,11,0,0,1,6,5,0,0,4,6,0,0
6480bb9f0f1f6c03d8e2f039,2013,,,2,GH Vihari,PA Patel,10,5,2,0,1,0,0,0,0,10,5,2,0
6480bb995193664eda3e9e10,2022,,,2,K Kartikeya,KA Pollard,10,12,0,0,1,3,5,0,0,4,7,0,0
6480bb965f597c872396f67c,2020/21,,,1,SP Narine,Shubman Gill,10,7,1,0,1,6,4,1,0,2,3,0,0
6480bb9f6b144f2a6d105b32,2013,,,1,M Vijay,MEK Hussey,10,12,0,0,1,5,8,0,0,5,4,0,0
6480bb95085c25712f29bd36,2019,,,1,MM Ali,UT Yadav,10,5,2,0,1,10,5,2,0,0,0,0,0
6480bba0b5eabeb0a150b93f,2013,,,2,LJ Wright,Yuvraj Singh,10,6,0,1,1,7,3,0,1,2,3,0,0
6480bba265483f7db002ec7c,2015,,,2,DA Warner,S Dhawan,10,11,2,0,1,9,9,2,0,1,2,0,0
6480bb9a365c63af4b3de24c,2023,,,1,P Simran Singh,S Dhawan,10,8,0,1,1,1,3,0,0,7,5,0,1
6480bb9bc8bcea920f081be8,2009,,,1,KP Pietersen,RV Uthappa,10,7,0,0,1,7,3,0,0,3,4,0,0
6480bb99358a21ba3487db81,2023,,,2,DJ Hooda,KL Rahul,10,9,0,1,1,7,8,0,1,1,1,0,0
6480bb953aab41e7ed166b9d,2019,,,1,PP Shaw,S Dhawan,10,10,1,0,1,7,6,1,0,2,4,0,0
6480bb982fc21d541267f7b9,2022,,,2,SP Jackson,SS Iyer,10,6,1,0,0,3,3,0,0,7,3,1,0
6480bb94640655c49683aee1,2018,,,2,JD Unadkat,K Gowtham,10,3,1,1,0,0,0,0,0,10,3,1,1
6480bb98bc3569cc8d04101a,2022,,,1,Ishan Kishan,SA Yadav,10,19,0,0,1,2,5,0,0,8,14,0,0
6480bb9e88141830a7a309b5,2011,,,2,R Bhatia,RN ten Doeschate,10,7,1,0,1,2,3,0,0,7,4,1,0
6480bb9ddfb0f2f6f8e813e5,2011,,,1,BB McCullum,M Klinger,10,12,1,0,1,7,6,1,0,2,6,0,0
6480bb9936b7698da2c2030c,2023,,,2,DP Conway,MM Ali,10,13,0,0,1,3,3,0,0,7,10,0,0
6480bb95a09b947e0837a38a,2019,,,1,KL Rahul,SM Curran,10,4,2,0,1,2,1,0,0,8,3,2,0
6480bb9e19dd5297ba8ca5f7,2011,,,1,MK Pandey,RV Uthappa,10,5,1,1,1,6,4,0,1,4,1,1,0
6480bb9d0f6794fbf429449b,2011,,,2,PA Patel,RA Jadeja,10,12,1,0,1,6,6,1,0,2,6,0,0
6480bb98a95cb1650c81c926,2022,,,2,F du Plessis,V Kohli,10,10,2,0,1,0,0,0,0,9,10,2,0
6480bb996c5ae75a32d978e8,2022,,,2,HH Pandya,WP Saha,10,11,1,0,1,7,6,1,0,3,5,0,0
6480bb9bcf9df9e7ae0416ba,2009,,,1,JH Kallis,W Jaffer,10,14,1,0,1,1,5,0,0,8,9,1,0
6480bb970d7cbd85b6ada680,2021,,,1,DJ Hooda,KL Rahul,10,15,0,0,1,5,9,0,0,5,6,0,0
6480bb97b97c36ac8be3582f,2021,,,1,GJ Maxwell,Washington Sundar,10,13,1,0,1,2,2,0,0,8,11,1,0
6480bb967d799ced7fe5d8e9,2020/21,,,2,JO Holder,V Shankar,10,10,1,0,1,4,6,0,0,6,4,1,0
6480bb971ffe5345804e7f32,2020/21,,,2,R Tewatia,S Gopal,10,8,1,0,1,3,4,0,0,6,4,1,0
6480bb9dd10e35e6145534dc,2011,,,2,V Sehwag,Y Venugopal Rao,10,14,0,0,1,2,3,0,0,3,11,0,0
6480bb97e5be965d3c00760e,2021,,,1,HV Patel,KA Jamieson,10,11,1,0,1,7,5,1,0,2,6,0,0
6480bb9936b7698da2c2030c,2023,,,2,DP Conway,RA Jadeja,10,5,1,0,1,7,3,1,0,2,2,0,0
6480bba01a3f8444c7a33ba6,2014,,,1,AM Nayar,AM Rahane,10,9,2,0,1,5,7,1,0,4,2,1,0
6480bb969d80bbba2884b855,2020/21,,,2,DA Warner,WP Saha,10,8,0,1,1,8,5,0,1,1,3,0,0
6480bba120182b9ca0b70004,2014,,,2,IK Pathan,NV Ojha,10,4,2,0,0,1,1,0,0,9,3,2,0
6480bb95f37ebb69ffb216e0,2019,,,2,CA Ingram,GH Vihari,10,8,1,0,1,8,5,1,0,2,3,0,0
6480bba265483f7db002ec7c,2015,,,1,M Vijay,M Vohra,10,14,1,0,1,4,5,0,0,5,9,1,0
6480bba2557febf92f9f79ab,2015,,,1,F du Plessis,R Ashwin,10,7,2,0,0,1,3,0,0,9,4,2,0
6480bb9ea75f51e7a33e90ed,2012,,,2,Bipul Sharma,N Saini,10,6,2,0,1,6,4,1,0,4,2,1,0
6480bb97fb920d483d0da2af,2020/21,,,2,Mandeep Singh,N Pooran,10,9,0,0,1,6,6,0,0,3,3,0,0
6480bb954e496ec9b12aa120,2019,,,2,AT Rayudu,F du Plessis,10,13,0,0,1,4,6,0,0,6,7,0,0
6480bb94f46306dbde97aa5c,2017,,,1,AT Rayudu,RG Sharma,10,17,0,0,1,4,9,0,0,6,8,0,0
6480bb95f214d4f82ab97ee5,2018,,,1,BA Stokes,SV Samson,10,7,1,0,1,5,4,0,0,5,3,1,0
6480bb9a6e44b0c8da00ca72,2007/08,,,1,B Lee,PP Chawla,10,4,2,0,1,8,3,2,0,0,1,0,0
6480bb9db0ecec8acdd30619,2011,,,1,M Kaif,SS Tiwary,10,7,1,0,1,6,3,1,0,4,4,0,0
6480bb9c8f3ef1685cdf4017,2009,,,2,MC Henriques,SC Ganguly,10,20,0,0,1,2,8,0,0,8,12,0,0
6480bba177ab201442a0e3c8,2015,,,1,AN Ahmed,VR Aaron,10,4,1,1,1,4,1,1,0,6,3,0,1
6480bb971ffe5345804e7f32,2020/21,,,1,AM Rahane,S Dhawan,10,14,1,0,1,2,9,0,0,6,5,1,0
6480bb9abfe839459b1a28f6,2007/08,,,1,RG Sharma,RP Singh,10,5,0,1,0,7,3,0,1,2,2,0,0
6480bb9575ad32214d0f6ec0,2019,,,2,JD Unadkat,STR Binny,10,5,1,0,0,0,0,0,0,10,5,1,0
6480bb97ce8cbd211049f957,2021,,,1,HH Pandya,KA Pollard,10,7,0,1,1,1,4,0,0,8,3,0,1
6480bba097818bcc0db9555d,2014,,,1,GJ Bailey,MG Johnson,10,8,1,0,1,8,6,1,0,0,2,0,0
6480bb9a0474602f26069e45,2007/08,,,2,S Vidyut,SK Raina,10,12,1,0,1,4,8,1,0,1,4,0,0
6480bb98825d8ceb716e3f3c,2022,,,1,DP Conway,MS Dhoni,10,9,1,0,1,2,2,0,0,8,7,1,0
6480bba2256bfaaf14c57ead,2015,,,2,Azhar Mahmood,Shakib Al Hasan,10,8,1,0,1,6,7,1,0,1,1,0,0
6480bb95816d3ad3bc382ab6,2018,,,2,SN Khan,TG Southee,10,15,1,0,1,6,6,1,0,4,9,0,0
6480bba2965d1d15aa6f723e,2016,,,1,KK Nair,Q de Kock,10,13,1,0,1,5,5,0,0,4,8,1,0
6480bb9f6f311344dac147cc,2012,,,2,MJ Clarke,RV Uthappa,10,7,1,0,1,1,2,0,0,9,5,1,0
6480bb9f87652064dab6c573,2013,,,1,DA Miller,MS Gony,10,6,2,0,1,1,2,0,0,9,4,2,0
6480bb94ce8e0a620532955b,2018,,,2,GJ Maxwell,RR Pant,10,11,1,0,1,6,5,1,0,4,6,0,0
6480bba069c0322e91e50958,2013,,,2,SP Narine,YK Pathan,10,6,0,1,1,1,2,0,0,9,4,0,1
6480bb9936b7698da2c2030c,2023,,,2,DP Conway,RD Gaikwad,10,14,1,0,1,1,4,0,0,8,10,1,0
6480bb9f146f5849bb759148,2013,,,1,A Ashish Reddy,DB Ravi Teja,10,7,1,0,0,6,3,1,0,4,4,0,0
6480bb9772f78629131db057,2021,,,1,AT Rayudu,F du Plessis,10,10,0,0,1,4,5,0,0,5,5,0,0
6480bb994aafcf67cd092a7d,2023,,,1,AR Patel,Kuldeep Yadav,10,6,0,1,1,9,5,0,1,1,1,0,0
6480bb9c13817091131f76e3,2009/10,,,1,A Symonds,Anirudh Singh,10,5,0,1,1,10,4,0,1,0,1,0,0
6480bb9c13817091131f76e3,2009/10,,,2,MS Bisla,RS Bopara,10,14,2,0,1,0,7,0,0,9,7,2,0
6480bb9ee779ef1e445d0506,2012,,,1,JEC Franklin,SA Yadav,10,9,0,0,1,10,5,0,0,0,4,0,0
6480bba3b818a7cff6fe4f89,2016,,,2,G Gambhir,MK Pandey,10,13,0,0,1,6,10,0,0,2,3,0,0
6480bb9618b5973b98c0ba18,2019,,,2,C de Grandhomme,UT Yadav,10,5,2,0,0,1,1,0,0,9,4,2,0
6480bba0bc196f7168b3d989,2013,,,1,MS Dhoni,SK Raina,10,6,0,1,1,2,2,0,0,8,4,0,1
6480bb9e88141830a7a309b5,2011,,,1,JEC Franklin,TL Suman,10,14,1,0,1,7,7,1,0,2,7,0,0
6480bb9c8cbb5dec60b7d50a,2009/10,,,2,R Sharma,RG Sharma,10,5,0,1,1,10,5,0,1,0,0,0,0
6480bb9737b1d7284b5297c1,2021,,,2,RM Patidar,V Kohli,10,9,1,0,1,8,8,1,0,1,1,0,0
6480bb954da239b357833c8a,2018,,,2,KS Williamson,S Dhawan,10,12,0,0,1,4,6,0,0,5,6,0,0
6480bba2bbd9d85769220a68,2015,,,2,NM Coulter-Nile,SS Tiwary,10,3,0,1,1,6,2,0,1,1,1,0,0
6480bb9b5d0191a0a2611916,2009,,,1,DPMD Jayawardene,KC Sangakkara,10,13,0,0,1,7,10,0,0,3,3,0,0
6480bba0adee98d459585bed,2014,,,2,AP Tare,RG Sharma,10,10,0,0,1,3,5,0,0,4,5,0,0
6480bb98e87e6f83b61088ea,2022,,,2,RD Gaikwad,RV Uthappa,10,12,1,0,1,1,4,0,0,9,8,1,0
6480bb9d867c041656e9a75f,2009/10,,,1,TM Dilshan,V Sehwag,10,8,2,0,1,6,6,1,0,4,2,1,0
6480bb9ef7c6084992b7cdf8,2012,,,2,KC Sangakkara,S Dhawan,10,14,1,0,1,1,7,0,0,9,7,1,0
6480bb993e44f97eccb361fe,2023,,,2,JM Sharma,Sikandar Raza,10,8,1,0,1,2,4,0,0,7,4,1,0
6480bb9b5d0191a0a2611916,2009,,,2,M Rawat,SK Warne,10,11,0,0,0,4,6,0,0,5,5,0,0
6480bba255079696d5cfa453,2015,,,2,AR Patel,MG Johnson,10,7,2,0,1,8,3,2,0,1,4,0,0
6480bb9f5867d07199aa832a,2013,,,2,MR Marsh,SPD Smith,10,6,0,1,1,2,4,0,0,7,2,0,1
6480bb9f4bdcea2f81049fe9,2012,,,1,DPMD Jayawardene,Y Venugopal Rao,10,8,0,1,1,0,1,0,0,10,7,0,1
6480bba18a289cc4b8d173a4,2014,,,1,AP Tare,AT Rayudu,10,6,2,0,1,9,4,2,0,1,2,0,0
6480bb963d224b9be17f2c75,2019,,,1,Shakib Al Hasan,WP Saha,10,9,0,0,1,4,4,0,0,5,5,0,0
6480bb94c008939d7976abfe,2018,,,2,CH Morris,SS Iyer,10,2,1,1,0,10,2,1,1,0,0,0,0
6480bb96686655f09172741d,2020/21,,,2,Navdeep Saini,YS Chahal,10,6,1,0,0,8,6,1,0,0,0,0,0
6480bb96593f4f87a2c294bc,2020/21,,,2,Sandeep Sharma,T Natarajan,10,8,1,0,1,7,4,1,0,3,4,0,0
6480bb94fc240a33621b10a6,2018,,,2,CH Gayle,MA Agarwal,10,9,0,1,0,7,7,0,1,2,2,0,0
6480bba1105add9a994c58a7,2014,,,1,KP Pietersen,Q de Kock,10,16,0,0,1,2,4,0,0,7,12,0,0
6480bb9a8ac627a1ebf8dacf,2007/08,,,1,MV Boucher,V Kohli,10,7,1,0,1,3,3,0,0,7,4,1,0
6480bb9e05381e16815803e9,2011,,,1,Mandeep Singh,SD Chitnis,10,14,1,0,1,2,7,0,0,8,7,1,0
6480bb9d97cceb6330e84df0,2011,,,2,M Klinger,PA Patel,10,13,0,0,1,4,7,0,0,3,6,0,0
6480bb9ab655ac367694708c,2007/08,,,2,SR Watson,YK Pathan,10,8,2,0,1,9,6,2,0,1,2,0,0
6480bb99358a21ba3487db81,2023,,,1,Abdul Samad,Washington Sundar,10,7,1,0,1,8,4,1,0,2,3,0,0
6480bb9e5ad1f3182858e7c9,2012,,,1,Harbhajan Singh,JEC Franklin,10,5,2,0,1,4,2,1,0,6,3,1,0
6480bb94ca3c1b1eac5e8dd3,2018,,,2,Imran Tahir,KM Jadhav,10,5,1,1,0,0,0,0,0,10,5,1,1
6480bb98e87e6f83b61088ea,2022,,,1,K Rabada,OF Smith,10,9,1,0,1,6,5,1,0,1,4,0,0
6480bb9d03ce4b87b32b91f5,2009/10,,,2,R Ashwin,T Thushara,10,11,0,0,1,4,5,0,0,6,6,0,0
6480bb955f4b3a84d6973620,2018,,,2,DJM Short,SV Samson,10,9,0,1,1,7,4,0,1,3,5,0,0
6480bba0ffae8617ee64bd19,2013,,,2,S Kaul,UT Yadav,10,13,0,0,0,7,9,0,0,3,4,0,0
6480bba1551dc12c8f2a7038,2014,,,2,JH Kallis,MK Pandey,10,6,2,0,0,10,6,2,0,0,0,0,0
6480bb95385ebb9bda58a643,2019,,,1,KA Pollard,KH Pandya,10,3,2,0,0,0,0,0,0,8,3,2,0
6480bb953b102c650968cba2,2019,,,1,AB de Villiers,PA Patel,10,12,0,0,1,9,10,0,0,1,2,0,0
6480bb9b77a0ff5cb3d0e3e0,2009,,,2,A Mishra,A Nehra,10,6,1,1,0,10,6,1,1,0,0,0,0
6480bb954817ed0a4ba25bc2,2018,,,1,HH Pandya,MJ McClenaghan,10,4,0,1,1,3,3,0,0,6,1,0,1
6480bba1b8e3071cc513602a,2014,,,1,SR Watson,SV Samson,10,11,0,0,1,7,7,0,0,2,4,0,0
6480bba0c9e6d590ed35eb56,2014,,,2,AT Rayudu,KA Pollard,10,13,0,0,1,7,6,0,0,3,7,0,0
6480bb9558c0acb502a3b1a9,2019,,,1,Mandeep Singh,Mujeeb Ur Rahman,10,2,1,1,0,10,2,1,1,0,0,0,0
6480bba140ee53a14fe06e0d,2014,,,2,F du Plessis,MS Dhoni,10,7,1,0,1,6,4,1,0,2,3,0,0
6480bb96ebf33df82879ad4c,2020/21,,,2,F du Plessis,KM Jadhav,10,5,2,0,1,8,3,2,0,1,2,0,0
6480bb9c454e9eefca545bde,2009/10,,,1,DPMD Jayawardene,PP Chawla,10,10,1,0,1,2,2,0,0,8,8,1,0
6480bb9a1a3ab2ab8297871d,2007/08,,,1,Shahid Afridi,VVS Laxman,10,4,1,1,1,10,4,1,1,0,0,0,0
6480bb9fa236b26050f19633,2012,,,2,LRPL Taylor,V Sehwag,10,8,1,0,1,6,5,1,0,3,3,0,0
6480bb9ea75f51e7a33e90ed,2012,,,1,DJ Bravo,RA Jadeja,10,8,0,1,1,2,4,0,0,8,4,0,1
6480bba2bae80e615447f251,2015,,,2,NJ Maddinson,V Kohli,10,13,2,0,1,4,7,1,0,6,6,1,0
6480bba358370ecde0231113,2016,,,1,R Ashwin,SS Tiwary,10,8,1,0,1,7,4,1,0,3,4,0,0
6480bb95f2e3c32afe233820,2018,,,1,WP Saha,YK Pathan,10,5,2,0,1,0,1,0,0,9,4,2,0
6480bb993e61058e682e2ff4,2023,,,2,R Ashwin,SO Hetmyer,10,3,1,1,1,10,3,1,1,0,0,0,0
6480bb9f2305d07e3c65be11,2013,,,1,BB Samantray,NLTC Perera,10,6,1,0,1,5,4,1,0,1,2,0,0
6480bb9b1fc007965b68d4d9,2009,,,2,Harbhajan Singh,Z Khan,10,7,0,1,1,7,3,0,1,3,4,0,0
6480bb93ec7e3351941d3b5b,2017,,,2,SR Watson,TM Head,10,7,1,0,1,4,3,0,0,6,4,1,0
6480bba1de7febd9f1f0138e,2014,,,2,DH Yagnik,R Bhatia,10,7,1,0,1,2,3,0,0,7,4,1,0
6480bb99f649ea7a6d79892f,2023,,,1,MW Short,S Dhawan,10,7,1,0,1,1,3,0,0,6,4,1,0
6480bb975ea60ce128803d60,2021,,,2,EJG Morgan,RA Tripathi,10,10,1,0,1,7,7,1,0,2,3,0,0
6480bb9d76ba2d9dd45c74a8,2011,,,2,KM Jadhav,M Muralitharan,10,13,0,0,1,3,5,0,0,5,8,0,0
6480bba2c56d0ef7222ee3b8,2015,,,1,CH Gayle,V Kohli,10,4,1,1,1,10,4,1,1,0,0,0,0
6480bb9932735ca83d38f6e7,2022,,,2,B Kumar,Umran Malik,10,11,1,0,0,6,6,1,0,3,5,0,0
6480bb99ed38bcb4025b8d86,2023,,,2,DJ Willey,KV Sharma,10,10,1,0,1,9,7,1,0,1,3,0,0
6480bba19052ba503c5f7c27,2015,,,1,DA Warner,KL Rahul,10,6,0,1,1,7,2,0,1,2,4,0,0
6480bba0d4b2f9be71a5f230,2014,,,2,M Vijay,MA Agarwal,10,5,2,0,1,0,2,0,0,9,3,2,0
6480bb9d1ed71a4f47892d00,2009/10,,,2,NV Ojha,YK Pathan,10,7,2,0,1,4,3,1,0,6,4,1,0
6480bb9eeeaf037e5e41ab86,2012,,,1,AL Menaria,AM Rahane,10,8,2,0,1,0,3,0,0,10,5,2,0
6480bb9bd918d2e963f0218a,2009,,,2,DB Ravi Teja,FH Edwards,10,6,1,0,0,7,4,1,0,3,2,0,0
6480bba27b4786f36f706f8e,2016,,,1,AT Rayudu,KA Pollard,10,13,0,0,1,2,5,0,0,1,8,0,0
6480bb99f47261f111a6cc1a,2023,,,1,DA Miller,V Shankar,10,7,1,0,1,6,3,1,0,4,4,0,0
6480bb9b8860198955e581d8,2007/08,,,1,S Vidyut,SP Fleming,10,4,2,0,1,8,4,2,0,0,0,0,0
6480bb9f302200e3bc89464e,2012,,,2,J Botha,OA Shah,10,9,1,0,1,3,4,0,0,6,5,1,0
6480bb9fe31a789bcb52d583,2012,,,2,MK Tiwary,Shakib Al Hasan,10,10,0,0,1,5,5,0,0,5,5,0,0
6480bb9a6ecee5429e0468be,2023,,,1,KS Sharma,N Pooran,10,17,0,0,1,5,8,0,0,5,9,0,0
6480bb938ed49c6d5c211429,2017,,,1,G Gambhir,SP Narine,10,14,1,0,1,3,5,0,0,6,9,1,0
6480bb9d918bd358d046889d,2011,,,1,JR Hopes,V Sehwag,10,12,1,0,1,8,9,1,0,2,3,0,0
6480bb9b1087ddfd207caa83,2009,,,2,KC Sangakkara,Yuvraj Singh,10,15,1,0,1,8,11,1,0,2,4,0,0
6480bb958f737f809dfb65e1,2019,,,2,DJ Hooda,YK Pathan,10,9,1,0,1,4,4,0,0,6,5,1,0
6480bb9d91920239b62f48ad,2009/10,,,1,DW Steyn,V Kohli,10,7,2,0,1,0,2,0,0,10,5,2,0
6480bb96f1eadf803ffc292c,2020/21,,,2,JC Archer,R Tewatia,10,7,1,0,1,2,4,0,0,6,3,1,0
6480bb98a95cb1650c81c926,2022,,,2,HV Patel,PWH de Silva,10,6,1,0,1,1,1,0,0,9,5,1,0
6480bb9498a98d52f9285b52,2017,,,1,Bipul Sharma,NV Ojha,10,5,0,1,1,3,2,0,0,7,3,0,1
6480bb9a77f349a0fd8d96d6,2023,,,2,Dhruv Jurel,TA Boult,10,5,0,1,0,9,3,0,1,1,2,0,0
6480bb95385ebb9bda58a643,2019,,,2,C Munro,PP Shaw,10,12,0,0,1,3,5,0,0,6,7,0,0
6480bb94cb5adf24f5ad15c3,2017,,,1,KA Pollard,PA Patel,10,14,1,0,1,7,10,1,0,3,4,0,0
6480bba000b91f6c5cf57fdb,2013,,,2,SR Watson,STR Binny,10,10,0,0,1,4,5,0,0,4,5,0,0
6480bb9eee740f701b0ee154,2011,,,2,DA Warner,IK Pathan,10,15,0,0,1,5,8,0,0,4,7,0,0
6480bba0ffae8617ee64bd19,2013,,,2,IK Pathan,UT Yadav,10,7,0,1,1,1,2,0,0,9,5,0,1
6480bb9c2f07203e8e510386,2009/10,,,2,G Gambhir,V Sehwag,10,8,2,0,1,2,2,0,0,8,6,2,0
6480bb9d6919e7181371271f,2011,,,2,NJ Rimmington,R McLaren,10,5,2,0,0,1,1,0,0,9,4,2,0
6480bb95a8153d4daac6e4f7,2019,,,1,AD Russell,KD Karthik,10,4,1,1,1,10,4,1,1,0,0,0,0
6480bb97e5be965d3c00760e,2021,,,1,D Padikkal,V Kohli,10,10,1,0,1,4,6,0,0,5,4,1,0
6480bb9873e53eace3a69dc7,2022,,,2,AD Russell,Shivam Mavi,10,12,0,1,1,8,8,0,1,2,4,0,0
6480bb981b01a21305fd65d5,2022,,,2,JM Bairstow,S Dhawan,10,14,2,0,1,1,6,0,0,9,8,2,0
6480bb9d8f5769d3a514fd88,2009/10,,,1,LRPL Taylor,P Kumar,10,8,0,1,1,9,6,0,1,1,2,0,0
6480bb981b01a21305fd65d5,2022,,,1,B Sai Sudharsan,PJ Sangwan,10,7,0,1,1,7,2,0,1,2,5,0,0
6480bb9e1a26096ce68e9ca3,2012,,,1,BJ Hodge,STR Binny,10,10,1,0,1,9,6,1,0,1,4,0,0
6480bb9af85f41b4de44ca19,2023,,,2,R Tewatia,V Shankar,10,8,0,0,1,3,5,0,0,4,3,0,0
6480bb9c3b082d71291a593c,2009,,,1,R Dravid,RV Uthappa,10,8,2,0,1,8,7,2,0,1,1,0,0
6480bb9e713e850d3dd0cba9,2012,,,2,Iqbal Abdulla,MK Tiwary,10,9,2,0,1,1,2,0,0,9,7,2,0
6480bba1d3b4ddc36050e3f3,2014,,,1,GJ Maxwell,WP Saha,10,12,1,0,1,6,9,1,0,2,3,0,0
6480bb9b724406459cd357c9,2007/08,,,2,MV Boucher,Z Khan,10,9,1,0,1,7,5,1,0,1,4,0,0
6480bb9a1032ce724214f6dd,2007/08,,,2,KD Karthik,R Bhatia,10,12,0,0,1,8,8,0,0,2,4,0,0
6480bb9ab655ac367694708c,2007/08,,,2,M Kaif,RA Jadeja,10,17,0,0,1,4,7,0,0,4,10,0,0
6480bba0f1ebf9ff255e1c91,2013,,,2,DJG Sammy,GH Vihari,10,9,2,0,1,8,5,2,0,1,4,0,0
6480bba179195d83fa7fbfbb,2014,,,1,SPD Smith,STR Binny,10,6,0,1,1,3,2,0,0,7,4,0,1
6480bb9371e90dbd44ee19a3,2017,,,2,EJG Morgan,HM Amla,10,8,2,0,1,2,5,0,0,8,3,2,0
6480bb9b62eb35d78fcd7df0,2007/08,,,1,DJ Hussey,WP Saha,10,7,0,1,1,8,4,0,1,2,3,0,0
6480bb9f4bdcea2f81049fe9,2012,,,2,JA Morkel,M Vijay,10,4,2,0,1,0,1,0,0,10,3,2,0
6480bb98825d8ceb716e3f3c,2022,,,1,DP Conway,RA Jadeja,10,4,2,0,0,9,3,2,0,1,1,0,0
6480bb973e451a92813d78cc,2020/21,,,2,KD Karthik,Shubman Gill,10,10,2,0,1,0,3,0,0,10,7,2,0
6480bb9a0a8baa96f94e8db9,2023,,,1,F du Plessis,SS Prabhudessai,10,11,0,0,1,4,4,0,0,6,7,0,0
6480bb98e87e6f83b61088ea,2022,,,1,PBB Rajapaksa,S Dhawan,10,6,0,1,1,9,5,0,1,0,1,0,0
6480bb97951f1bc43b462c46,2021,,,1,RD Gaikwad,SK Raina,10,10,1,0,1,7,5,1,0,3,5,0,0
6480bb98291bb8b3f3e8145d,2022,,,1,DA Warner,R Powell,10,8,0,1,1,2,2,0,0,8,6,0,1
6480bb9e6d7f7f691dde322d,2012,,,2,DW Steyn,JP Duminy,10,9,1,0,1,3,5,0,0,6,4,1,0
6480bba33195e5ebac1da82a,2016,,,1,Harbhajan Singh,MJ McClenaghan,10,7,2,0,1,6,3,1,0,4,4,1,0
6480bba2d313234709068efb,2015,,,1,HH Pandya,LMP Simmons,10,8,0,1,1,8,4,0,1,2,4,0,0
6480bb9d80536875f41bc605,2011,,,2,A Symonds,KA Pollard,10,8,0,1,1,3,3,0,0,7,5,0,1
6480bb9f4780a208e13bfb3d,2013,,,2,AM Rahane,SR Watson,10,14,2,0,1,4,5,1,0,6,9,1,0
6480bb9c7ac2dca34620d56e,2009/10,,,1,C Ganapathy,SK Raina,10,2,0,1,0,0,0,0,0,8,2,0,1
6480bb9837deb0fb66704166,2022,,,2,A Badoni,KH Pandya,10,3,1,1,0,10,3,1,1,0,0,0,0
6480bb95f2e3c32afe233820,2018,,,1,KS Williamson,MK Pandey,10,15,0,0,1,5,8,0,0,5,7,0,0
6480bb93182304739a535742,2017,,,1,F du Plessis,MA Agarwal,10,11,1,0,1,2,2,0,0,8,9,1,0
6480bb99e520ec7a66b73adb,2022,,,2,Ramandeep Singh,Tilak Varma,10,6,1,0,1,9,4,1,0,1,2,0,0
6480bb9a8cf29e28434bb1d5,2023,,,1,PK Garg,RR Rossouw,10,10,2,0,1,2,4,0,0,8,6,2,0
6480bb9384cbae8edee3707f,2017,,,1,JC Buttler,N Rana,10,7,2,0,1,9,5,2,0,1,2,0,0
6480bba22349149c9ec92d49,2016,,,1,NLTC Perera,R Bhatia,10,4,0,1,0,6,2,0,1,3,2,0,0
6480bb97e5be965d3c00760e,2021,,,1,GJ Maxwell,KS Bharat,10,13,0,0,1,5,8,0,0,5,5,0,0
6480bb9a77f349a0fd8d96d6,2023,,,2,Dhruv Jurel,SO Hetmyer,10,5,2,0,1,1,1,0,0,9,4,2,0
6480bb94566b0cf89fca84f9,2018,,,2,KS Williamson,MK Pandey,10,8,2,0,1,10,6,2,0,0,2,0,0
6480bb9740aaba2132c0eb0e,2021,,,2,D Padikkal,Washington Sundar,10,11,1,0,1,2,3,0,0,6,8,1,0
6480bb9da3dc1406b000cc98,2011,,,2,JR Hopes,S Nadeem,10,2,1,1,0,10,2,1,1,0,0,0,0
6480bb9baa08d0494c0b8dc3,2007/08,,,2,R Dravid,Z Khan,10,9,0,1,1,9,4,0,1,1,5,0,0
6480bb950ced01a335bd7833,2019,,,2,BA Stokes,RA Tripathi,10,5,0,1,0,1,2,0,0,9,3,0,1
6480bb9b52b93b56f5a16e52,2007/08,,,1,G Gambhir,V Sehwag,10,8,0,0,1,3,4,0,0,3,4,0,0
6480bba1af9481df8b4f9f0f,2015,,,1,AD Russell,Shakib Al Hasan,10,4,2,0,1,9,3,2,0,0,1,0,0
6480bb968211e65fcbffa192,2019,,,1,H Klaasen,PA Patel,10,7,1,0,1,2,2,0,0,8,5,1,0
6480bb95c28e7980e1768064,2018,,,2,JC Buttler,P Chopra,10,8,2,0,1,2,2,0,0,8,6,2,0
6480bba0d4b2f9be71a5f230,2014,,,1,G Gambhir,MK Pandey,10,9,0,0,1,0,4,0,0,3,5,0,0
6480bb9dd89d4266d59a4592,2011,,,2,PP Chawla,R McLaren,10,13,0,0,1,5,6,0,0,5,7,0,0
6480bb9a6a7169d0e413bcfa,2023,,,2,N Pooran,Q de Kock,10,7,0,1,1,1,3,0,0,9,4,0,1
6480bba1e64915b9e7c849ca,2014,,,2,AR Patel,R Dhawan,10,7,1,0,0,2,2,0,0,8,5,1,0
6480bba29f384ce360fa8131,2016,,,2,F du Plessis,MS Dhoni,10,8,1,0,1,9,7,1,0,1,1,0,0
6480bb9a36f2ab9a44baa0f8,2023,,,1,Dhruv Jurel,SO Hetmyer,10,10,1,0,1,9,8,1,0,1,2,0,0
6480bba23b270561e8026bd2,2015,,,1,KL Rahul,KV Sharma,10,16,0,0,1,6,8,0,0,4,8,0,0
6480bb94f27c8167d1685878,2017,,,2,BB McCullum,DR Smith,10,7,2,0,1,1,3,0,0,9,4,2,0
6480bb9f8d3b0a3d1e28a4b7,2013,,,2,KV Sharma,NLTC Perera,9,10,1,0,1,2,4,0,0,7,6,1,0
6480bb9f36da1a646c80be45,2013,,,2,KM Jadhav,MC Juneja,9,7,1,0,1,1,2,0,0,8,5,1,0
6480bb9bbb0ec0266749f518,2007/08,,,2,HH Gibbs,VVS Laxman,9,8,2,0,1,5,7,1,0,4,1,1,0
6480bb954714437843ab3647,2019,,,1,C Munro,S Dhawan,9,9,2,0,1,8,7,2,0,0,2,0,0
6480bba2b5d601f8354f5b5a,2016,,,2,MG Johnson,P Sahu,9,10,1,0,1,2,3,0,0,7,7,1,0
6480bb98aae066234fd8f11e,2022,,,2,Kuldeep Yadav,R Powell,9,8,1,0,1,3,4,0,0,6,4,1,0
6480bb9ff2e0b1df0c3972c9,2012,,,2,DJ Hussey,P Kumar,9,6,1,0,1,0,1,0,0,8,5,1,0
6480bb961ee814aee7b674ac,2020/21,,,1,AR Patel,MP Stoinis,9,13,0,0,1,6,9,0,0,2,4,0,0
6480bb9c58b62383739c022e,2009,,,1,DJ Bravo,YV Takawale,9,9,1,0,1,1,3,0,0,8,6,1,0
6480bb9538916411f52016bf,2019,,,1,KC Cariappa,Y Prithvi Raj,9,3,0,1,0,9,3,0,1,0,0,0,0
6480bb994877788ec5b187ff,2023,,,2,F du Plessis,MK Lomror,9,8,1,0,1,5,3,1,0,0,5,0,0
6480bb948211fe47e65f2e77,2018,,,1,Sandeep Sharma,YK Pathan,9,11,0,1,1,0,1,0,0,9,10,0,1
6480bb9fe8f5df13fc8d1bc3,2012,,,2,DJ Bravo,RA Jadeja,9,4,0,1,0,6,2,0,1,3,2,0,0
6480bb9f3700dfaa08e18c43,2012,,,1,AC Gilchrist,Azhar Mahmood,9,8,2,0,0,0,1,0,0,9,7,2,0
6480bb9ab83a3072124dda22,2023,,,1,Abdul Samad,B Kumar,9,6,0,1,0,7,5,0,1,2,1,0,0
6480bb961cdee4d82c395517,2020/21,,,2,A Nortje,K Rabada,9,3,0,1,0,3,2,0,0,6,1,0,1
6480bb9cafc843037dc1e863,2009,,,1,LRPL Taylor,V Kohli,9,10,2,0,1,1,2,0,0,8,8,2,0
6480bb9ccfdcb55be258ec95,2009,,,2,BJ Hodge,DJ Hussey,9,8,0,0,1,6,6,0,0,3,2,0,0
6480bba07fa24b891b818984,2013,,,2,KA Pollard,RG Sharma,9,15,1,0,1,2,7,0,0,7,8,1,0
6480bb93f866249511c76dbc,2017,,,1,KD Karthik,SK Raina,9,10,0,0,1,3,5,0,0,6,5,0,0
6480bb942efd740a6ffc47df,2017,,,2,TM Head,V Kohli,9,9,0,1,1,2,4,0,0,7,5,0,1
6480bb9834c7569d5fa64353,2022,,,2,JDS Neesham,M Prasidh Krishna,9,8,1,0,1,8,6,1,0,1,2,0,0
6480bb9b3a5e1af467fb027b,2009,,,1,A Kumble,R Dravid,9,11,1,0,1,1,5,0,0,8,6,1,0
6480bb982fc21d541267f7b9,2022,,,1,RA Jadeja,S Dube,9,13,0,0,1,6,7,0,0,3,6,0,0
6480bb964c4bea88164f168d,2020/21,,,2,JC Buttler,RV Uthappa,9,12,1,0,1,6,7,1,0,1,5,0,0
6480bb9774a44376e3b5eb6f,2021,,,1,KD Karthik,SP Narine,9,8,0,0,1,5,5,0,0,3,3,0,0
6480bb99e909d98c8193bac5,2023,,,2,GD Phillips,MA Agarwal,9,7,0,1,1,8,6,0,1,1,1,0,0
6480bb9fd9db46138a9bb209,2013,,,1,DJ Bravo,RA Jadeja,9,3,0,1,1,8,3,0,1,0,0,0,0
6480bba237377ccc608266d2,2016,,,2,HH Pandya,KA Pollard,9,7,1,0,1,4,1,1,0,5,6,0,0
6480bb94ca3c1b1eac5e8dd3,2018,,,2,KM Jadhav,MS Dhoni,9,13,0,0,1,3,8,0,0,5,5,0,0
6480bb9c50838010977c168c,2009,,,2,PP Chawla,RR Powar,9,7,1,0,0,2,2,0,0,7,5,1,0
6480bb9c50838010977c168c,2009,,,1,JDP Oram,MS Gony,9,7,0,1,1,2,2,0,0,7,5,0,1
6480bb951677500061c85592,2019,,,2,MK Pandey,V Shankar,9,16,1,0,1,4,8,0,0,5,8,1,0
6480bb9a325c576efe386437,2023,,,1,Anuj Rawat,MK Lomror,9,5,0,1,0,8,3,0,1,1,2,0,0
6480bba250b404cdcbff22c8,2015,,,1,DJ Bravo,RA Jadeja,9,6,1,0,1,1,2,0,0,8,4,1,0
6480bb9c8cbb5dec60b7d50a,2009/10,,,2,RG Sharma,RP Singh,9,5,0,1,1,7,3,0,1,1,2,0,0
6480bba07b5396a7b65684d3,2013,,,1,Harbhajan Singh,KD Karthik,9,3,2,0,1,0,0,0,0,8,3,2,0
6480bb9faf20f0bc714af2ea,2013,,,2,DPMD Jayawardene,J Botha,9,8,1,0,1,2,2,0,0,7,6,1,0
6480bb98634dba60191637ad,2021,,,1,AK Markram,N Pooran,9,6,0,1,1,1,2,0,0,8,4,0,1
6480bb9aab9770e7260312df,2007/08,,,1,AC Gilchrist,Y Venugopal Rao,9,12,0,1,1,8,9,0,1,0,3,0,0
6480bb9a1a3e8cef5633f4e6,2023,,,1,AK Markram,H Klaasen,9,8,0,0,1,4,4,0,0,4,4,0,0
6480bb9b6ded6d116cfe02ee,2009,,,1,BJ Hodge,CH Gayle,9,6,0,1,1,1,2,0,0,7,4,0,1
6480bb9f8ab73cf7c77cef03,2012,,,1,AM Rahane,R Dravid,9,10,1,0,1,2,5,0,0,5,5,1,0
6480bb9c620c92d09ba1b6b9,2009,,,2,RA Jadeja,SA Asnodkar,9,11,0,0,1,5,5,0,0,4,6,0,0
6480bb9d918bd358d046889d,2011,,,1,IK Pathan,Y Nagar,9,5,0,1,0,7,3,0,1,0,2,0,0
6480bb968211e65fcbffa192,2019,,,1,Gurkeerat Singh,H Klaasen,9,5,1,0,1,6,3,1,0,3,2,0,0
6480bb9a807eb5f39489408a,2023,,,2,Aman Hakim Khan,RV Patel,9,6,0,0,1,1,2,0,0,4,4,0,0
6480bba35038a60ea566794a,2016,,,2,BCJ Cutting,DA Warner,9,8,1,0,1,8,7,1,0,1,1,0,0
6480bba3fc9599eca1b87a77,2016,,,2,BB McCullum,DR Smith,9,11,1,0,1,2,5,0,0,7,6,1,0
6480bb980ea7c3bcea4fdf9c,2022,,,1,Avesh Khan,Mohsin Khan,9,9,1,0,0,2,5,0,0,7,4,1,0
6480bba069c0322e91e50958,2013,,,2,Iqbal Abdulla,YK Pathan,9,5,0,1,0,2,3,0,0,6,2,0,1
6480bb9c12f907c7b81b11a9,2009,,,1,BJ Hodge,DJ Hussey,9,13,2,0,1,1,4,0,0,8,9,2,0
6480bb9e4bb50b724830b249,2011,,,1,R Bhatia,Shakib Al Hasan,9,4,2,0,1,8,3,2,0,1,1,0,0
6480bba19052ba503c5f7c27,2015,,,1,EJG Morgan,RS Bopara,9,14,0,0,1,3,7,0,0,6,7,0,0
6480bb9ff2e0b1df0c3972c9,2012,,,2,DA Miller,DJ Hussey,9,14,1,0,1,4,7,0,0,5,7,1,0
6480bb99773871f8e2ddc4b1,2022,,,1,AK Markram,Washington Sundar,9,10,1,0,1,8,6,1,0,1,4,0,0
6480bb9a596c087c0396ec2e,2007/08,,,1,L Ronchi,ST Jayasuriya,9,11,2,0,1,8,10,2,0,1,1,0,0
6480bba38060854b4fab1831,2016,,,1,AB de Villiers,CH Gayle,9,15,1,0,1,4,9,0,0,5,6,1,0
6480bba0c7bf2b92ac8d836a,2013,,,2,OA Shah,STR Binny,9,11,0,0,1,5,6,0,0,3,5,0,0
6480bba1c67d2c9c1279a4c8,2014,,,2,KL Rahul,S Dhawan,9,7,1,0,1,6,6,1,0,3,1,0,0
6480bb96c3293977af83acbf,2019,,,1,LS Livingstone,SV Samson,9,11,1,0,1,5,5,1,0,3,6,0,0
6480bba38056992b92414bab,2016,,,1,G Gambhir,MK Pandey,9,9,0,0,1,4,4,0,0,4,5,0,0
6480bb9aab9770e7260312df,2007/08,,,1,A Symonds,RG Sharma,9,8,1,0,1,1,2,0,0,7,6,1,0
6480bb9af968df9497d2b9c4,2007/08,,,2,MK Pandey,ST Jayasuriya,9,6,2,0,1,0,2,0,0,8,4,2,0
6480bb9d66dc7da0d45e453c,2011,,,2,AM Nayar,KD Karthik,9,9,2,0,1,0,2,0,0,9,7,2,0
6480bb9ea75f51e7a33e90ed,2012,,,1,SK Raina,WP Saha,9,16,0,0,1,7,9,0,0,2,7,0,0
6480bb962a1612c936d161ba,2019,,,2,M Vijay,SR Watson,9,5,2,0,1,1,1,0,0,8,4,2,0
6480bb9c6f1c8ea3dc73226f,2009/10,,,1,A Mishra,PJ Sangwan,9,10,0,0,1,1,3,0,0,3,7,0,0
6480bb9e565ef5f11c5c8f55,2011,,,2,AB de Villiers,AUK Pathan,9,6,0,1,1,2,2,0,0,7,4,0,1
6480bb98960cf9374ee9420d,2022,,,2,SA Yadav,Tilak Varma,9,10,1,0,1,5,5,1,0,4,5,0,0
6480bb9927b39ebcfd7820b0,2022,,,2,A Tomar,N Rana,9,12,2,0,1,4,8,1,0,5,4,1,0
6480bba255079696d5cfa453,2015,,,1,AB de Villiers,KD Karthik,9,4,0,1,1,1,1,0,0,8,3,0,1
6480bb93d5dc00a79edede9c,2017,,,2,S Dhawan,Yuvraj Singh,9,10,1,0,1,7,6,1,0,1,4,0,0
6480bba19e29de4f208211ac,2014,,,2,AB Dinda,VR Aaron,9,10,1,0,0,2,4,0,0,6,6,1,0
6480bb958f737f809dfb65e1,2019,,,1,R Tewatia,SS Iyer,9,10,1,0,1,5,7,1,0,3,3,0,0
6480bb9eda28fb340ed37b49,2012,,,1,IR Jaggi,JP Duminy,9,12,1,0,1,3,7,0,0,6,5,1,0
6480bb9be7cbbb90a12dc916,2009,,,2,Harbhajan Singh,SR Tendulkar,9,5,2,0,1,4,2,1,0,5,3,1,0
6480bb9ea49fe0f895bf242a,2012,,,1,AT Rayudu,KD Karthik,9,4,0,1,1,9,3,0,1,0,1,0,0
6480bba2b7be71a15b2bb3de,2015,,,2,P Negi,RA Jadeja,9,7,1,0,1,1,3,0,0,7,4,1,0
6480bb9a7577454a5220c94b,2007/08,,,2,SA Asnodkar,YK Pathan,9,5,2,0,1,8,2,2,0,1,3,0,0
6480bb97e5be965d3c00760e,2021,,,1,Mohammed Siraj,YS Chahal,9,15,1,0,1,6,9,1,0,2,6,0,0
6480bb9a9dc58f49d783faa9,2023,,,2,A Zampa,SO Hetmyer,9,11,1,0,1,2,5,0,0,7,6,1,0
6480bb9d918bd358d046889d,2011,,,1,IK Pathan,NV Ojha,9,5,0,1,1,6,4,0,1,0,1,0,0
6480bb9fe3bc767415c60bfa,2012,,,1,IK Pathan,P Negi,9,4,2,0,1,5,2,1,0,4,2,1,0
6480bb9baa08d0494c0b8dc3,2007/08,,,2,JH Kallis,R Dravid,9,14,0,0,1,6,8,0,0,3,6,0,0
6480bb9eb2690fb1ed356b42,2011,,,1,AC Blizzard,SR Tendulkar,9,13,0,0,1,1,7,0,0,4,6,0,0
6480bb990b96e91d3fbf421b,2022,,,1,F du Plessis,V Kohli,9,11,0,1,1,2,3,0,0,7,8,0,1
6480bb9e5ab10d1241d6509d,2012,,,2,MN Samuels,RV Uthappa,9,7,1,0,1,3,3,0,0,6,4,1,0
6480bb967d799ced7fe5d8e9,2020/21,,,2,Abdul Samad,MK Pandey,9,9,1,0,1,7,5,1,0,2,4,0,0
6480bb94aad1a08ca4276b4e,2018,,,2,CR Woakes,Washington Sundar,9,5,2,0,0,0,1,0,0,9,4,2,0
6480bb96edb3270eba0af1d4,2020/21,,,2,DJ Bravo,RA Jadeja,9,7,0,0,1,7,5,0,0,2,2,0,0
6480bb9faf20f0bc714af2ea,2013,,,2,DPMD Jayawardene,IK Pathan,9,12,0,0,1,4,5,0,0,4,7,0,0
6480bb9dec749d630afd07d1,2011,,,1,DB Ravi Teja,DW Steyn,9,6,1,0,0,8,4,1,0,1,2,0,0
6480bb9bc74c35e494cec477,2007/08,,,2,AC Gilchrist,RG Sharma,9,7,1,0,1,7,5,1,0,1,2,0,0
6480bb9c17dcdfd5b06984f0,2009/10,,,1,DA Warner,V Sehwag,9,6,2,0,1,1,3,0,0,8,3,2,0
6480bb9e32ed1b9e077b8c11,2011,,,1,AL Menaria,AS Raut,9,7,1,0,1,7,4,1,0,2,3,0,0
6480bb965f597c872396f67c,2020/21,,,1,RA Tripathi,Shubman Gill,9,8,0,1,1,7,4,0,1,2,4,0,0
6480bb990942cd416cf5f447,2022,,,2,DJ Hooda,KS Sharma,9,6,2,0,1,5,2,1,0,4,4,1,0
6480bb9d80e97e178e5f68de,2011,,,1,JA Morkel,S Anirudha,9,12,0,0,1,5,7,0,0,4,5,0,0
6480bb99b35dc0981e512451,2022,,,2,Shubman Gill,WP Saha,9,10,2,0,1,4,3,1,0,5,7,1,0
6480bb9ee7a29c9b96ed61e5,2011,,,1,AC Gilchrist,PC Valthaty,9,10,2,0,1,4,4,1,0,5,6,1,0
6480bb94ebff9a116f68560b,2018,,,1,AD Russell,KD Karthik,9,6,0,1,1,9,5,0,1,0,1,0,0
6480bb960d9d6af315534958,2019,,,1,CH Gayle,MA Agarwal,9,10,1,0,1,3,6,0,0,6,4,1,0
6480bb964752e7c0f9e39d3c,2020/21,,,1,KD Karthik,Shubman Gill,9,12,1,0,1,4,7,1,0,4,5,0,0
6480bb9eb261c1057830912e,2011,,,1,CA Ingram,Y Venugopal Rao,9,8,1,0,0,8,7,1,0,0,1,0,0
6480bb9a87f64c1a12f62ece,2007/08,,,2,L Ronchi,ST Jayasuriya,9,6,1,0,1,2,3,0,0,5,3,1,0
6480bb9b0b09749af4aa32dd,2009,,,1,K Goel,RS Bopara,9,14,2,0,1,0,7,0,0,9,7,2,0
6480bb9d80536875f41bc605,2011,,,1,M Manhas,RV Uthappa,9,4,0,1,1,0,1,0,0,9,3,0,1
6480bb9e8dfd9ba30b93cbd8,2012,,,1,B Chipli,DT Christian,9,6,0,1,1,8,5,0,1,1,1,0,0
6480bb95b33a36f0dd77d1a1,2018,,,2,DJM Short,JC Buttler,9,5,1,0,1,4,5,1,0,0,0,0,0
6480bb9da9ca2f2d3738d79e,2011,,,1,JEC Franklin,SR Tendulkar,9,10,1,0,1,6,8,1,0,1,2,0,0
6480bb96ef6f4c2c85264241,2019,,,2,Q de Kock,RG Sharma,9,8,2,0,1,0,4,0,0,8,4,2,0
6480bb993e44f97eccb361fe,2023,,,1,DJ Hooda,KL Rahul,9,6,1,0,1,2,3,0,0,7,3,1,0
6480bb94ebff9a116f68560b,2018,,,1,MG Johnson,Shivam Mavi,9,10,0,0,1,4,5,0,0,4,5,0,0
6480bb97c92184fed1a879f3,2021,,,2,AB de Villiers,GHS Garton,9,8,0,1,0,7,5,0,1,2,3,0,0
6480bb931e6d2b03141b586d,2017,,,2,MK Pandey,SP Narine,9,3,0,1,0,8,2,0,1,1,1,0,0
6480bb94834e2b780c4782b5,2017,,,1,Kuldeep Yadav,UT Yadav,9,8,1,0,1,6,5,1,0,3,3,0,0
6480bb9a24adc8d916dfe2db,2023,,,1,HH Pandya,Shubman Gill,9,7,1,0,1,8,6,1,0,1,1,0,0
6480bb95e435367dc64d9844,2019,,,2,SPD Smith,STR Binny,9,6,1,0,0,2,2,0,0,7,4,1,0
6480bb9b69f8ace7659e486d,2009,,,2,M Rawat,SK Trivedi,9,8,1,0,1,7,5,1,0,2,3,0,0
6480bb9f777b7b1e89543a6e,2013,,,2,PP Ojha,SL Malinga,9,7,1,0,1,1,1,0,0,7,6,1,0
6480bb9a9801c2dda3fe88e9,2007/08,,,1,KC Sangakkara,SM Katich,9,6,1,0,1,4,2,1,0,5,4,0,0
6480bb9f5867d07199aa832a,2013,,,1,CH Morris,JA Morkel,9,10,0,0,1,5,5,0,0,4,5,0,0
6480bb961cdee4d82c395517,2020/21,,,2,AR Patel,MP Stoinis,9,8,0,0,1,3,3,0,0,5,5,0,0
6480bb96b7b695186bbb6a3e,2019,,,2,MS Dhoni,SR Watson,9,13,1,0,1,2,8,0,0,6,5,1,0
6480bb99433f6e11060ba714,2022,,,1,MR Marsh,RR Pant,9,6,0,1,1,2,3,0,0,7,3,0,1
6480bb9fd4a1af6234c9e57c,2012,,,2,P Dogra,PP Chawla,9,6,0,1,0,3,4,0,0,6,2,0,1
6480bba2c56d0ef7222ee3b8,2015,,,1,AB de Villiers,V Kohli,9,10,1,0,1,4,6,1,0,1,4,0,0
6480bb94cfe5aeb50e36aef3,2017,,,1,Ishan Kishan,SK Raina,9,11,1,0,1,7,8,1,0,2,3,0,0
6480bb94dfad571ef76493a9,2017,,,1,A Mishra,Z Khan,9,18,0,0,1,6,7,0,0,2,11,0,0
6480bb9fa1611443840261b7,2012,,,2,HV Patel,R Vinay Kumar,9,7,1,0,1,3,3,0,0,6,4,1,0
6480bb954da239b357833c8a,2018,,,1,GJ Maxwell,PP Shaw,9,10,0,1,1,2,3,0,0,7,7,0,1
6480bb9d867c041656e9a75f,2009/10,,,1,DA Warner,V Sehwag,9,8,2,0,1,5,4,1,0,4,4,1,0
6480bb9a5d25d853e1cbfe3e,2007/08,,,2,JR Hopes,Yuvraj Singh,9,8,1,0,1,1,4,0,0,6,4,1,0
6480bb9eb35365cccf73d55c,2011,,,1,JD Ryder,MK Pandey,9,8,2,0,1,1,6,0,0,8,2,2,0
6480bb9e34659755628e7471,2012,,,2,DJ Hussey,PP Chawla,9,7,0,1,1,8,6,0,1,1,1,0,0
6480bb9c71030f4c6f018f55,2009,,,2,B Lee,IK Pathan,9,9,1,0,1,0,3,0,0,9,6,1,0
6480bb97aed297ca9686c94a,2021,,,2,F du Plessis,SK Raina,9,11,1,0,1,0,2,0,0,8,9,1,0
6480bba0d4b2f9be71a5f230,2014,,,2,JP Duminy,MK Tiwary,9,9,1,0,1,1,3,0,0,8,6,1,0
6480bb9822eeb0c1c117f221,2021,,,1,RR Pant,TK Curran,9,8,1,0,0,9,7,1,0,0,1,0,0
6480bb9498a98d52f9285b52,2017,,,1,Bipul Sharma,Rashid Khan,9,8,0,0,1,5,5,0,0,3,3,0,0
6480bba08cc4182f0127f2e2,2013,,,2,DJ Bravo,MEK Hussey,9,7,2,0,1,9,7,2,0,0,0,0,0
6480bb9e21655ee16a96b2c3,2012,,,1,SS Tiwary,V Kohli,9,11,0,0,1,5,6,0,0,4,5,0,0
6480bb9b283b30d0503656f7,2007/08,,,2,DB Ravi Teja,RP Singh,9,5,0,1,1,8,4,0,1,1,1,0,0
6480bba069d61566bb63ac2b,2014,,,2,JH Kallis,MK Pandey,9,5,1,0,1,4,2,0,0,5,3,1,0
6480bb972a7d4e1071ea662e,2021,,,1,Ishan Kishan,RG Sharma,9,10,1,0,1,1,3,0,0,8,7,1,0
6480bb9ea75f51e7a33e90ed,2012,,,1,KMDN Kulasekara,R Ashwin,9,5,1,0,0,1,2,0,0,7,3,1,0
6480bba22daffa649f339a05,2016,,,2,MR Marsh,MS Dhoni,9,14,0,0,1,7,11,0,0,1,3,0,0
6480bba08cc4182f0127f2e2,2013,,,2,M Vijay,MEK Hussey,9,13,1,0,1,2,4,0,0,7,9,1,0
6480bb9523e6dc3c988ce398,2019,,,2,RV Uthappa,Shubman Gill,9,7,1,0,1,1,1,0,0,8,6,1,0
6480bb97ea8bfb43e3f7515f,2020/21,,,1,PP Shaw,RR Pant,9,10,1,0,1,7,6,1,0,2,4,0,0
6480bba10e78f50f124b406a,2015,,,2,F du Plessis,MM Sharma,9,8,0,1,1,7,2,0,1,2,6,0,0
6480bb943565d22d24ec0ae8,2017,,,2,G Gambhir,SP Narine,9,8,2,0,1,8,4,2,0,1,4,0,0
6480bba2ebdcfb98389cee5a,2015,,,2,P Negi,RA Jadeja,9,11,0,0,0,5,7,0,0,3,4,0,0
6480bb9c37b72d7a51019794,2009/10,,,2,SR Watson,YK Pathan,9,10,0,0,1,4,3,0,0,5,7,0,0
6480bb99fa79383bdc7df827,2022,,,1,Harpreet Brar,LS Livingstone,9,7,0,1,1,7,5,0,1,2,2,0,0
6480bb9bef0d1fffea8bfd11,2009,,,1,JA Morkel,MS Dhoni,9,6,1,0,0,2,2,0,0,7,4,1,0
6480bb99bbae76f3f761d060,2023,,,2,D Wiese,RK Singh,9,5,0,1,1,1,2,0,0,8,3,0,1
6480bb9ef8d4c23c6e5be4c7,2011,,,2,R Vinay Kumar,RA Jadeja,9,7,0,0,1,3,3,0,0,5,4,0,0
6480bba2b5d601f8354f5b5a,2016,,,1,Q de Kock,SS Iyer,9,13,1,0,1,6,8,1,0,3,5,0,0
6480bb94cf431881ac3e9cbf,2018,,,2,M Vohra,Q de Kock,9,12,1,0,1,2,5,0,0,6,7,1,0
6480bb94a0422f6d0abe276b,2017,,,2,CH Morris,SS Iyer,9,4,2,0,1,5,2,1,0,4,2,1,0
6480bb979e91d1ff9b54c737,2020/21,,,2,HH Pandya,Ishan Kishan,9,8,1,0,1,3,5,0,0,6,3,1,0
6480bba0c9e6d590ed35eb56,2014,,,2,Harbhajan Singh,SL Malinga,9,9,1,0,1,8,6,1,0,1,3,0,0
6480bb9740aaba2132c0eb0e,2021,,,2,KA Jamieson,YS Chahal,9,17,0,1,1,8,6,0,1,1,11,0,0
6480bba18a2fe828fa106f6c,2014,,,1,JP Faulkner,R Bhatia,9,7,1,0,0,3,3,0,0,6,4,1,0
6480bb9d362f72789dcdc5a7,2009/10,,,1,M Vijay,ML Hayden,9,9,1,0,1,6,4,1,0,1,5,0,0
6480bb965aa0867bce4e79b3,2019,,,2,Mandeep Singh,SM Curran,9,10,1,0,0,3,3,0,0,6,7,1,0
6480bb9ea49fe0f895bf242a,2012,,,2,AA Chavan,AL Menaria,9,3,2,0,1,4,1,1,0,4,2,1,0
6480bb9a40966b9b90fcdf2e,2023,,,2,AD Russell,N Rana,9,10,1,0,1,6,5,1,0,3,5,0,0
6480bba04b49d2ff5f997e02,2013,,,2,BJ Rohrer,IK Pathan,9,13,1,0,1,7,9,1,0,2,4,0,0
6480bb9558c0acb502a3b1a9,2019,,,1,GC Viljoen,Mandeep Singh,9,7,1,0,1,1,3,0,0,7,4,1,0
6480bb973d98bfd2d4a5f108,2020/21,,,2,CV Varun,KL Nagarkoti,9,12,0,0,1,5,7,0,0,3,5,0,0
6480bb9e335bec070f88430f,2011,,,2,M Vijay,SK Raina,9,8,2,0,1,4,3,1,0,4,5,1,0
6480bb9ef18c54e7aafdd223,2012,,,1,DB Das,Shakib Al Hasan,9,12,0,0,1,6,7,0,0,3,5,0,0
6480bb9eae43aed76989151b,2011,,,2,G Gambhir,MK Tiwary,9,10,1,0,1,5,5,1,0,3,5,0,0
6480bb9c6f1c8ea3dc73226f,2009/10,,,2,DJ Bravo,KA Pollard,9,4,0,1,1,9,4,0,1,0,0,0,0
6480bb9a3d3f26063faa9f71,2007/08,,,1,A Chopra,BJ Hodge,9,13,1,0,1,2,5,0,0,6,8,1,0
6480bb95c701f5c8388f7f88,2018,,,1,AJ Finch,MP Stoinis,9,9,1,0,1,7,6,1,0,2,3,0,0
6480bb954e496ec9b12aa120,2019,,,2,AT Rayudu,KM Jadhav,9,11,0,1,1,8,5,0,1,1,6,0,0
6480bb980ea7c3bcea4fdf9c,2022,,,2,K Rabada,R Dhawan,9,12,1,0,1,2,5,0,0,6,7,1,0
6480bb9404b444be6724e41e,2017,,,2,MK Tiwary,MS Dhoni,9,11,0,0,1,3,6,0,0,5,5,0,0
6480bb997d1393ca85856ec2,2022,,,1,HH Pandya,R Tewatia,9,7,1,0,1,6,4,1,0,2,3,0,0
6480bb9c7ac2dca34620d56e,2009/10,,,1,S Badrinath,SK Raina,9,8,1,0,1,7,6,1,0,1,2,0,0
6480bba3aa840e4e9450a200,2016,,,1,CH Morris,Q de Kock,9,7,1,0,1,2,2,0,0,7,5,1,0
6480bb96a467817b9b68ca94,2020/21,,,2,KS Williamson,Rashid Khan,9,4,2,0,1,9,4,2,0,0,0,0,0
6480bba0eb5a345386bdc825,2013,,,1,Harbhajan Singh,R Dhawan,9,3,2,0,0,4,1,1,0,4,2,1,0
6480bb9e156723e64d6bd26b,2012,,,1,CL White,DW Steyn,9,5,1,0,1,6,3,1,0,2,2,0,0
6480bb9b82dc3ec84c520466,2009,,,2,CH Gayle,SC Ganguly,9,16,1,0,1,8,8,1,0,1,8,0,0
6480bb9a9801c2dda3fe88e9,2007/08,,,2,MK Tiwary,Shoaib Malik,9,7,1,0,1,5,3,1,0,2,4,0,0
6480bb9fc28e897b3c53f359,2012,,,2,JEC Franklin,RG Sharma,9,12,0,0,1,3,5,0,0,4,7,0,0
6480bb9553f3fc8903579544,2018,,,2,RK Singh,TK Curran,9,6,2,0,1,5,3,1,0,4,3,1,0
6480bb954e496ec9b12aa120,2019,,,1,BA Stokes,SPD Smith,9,12,0,0,1,4,4,0,0,5,8,0,0
6480bb9b4fc6889967a3cd54,2007/08,,,1,DNT Zoysa,H Das,9,8,1,0,1,7,3,1,0,2,5,0,0
6480bb93d5dc00a79edede9c,2017,,,2,BCJ Cutting,Yuvraj Singh,9,4,2,0,1,4,1,1,0,4,3,1,0
6480bb9a9514379c05d59c38,2023,,,1,Dhruv Jurel,YBK Jaiswal,9,5,0,1,1,2,3,0,0,7,2,0,1
6480bba0eb5a345386bdc825,2013,,,1,AT Rayudu,KA Pollard,9,6,0,1,1,2,3,0,0,7,3,0,1
6480bba00be5cdbaf6648462,2013,,,1,AB de Villiers,V Kohli,9,5,2,0,1,5,3,1,0,4,2,1,0
6480bba28257fe87dd859e3e,2015,,,1,M Vijay,V Sehwag,9,7,0,0,1,1,2,0,0,2,5,0,0
6480bb95f282ca61c07afe9b,2018,,,1,BB McCullum,PA Patel,9,8,1,0,1,5,3,1,0,2,5,0,0
6480bba07fa24b891b818984,2013,,,1,M Vohra,PP Chawla,9,4,0,1,1,7,2,0,1,1,2,0,0
6480bb9fcbbfd8053f253537,2012,,,1,DA Warner,DPMD Jayawardene,9,13,1,0,1,6,7,1,0,3,6,0,0
6480bb9aa030c8ebcbcc19c9,2007/08,,,1,RV Uthappa,ST Jayasuriya,9,10,1,0,1,6,5,1,0,1,5,0,0
6480bb94ee669473878c11c2,2017,,,2,AB de Villiers,CH Gayle,9,7,2,0,1,8,6,2,0,1,1,0,0
6480bba0fee4ae82492a666f,2013,,,1,GH Vihari,PA Patel,9,14,0,0,1,3,8,0,0,6,6,0,0
6480bb9384cbae8edee3707f,2017,,,1,N Rana,RG Sharma,9,13,1,0,1,7,7,1,0,2,6,0,0
6480bb9c963968000dfd00d1,2009/10,,,1,JA Morkel,R Ashwin,9,8,1,0,1,5,3,1,0,2,5,0,0
6480bb9c54a72690027ba3d4,2009/10,,,2,DJ Bravo,R McLaren,9,4,0,1,0,8,3,0,1,1,1,0,0
6480bb9c12e6c723b248799b,2009,,,2,HH Gibbs,RJ Harris,9,5,0,0,0,0,0,0,0,9,5,0,0
6480bba31cc11024436836b5,2016,,,2,CH Morris,S Nadeem,9,7,0,1,1,8,6,0,1,0,1,0,0
6480bb9a2b33e06f46eed54f,2023,,,1,AS Roy,SP Narine,9,8,1,0,1,3,3,0,0,6,5,1,0
6480bb995f3db9699a1f794d,2022,,,2,D Padikkal,YBK Jaiswal,9,17,0,0,1,3,9,0,0,6,8,0,0
6480bba34d78f594b07da1bc,2016,,,2,KC Cariappa,MM Sharma,9,9,1,0,1,2,3,0,0,7,6,1,0
6480bb95f282ca61c07afe9b,2018,,,1,AB de Villiers,PA Patel,9,8,1,0,1,1,4,0,0,8,4,1,0
6480bb9cff4ec2f71cdf18d1,2009/10,,,1,S Dhawan,SS Tiwary,9,10,0,0,1,8,8,0,0,1,2,0,0
6480bb9e30b7f3c09cfbdabb,2011,,,2,AL Menaria,JDP Oram,9,10,1,0,1,9,7,1,0,0,3,0,0
6480bb94ebff9a116f68560b,2018,,,2,KS Williamson,MK Pandey,9,21,0,0,1,5,10,0,0,4,11,0,0
6480bb94b9d954a885cc531b,2017,,,1,KA Pollard,KH Pandya,9,5,0,1,1,7,3,0,1,2,2,0,0
6480bb9baccf501985a56d64,2007/08,,,1,M Rawat,NK Patel,9,5,2,0,0,5,4,1,0,4,1,1,0
6480bb9e692eaa193a417426,2012,,,1,AB McDonald,V Kohli,9,12,1,0,1,5,7,1,0,2,5,0,0
6480bb942fc9529eb2869c17,2018,,,2,AT Rayudu,SW Billings,9,7,2,0,1,0,0,0,0,9,7,2,0
6480bb9a6ecee5429e0468be,2023,,,1,KS Sharma,M Vohra,9,12,1,0,1,3,6,0,0,6,6,1,0
6480bb96ec01f8fb3504bc36,2020/21,,,1,MK Lomror,R Tewatia,9,5,0,1,1,8,4,0,1,1,1,0,0
6480bb9a81d7fd0ac0307b4d,2023,,,1,CJ Jordan,N Wadhera,9,8,0,0,1,4,7,0,0,1,1,0,0
6480bb972a7d4e1071ea662e,2021,,,1,Q de Kock,RG Sharma,9,13,0,0,1,2,4,0,0,6,9,0,0
6480bb99c6aa5989a16174d1,2023,,,2,SV Samson,YBK Jaiswal,9,12,0,0,1,7,9,0,0,1,3,0,0
6480bba2f39653e2f61baca2,2015,,,2,NM Coulter-Nile,SS Tiwary,9,6,1,0,0,3,2,0,0,6,4,1,0
6480bb94dfad571ef76493a9,2017,,,1,A Mishra,Mohammed Shami,9,6,0,1,1,2,2,0,0,7,4,0,1
6480bb9c12f907c7b81b11a9,2009,,,1,BB McCullum,SC Ganguly,9,6,2,0,1,9,3,2,0,0,3,0,0
6480bb9384cbae8edee3707f,2017,,,2,KK Nair,SV Samson,9,4,2,0,1,1,1,0,0,8,3,2,0
6480bb9b5d0191a0a2611916,2009,,,1,PP Chawla,WA Mota,9,6,1,0,0,6,4,1,0,1,2,0,0
6480bb9e88141830a7a309b5,2011,,,2,G Gambhir,JH Kallis,9,10,1,0,1,0,3,0,0,7,7,1,0
6480bb98af25209ef756aa2c,2021,,,2,HH Pandya,KA Pollard,9,12,0,0,1,3,6,0,0,5,6,0,0
6480bb94ca3c1b1eac5e8dd3,2018,,,2,DJ Bravo,KM Jadhav,9,5,0,1,0,7,4,0,1,1,1,0,0
6480bb9ff2e0b1df0c3972c9,2012,,,1,DPMD Jayawardene,Y Venugopal Rao,9,13,1,0,1,7,8,1,0,2,5,0,0
6480bb94d8ce46258c13e90e,2017,,,1,PA Patel,RG Sharma,9,10,1,0,1,3,5,0,0,6,5,1,0
6480bba0d4b2f9be71a5f230,2014,,,1,SA Yadav,Shakib Al Hasan,9,3,2,0,0,8,3,2,0,0,0,0,0
6480bb9e19dd5297ba8ca5f7,2011,,,1,B Kumar,WD Parnell,9,4,0,1,1,1,1,0,0,8,3,0,1
6480bba2c5a614e0fd10cd19,2016,,,2,AD Russell,SA Yadav,9,12,0,0,1,7,9,0,0,2,3,0,0
6480bba33195e5ebac1da82a,2016,,,2,Gurkeerat Singh,M Vijay,9,7,1,0,0,6,4,1,0,3,3,0,0
6480bb9ea49fe0f895bf242a,2012,,,1,AT Rayudu,RE Levi,9,9,0,0,1,6,5,0,0,3,4,0,0
6480bba1b85900d7d83de308,2014,,,1,KV Sharma,NV Ojha,9,4,0,1,0,1,1,0,0,8,3,0,1
6480bb9ca668b7b36823fb21,2009,,,1,AB de Villiers,R Bhatia,9,12,1,0,1,6,6,1,0,2,6,0,0
6480bb9538916411f52016bf,2019,,,1,AD Russell,CA Lynn,9,9,1,0,1,2,3,0,0,6,6,1,0
6480bba0b46cf5430edef3f5,2014,,,2,JH Kallis,RV Uthappa,9,6,0,1,1,8,4,0,1,1,2,0,0
6480bb9996eb97dd08b62f78,2023,,,2,JM Sharma,M Shahrukh Khan,9,8,0,1,1,2,3,0,0,7,5,0,1
6480bb94d8aa9021808a4760,2017,,,1,Bipul Sharma,NV Ojha,9,9,0,0,1,2,3,0,0,6,6,0,0
6480bb9b4b74852492343291,2007/08,,,2,KD Karthik,S Dhawan,9,7,1,0,1,6,4,1,0,3,3,0,0
6480bb9d6919e7181371271f,2011,,,2,AM Nayar,R McLaren,9,15,1,0,1,2,7,0,0,6,8,1,0
6480bb9836d24b9817a35f7d,2022,,,1,DJ Hooda,MK Pandey,9,6,1,0,1,4,3,0,0,4,3,1,0
6480bba38056992b92414bab,2016,,,1,JO Holder,YK Pathan,9,6,1,0,1,3,3,0,0,6,3,1,0
6480bb99bbae76f3f761d060,2023,,,2,RK Singh,UT Yadav,9,6,0,0,1,3,2,0,0,4,4,0,0
6480bb9c94ef2c2e850189ff,2009/10,,,2,DPMD Jayawardene,IK Pathan,9,3,1,0,0,5,2,1,0,3,1,0,0
6480bb95f214d4f82ab97ee5,2018,,,1,JC Buttler,SV Samson,9,12,1,0,1,2,5,0,0,7,7,1,0
6480bb97a4220e27710e38de,2021,,,2,EJG Morgan,N Rana,9,5,2,0,1,1,1,0,0,8,4,2,0
6480bb95e435367dc64d9844,2019,,,1,BCJ Cutting,KH Pandya,9,5,0,1,0,7,3,0,1,2,2,0,0
6480bb9d105fba311a23a588,2011,,,1,PA Patel,RA Jadeja,9,8,1,0,0,1,4,0,0,7,4,1,0
6480bb9bdde9db92f880e40d,2007/08,,,2,DPMD Jayawardene,IK Pathan,9,8,1,0,1,1,4,0,0,7,4,1,0
6480bba3de527604cd2f96f3,2016,,,1,Q de Kock,RR Pant,9,11,0,0,1,2,9,0,0,1,2,0,0
6480bb9d8f5769d3a514fd88,2009/10,,,2,AT Rayudu,JP Duminy,9,7,1,0,1,6,3,1,0,3,4,0,0
6480bba3caa5150f2db7a1dc,2016,,,2,AJ Finch,BB McCullum,9,12,0,0,1,4,5,0,0,3,7,0,0
6480bba2557febf92f9f79ab,2015,,,2,AD Russell,RN ten Doeschate,9,9,0,0,1,4,4,0,0,5,5,0,0
6480bb9f6f311344dac147cc,2012,,,1,DB Das,MK Tiwary,9,6,0,0,0,3,2,0,0,6,4,0,0
6480bba1553f17c77d5f1ca2,2014,,,2,AT Rayudu,RG Sharma,9,6,1,0,1,5,4,1,0,1,2,0,0
6480bb9a1e358307d26cd50d,2023,,,2,JP Behrendorff,K Kartikeya,9,11,1,0,1,3,5,0,0,6,6,1,0
6480bb980d1be75574871dcc,2022,,,1,GJ Maxwell,KD Karthik,9,5,0,1,1,7,2,0,1,2,3,0,0
6480bba1743abcb135a6a4c7,2015,,,2,SPD Smith,SV Samson,9,8,1,0,1,5,3,1,0,4,5,0,0
6480bb99af95c6c90c4c3924,2023,,,2,Abdul Samad,B Kumar,9,9,1,0,1,5,5,1,0,2,4,0,0
6480bb95f2e3c32afe233820,2018,,,1,Rashid Khan,WP Saha,9,5,0,1,1,0,1,0,0,8,4,0,1
6480bb9d7aa8d2c4c947d164,2009/10,,,1,CL White,V Kohli,9,5,2,0,1,1,1,0,0,8,4,2,0
6480bb9de80788b3c3ebe4e1,2009/10,,,1,MJ Lumb,NV Ojha,9,10,2,0,1,8,6,2,0,0,4,0,0
6480bb98b8bb5b0d2c2f0848,2022,,,1,DR Sams,Tilak Varma,9,6,1,0,1,5,3,1,0,4,3,0,0
6480bb942efd740a6ffc47df,2017,,,1,N Rana,RG Sharma,9,11,1,0,1,1,5,0,0,8,6,1,0
6480bb964c4bea88164f168d,2020/21,,,1,AD Russell,EJG Morgan,9,7,0,1,1,7,3,0,1,1,4,0,0
6480bba1ff89cb428182daa6,2014,,,1,GJ Bailey,GJ Maxwell,9,8,1,0,1,2,3,0,0,5,5,1,0
6480bb9c50838010977c168c,2009,,,1,JDP Oram,R Ashwin,9,18,0,0,1,4,5,0,0,4,13,0,0
6480bb9c620c92d09ba1b6b9,2009,,,1,DB Ravi Teja,DR Smith,9,7,1,0,1,5,2,1,0,4,5,0,0
6480bb9f231505ffc493730f,2012,,,2,PA Patel,S Dhawan,9,10,1,0,1,1,5,0,0,8,5,1,0
6480bba2b7be71a15b2bb3de,2015,,,2,DJ Bravo,MS Dhoni,9,6,0,1,1,9,6,0,1,0,0,0,0
6480bb9e80233e83b9d1be1f,2012,,,1,Harbhajan Singh,PP Ojha,9,13,1,0,1,5,5,1,0,1,8,0,0
6480bb9480627b50308b7903,2017,,,1,Ankit Soni,Basil Thampi,9,6,0,1,0,7,2,0,1,2,4,0,0
6480bb94a0422f6d0abe276b,2017,,,1,G Gambhir,SP Narine,9,8,1,0,1,4,4,0,0,4,4,1,0
6480bb9e93f969bcc8a79433,2011,,,1,EJG Morgan,JH Kallis,9,7,1,0,1,5,6,1,0,1,1,0,0
6480bba0120becd670aec59d,2013,,,1,AM Nayar,RV Uthappa,9,6,0,1,1,1,3,0,0,8,3,0,1
6480bb945460b25d997060fb,2018,,,2,G Gambhir,SS Iyer,9,6,2,0,1,5,3,1,0,4,3,1,0
6480bb96c880c7df4e055f14,2020/21,,,2,K Gowtham,SN Khan,9,7,1,0,1,3,3,0,0,6,4,1,0
6480bb9834c7569d5fa64353,2022,,,2,HE van der Dussen,SV Samson,9,9,0,1,1,1,1,0,0,8,8,0,1
6480bb9834c7569d5fa64353,2022,,,2,JC Buttler,SV Samson,9,5,0,1,1,6,2,0,1,3,3,0,0
6480bba0b46cf5430edef3f5,2014,,,1,CM Gautam,KA Pollard,9,9,1,0,1,7,7,1,0,2,2,0,0
6480bb9f87652064dab6c573,2013,,,1,DJ Hussey,Mandeep Singh,9,9,0,0,1,3,3,0,0,6,6,0,0
6480bb9dfa7d0510ae3a7b40,2011,,,1,DA Warner,IK Pathan,9,11,0,0,1,5,8,0,0,2,3,0,0
6480bb9b5d0191a0a2611916,2009,,,2,RA Jadeja,YK Pathan,9,13,1,0,1,7,7,1,0,2,6,0,0
6480bb9c1e676472f4841aa9,2009/10,,,1,EJG Morgan,RV Uthappa,9,7,0,1,1,1,4,0,0,8,3,0,1
6480bb9b69f8ace7659e486d,2009,,,2,GC Smith,RJ Quiney,9,12,1,0,1,2,5,0,0,6,7,1,0
6480bb966f48b8ee03e6dff5,2020/21,,,1,MS Dhoni,SM Curran,9,8,0,1,1,7,6,0,1,1,2,0,0
6480bb94640655c49683aee1,2018,,,1,KA Pollard,M Markande,9,8,1,0,0,8,7,1,0,0,1,0,0
6480bb98e87e6f83b61088ea,2022,,,2,D Pretorius,MS Dhoni,9,5,0,1,1,8,4,0,1,1,1,0,0
6480bb993e61058e682e2ff4,2023,,,1,DA Miller,R Tewatia,9,4,2,0,1,8,4,2,0,0,0,0,0
6480bb99e520ec7a66b73adb,2022,,,1,PP Shaw,RR Pant,9,14,1,0,1,8,10,1,0,1,4,0,0
6480bb9f58a3e7ea877fc9dc,2012,,,1,A Ashish Reddy,J Theron,9,6,1,0,1,5,5,1,0,0,1,0,0
6480bb9be88c31fc563da86f,2009,,,1,KP Appanna,P Kumar,9,5,1,0,0,0,1,0,0,8,4,1,0
6480bb9dbefe5e2cceb23e01,2011,,,1,R Sathish,SR Tendulkar,9,13,1,0,1,0,7,0,0,4,6,1,0
6480bba2557febf92f9f79ab,2015,,,2,MK Pandey,SA Yadav,9,12,1,0,1,3,7,0,0,6,5,1,0
6480bb97668d35800fa74139,2021,,,1,M Ashwin,M Shahrukh Khan,9,9,1,0,1,7,6,1,0,2,3,0,0
6480bb9c2f07203e8e510386,2009/10,,,1,M Kaif,RS Bopara,9,9,1,0,1,6,6,1,0,3,3,0,0
6480bba1017a98eead1ec861,2015,,,1,KK Nair,STR Binny,9,6,0,1,1,8,5,0,1,1,1,0,0
6480bb9bfcaabf33b5687e32,2007/08,,,2,AM Nayar,DR Smith,9,7,1,0,1,6,5,1,0,1,2,0,0
6480bb9f00ef088221497043,2013,,,2,MEK Hussey,SK Raina,9,10,1,0,1,2,2,0,0,7,8,1,0
6480bb9c9685addc4a78d7d0,2009/10,,,1,B Lee,K Goel,9,7,1,0,0,7,5,1,0,0,2,0,0
6480bb93575636076d81e4c5,2017,,,2,I Sharma,Sandeep Sharma,9,8,0,0,1,1,4,0,0,5,4,0,0
6480bba29f384ce360fa8131,2016,,,1,DA Miller,M Vijay,9,5,0,1,1,2,2,0,0,7,3,0,1
6480bba25855b7a7195a9bc5,2016,,,2,PA Patel,RG Sharma,9,10,2,0,1,1,4,0,0,8,6,2,0
6480bb9b6ded6d116cfe02ee,2009,,,1,SC Ganguly,Yashpal Singh,9,11,0,0,1,4,6,0,0,5,5,0,0
6480bba28257fe87dd859e3e,2015,,,1,MG Johnson,WP Saha,9,7,0,1,1,8,4,0,1,1,3,0,0
6480bba0f858e6c12b25d8c3,2014,,,1,RV Uthappa,YK Pathan,9,8,1,0,1,5,3,1,0,3,5,0,0
6480bba26bb69626041c4ba1,2015,,,2,SA Yadav,YK Pathan,9,6,0,0,0,0,2,0,0,5,4,0,0
6480bb9824c4678d005d7aeb,2022,,,1,KK Nair,SO Hetmyer,9,10,0,0,1,3,5,0,0,4,5,0,0
6480bb9b0b09749af4aa32dd,2009,,,1,DPMD Jayawardene,T Kohli,9,10,1,0,1,8,6,1,0,1,4,0,0
6480bb9754755bb7a7427d52,2021,,,1,RA Tripathi,SP Narine,9,10,1,0,1,3,3,0,0,6,7,1,0
6480bb9e21655ee16a96b2c3,2012,,,1,R Vinay Kumar,Z Khan,9,7,1,0,1,9,6,1,0,0,1,0,0
6480bba0f858e6c12b25d8c3,2014,,,2,CA Pujara,V Sehwag,9,11,1,0,1,8,8,1,0,0,3,0,0
6480bb9cdf6c63fec90a42df,2009/10,,,1,AD Mathews,SC Ganguly,9,11,0,0,1,4,7,0,0,2,4,0,0
6480bba1cef79f12933bbf27,2014,,,1,DJ Hussey,SK Raina,9,11,0,0,1,3,6,0,0,2,5,0,0
6480bb9a36f2ab9a44baa0f8,2023,,,1,SO Hetmyer,TA Boult,9,6,1,0,1,2,3,0,0,6,3,1,0
6480bb9e41b781523bd5aafe,2012,,,1,B Lee,Iqbal Abdulla,8,4,0,1,1,7,3,0,1,1,1,0,0
6480bb9a1a3ab2ab8297871d,2007/08,,,2,RA Jadeja,SK Warne,8,7,1,0,1,1,3,0,0,5,4,1,0
6480bb9eb35365cccf73d55c,2011,,,1,RV Uthappa,Yuvraj Singh,8,10,1,0,1,1,4,0,0,7,6,1,0
6480bb9c13fa57328b17e4e2,2009/10,,,1,A Mishra,M Manhas,8,4,1,0,0,6,3,1,0,1,1,0,0
6480bb971c9e4a3ef11759f3,2021,,,2,RA Tripathi,SP Narine,8,7,1,0,1,6,3,1,0,0,4,0,0
6480bb9480627b50308b7903,2017,,,1,Ishan Kishan,KD Karthik,8,14,0,0,1,4,6,0,0,2,8,0,0
6480bb9bf2869505c9393b7d,2009,,,2,AB Agarkar,M Kartik,8,4,0,1,1,6,2,0,1,2,2,0,0
6480bba0a9f68a29bda72302,2013,,,1,G Gambhir,JH Kallis,8,14,0,0,1,4,7,0,0,1,7,0,0
6480bb9f90a251567178de39,2012,,,1,DJ Hussey,PP Chawla,8,3,2,0,1,0,0,0,0,8,3,2,0
6480bb96c3293977af83acbf,2019,,,1,K Gowtham,R Parag,8,11,1,0,1,6,6,1,0,2,5,0,0
6480bb9b2de4e62ee60b7e5c,2009,,,1,LRPL Taylor,V Kohli,8,7,1,0,1,5,4,1,0,2,3,0,0
6480bb990942cd416cf5f447,2022,,,1,Shubman Gill,WP Saha,8,16,1,0,1,3,5,0,0,5,11,1,0
6480bb9a7194d8b20952afae,2007/08,,,1,G Gambhir,Shoaib Malik,8,7,1,0,1,2,3,0,0,6,4,1,0
6480bba1d3370c13ea1f79f3,2014,,,2,MA Agarwal,Q de Kock,8,8,1,0,1,3,3,0,0,5,5,1,0
6480bb9f7ff1377c4d13a645,2013,,,2,RV Uthappa,Yuvraj Singh,8,8,1,0,1,7,8,1,0,0,0,0,0
6480bba048fb3d33ea0711e7,2013,,,2,DW Steyn,NLTC Perera,8,6,1,0,0,1,3,0,0,5,3,1,0
6480bb9a40966b9b90fcdf2e,2023,,,1,PBB Rajapaksa,S Dhawan,8,10,1,0,1,0,3,0,0,5,7,1,0
6480bb9d6919e7181371271f,2011,,,1,JD Ryder,RV Uthappa,8,4,2,0,1,8,3,2,0,0,1,0,0
6480bba06e8cb70fb4bdc83e,2013,,,1,CH Gayle,V Kohli,8,6,1,0,1,3,4,0,0,4,2,1,0
6480bba1cef79f12933bbf27,2014,,,2,DJG Sammy,S Dhawan,8,7,1,0,1,0,3,0,0,7,4,1,0
6480bb9b166300b6298fc71a,2009,,,2,AS Raut,LA Carseldine,8,4,1,0,0,1,1,0,0,7,3,1,0
6480bba2e8614b1263627c1b,2015,,,1,AM Rahane,SR Watson,8,6,2,0,1,8,6,2,0,0,0,0,0
6480bb981dc3f7250f93bc92,2022,,,2,DA Warner,MR Marsh,8,10,1,0,1,3,3,0,0,5,7,1,0
6480bb9809c62ba77e5df472,2021,,,1,DT Christian,HV Patel,8,5,1,0,1,1,1,0,0,6,4,1,0
6480bb9aa64355ce98da1141,2007/08,,,1,A Kumble,R Dravid,8,7,0,1,1,2,5,0,0,6,2,0,1
6480bb9f68a0a232d83c338c,2012,,,1,CH Gayle,TM Dilshan,8,14,0,1,1,6,8,0,1,2,6,0,0
6480bb999424dd02cf40772a,2022,,,2,KL Rahul,Q de Kock,8,6,0,1,1,1,1,0,0,6,5,0,1
6480bb9d66dc7da0d45e453c,2011,,,2,AC Gilchrist,SE Marsh,8,9,1,0,1,1,2,0,0,5,7,1,0
6480bb9e56c724ba25b94666,2011,,,2,AC Blizzard,RG Sharma,8,7,1,0,1,2,2,0,0,5,5,1,0
6480bba27b4786f36f706f8e,2016,,,1,LMP Simmons,RG Sharma,8,7,1,0,1,1,2,0,0,7,5,1,0
6480bb99f816e64203e3c687,2023,,,1,S Dhawan,Sikandar Raza,8,6,1,0,1,2,2,0,0,6,4,1,0
6480bb9f6b144f2a6d105b32,2013,,,2,DR Smith,KA Pollard,8,9,1,0,1,3,5,0,0,5,4,1,0
6480bb9a3ffea6235f54cc1e,2023,,,1,JJ Roy,Rahmanullah Gurbaz,8,7,2,0,1,8,6,2,0,0,1,0,0
6480bba09d6b23c8722fd208,2013,,,2,KD Karthik,RG Sharma,8,13,0,0,1,2,3,0,0,6,10,0,0
6480bb98e87e6f83b61088ea,2022,,,2,AT Rayudu,MM Ali,8,14,1,0,1,7,12,1,0,0,2,0,0
6480bb96ee2a21f0d9b9f37f,2020/21,,,2,SP Narine,Shubman Gill,8,8,0,0,1,3,5,0,0,1,3,0,0
6480bba07b5396a7b65684d3,2013,,,2,Iqbal Abdulla,R Bhatia,8,11,0,0,1,4,6,0,0,4,5,0,0
6480bb931e6d2b03141b586d,2017,,,1,CH Morris,RR Pant,8,5,1,0,1,5,3,1,0,1,2,0,0
6480bb9f4bdcea2f81049fe9,2012,,,1,P Negi,Sunny Gupta,8,6,0,1,1,8,5,0,1,0,1,0,0
6480bba1827557ebdfc70821,2015,,,1,GJ Bailey,MG Johnson,8,4,0,1,1,7,3,0,1,1,1,0,0
6480bba154ce29a67e4752df,2015,,,1,AN Ahmed,D Wiese,8,5,1,0,0,1,1,0,0,7,4,1,0
6480bb93ec7e3351941d3b5b,2017,,,2,TS Mills,YS Chahal,8,7,0,1,1,6,3,0,1,1,4,0,0
6480bba08ffdd4393211d261,2014,,,2,M Manhas,MS Dhoni,8,6,1,0,0,3,4,0,0,5,2,1,0
6480bb991a4f7e5f59dd1afc,2023,,,2,RK Singh,UT Yadav,8,5,0,1,0,7,4,0,1,1,1,0,0
6480bb9ddcbb8fbbad6614c8,2009/10,,,1,DL Vettori,KD Karthik,8,15,1,0,1,2,4,0,0,6,11,1,0
6480bb984f6c41cd28aa0353,2022,,,1,E Lewis,KL Rahul,8,9,1,0,1,1,5,0,0,7,4,1,0
6480bba23ed328dbb847b4e7,2016,,,1,CH Gayle,KL Rahul,8,9,0,1,1,7,7,0,1,1,2,0,0
6480bb9651b51fdcda05e4c8,2020/21,,,2,BA Stokes,SPD Smith,8,7,1,0,1,7,7,1,0,0,0,0,0
6480bb9d109617dfa089c2c6,2011,,,2,JH Kallis,MS Bisla,8,8,0,0,1,4,5,0,0,1,3,0,0
6480bb9e30b7f3c09cfbdabb,2011,,,2,AM Rahane,SR Watson,8,13,1,0,1,8,9,1,0,0,4,0,0
6480bb9e80233e83b9d1be1f,2012,,,1,KA Pollard,RG Sharma,8,8,1,0,1,1,3,0,0,6,5,1,0
6480bb9b4fc6889967a3cd54,2007/08,,,1,DNT Zoysa,RP Singh,8,7,0,0,0,3,4,0,0,3,3,0,0
6480bb9a43249ece8e841e56,2023,,,2,C Green,N Wadhera,8,4,0,1,0,2,2,0,0,6,2,0,1
6480bb9fc28e897b3c53f359,2012,,,2,DR Smith,RG Sharma,8,8,1,0,1,5,3,1,0,3,5,0,0
6480bb9ba9d43057d652a5fe,2009,,,2,JP Duminy,S Dhawan,8,17,0,0,1,6,12,0,0,2,5,0,0
6480bb9827e9fb920cf62809,2021,,,1,B Kumar,Rashid Khan,8,6,1,0,1,2,2,0,0,6,4,1,0
6480bb954817ed0a4ba25bc2,2018,,,1,BCJ Cutting,HH Pandya,8,13,0,0,1,4,7,0,0,4,6,0,0
6480bb9eb261c1057830912e,2011,,,1,MS Wade,NV Ojha,8,13,1,0,1,1,6,0,0,5,7,1,0
6480bb984a8abbb79a69e6ce,2022,,,2,AK Markram,Abdul Samad,8,12,0,0,1,4,6,0,0,4,6,0,0
6480bba16e510ff78ef635a1,2014,,,1,CJ Anderson,KA Pollard,8,4,0,1,1,0,1,0,0,7,3,0,1
6480bb9be2940d96c1f903ca,2007/08,,,2,Misbah-ul-Haq,R Dravid,8,11,0,0,1,4,6,0,0,4,5,0,0
6480bb9e8dfd9ba30b93cbd8,2012,,,1,B Chipli,CL White,8,6,0,1,1,2,4,0,0,6,2,0,1
6480bb95960e393c939ab44c,2018,,,1,GJ Maxwell,SS Iyer,8,8,1,0,1,6,7,1,0,1,1,0,0
6480bb9c5ec0713155cad138,2009/10,,,1,Jaskaran Singh,TL Suman,8,10,0,0,0,4,4,0,0,2,6,0,0
6480bb96e2809aa0bc35c7e9,2019,,,2,KS Williamson,MK Pandey,8,12,1,0,1,3,7,0,0,5,5,1,0
6480bb95816d3ad3bc382ab6,2018,,,2,AB de Villiers,Mandeep Singh,8,9,0,0,1,5,5,0,0,3,4,0,0
6480bb99f816e64203e3c687,2023,,,2,SN Thakur,VR Iyer,8,4,0,1,1,7,2,0,1,1,2,0,0
6480bb95af5853799812b0f6,2019,,,2,KD Karthik,N Rana,8,6,1,0,1,2,4,0,0,5,2,1,0
6480bba20559f15c3489f637,2015,,,1,J Suchith,MJ McClenaghan,8,4,0,0,0,6,3,0,0,1,1,0,0
6480bb9b9614f21d90333e15,2007/08,,,1,LA Pomersbach,Yuvraj Singh,8,4,0,1,1,1,1,0,0,7,3,0,1
6480bba1cef79f12933bbf27,2014,,,2,AJ Finch,S Dhawan,8,5,0,1,1,7,3,0,1,1,2,0,0
6480bb9442c4889bcbb4a784,2017,,,2,MS Dhoni,RA Tripathi,8,16,0,0,1,5,9,0,0,3,7,0,0
6480bba1ff89cb428182daa6,2014,,,2,M Manhas,MS Dhoni,8,4,0,1,1,0,0,0,0,8,4,0,1
6480bb988545a7776b8c9306,2022,,,2,GJ Maxwell,Shahbaz Ahmed,8,5,1,0,1,5,3,1,0,3,2,0,0
6480bb984a44a355b856fd1a,2022,,,2,KS Williamson,RA Tripathi,8,4,0,1,0,1,1,0,0,7,3,0,1
6480bb9a4de9fe3e7319ce39,2007/08,,,2,M Kaif,SR Watson,8,7,2,0,0,4,6,1,0,4,1,1,0
6480bb9a17692bfb5bd3894c,2007/08,,,1,JA Morkel,SK Raina,8,7,1,0,1,5,3,1,0,3,4,0,0
6480bb953aab41e7ed166b9d,2019,,,1,AR Patel,RR Pant,8,3,2,0,1,4,2,1,0,4,1,1,0
6480bba264ad6b873d0d07d8,2016,,,2,SR Watson,V Kohli,8,10,1,0,1,6,6,1,0,2,4,0,0
6480bb9f302200e3bc89464e,2012,,,2,OA Shah,SP Goswami,8,6,0,0,1,5,3,0,0,3,3,0,0
6480bb9f6b144f2a6d105b32,2013,,,1,MS Dhoni,S Badrinath,8,11,0,0,1,2,2,0,0,5,9,0,0
6480bb94ebff9a116f68560b,2018,,,1,CA Lynn,KD Karthik,8,10,0,0,1,3,4,0,0,4,6,0,0
6480bb99e520ec7a66b73adb,2022,,,1,AR Patel,Kuldeep Yadav,8,3,0,1,0,6,2,0,1,1,1,0,0
6480bb9b09e6c98206422ae5,2009,,,2,GC Smith,PC Valthaty,8,12,1,0,1,2,5,0,0,5,7,1,0
6480bba11c977a5d11c1aa38,2015,,,1,EJG Morgan,RS Bopara,8,4,0,1,1,1,1,0,0,7,3,0,1
6480bba1d21281c7385d5ce4,2014,,,1,CH Gayle,PA Patel,8,13,2,0,1,4,7,1,0,4,6,1,0
6480bb99ed38bcb4025b8d86,2023,,,2,GJ Maxwell,MG Bracewell,8,12,1,0,1,5,7,1,0,3,5,0,0
6480bb9ef7c6084992b7cdf8,2012,,,1,DPMD Jayawardene,KP Pietersen,8,7,1,0,1,6,5,1,0,1,2,0,0
6480bb9a5d25d853e1cbfe3e,2007/08,,,2,DPMD Jayawardene,JR Hopes,8,6,0,0,1,2,4,0,0,5,2,0,0
6480bba2b341a081c069198d,2015,,,2,AM Rahane,DJ Hooda,8,11,0,0,1,3,5,0,0,5,6,0,0
6480bb98aae066234fd8f11e,2022,,,2,R Powell,SN Thakur,8,7,0,0,1,1,2,0,0,2,5,0,0
6480bb9f58a3e7ea877fc9dc,2012,,,2,Azhar Mahmood,DA Miller,8,9,1,0,1,5,4,1,0,3,5,0,0
6480bb9b2e179d359c1d446d,2009,,,1,AC Gilchrist,HH Gibbs,8,5,2,0,1,8,5,2,0,0,0,0,0
6480bb94a0422f6d0abe276b,2017,,,2,RR Pant,SS Iyer,8,7,1,0,1,6,4,1,0,2,3,0,0
6480bb99f2a793884331579e,2023,,,2,N Wadhera,TH David,8,5,1,0,1,6,4,1,0,1,1,0,0
6480bb98aae066234fd8f11e,2022,,,2,PP Shaw,TL Seifert,8,7,1,0,1,5,2,1,0,3,5,0,0
6480bb98a95cb1650c81c926,2022,,,2,HV Patel,JR Hazlewood,8,11,0,1,1,7,9,0,1,0,2,0,0
6480bb9a77f349a0fd8d96d6,2023,,,1,LS Livingstone,S Dhawan,8,11,1,0,1,6,8,1,0,1,3,0,0
6480bb9fcb2b412c0ebd4afa,2013,,,2,CH Gayle,TM Dilshan,8,7,0,0,1,1,2,0,0,2,5,0,0
6480bb9538916411f52016bf,2019,,,1,CA Lynn,Shubman Gill,8,10,0,0,1,5,6,0,0,3,4,0,0
6480bb98323919fff9902666,2022,,,2,R Parag,SO Hetmyer,8,5,0,1,0,0,1,0,0,7,4,0,1
6480bb9a596c087c0396ec2e,2007/08,,,2,JH Kallis,LRPL Taylor,8,7,1,0,1,3,4,0,0,5,3,1,0
6480bba0c1c8569f19cc70f0,2013,,,2,M Rawat,MR Marsh,8,2,0,1,0,0,0,0,0,8,2,0,1
6480bb9442c4889bcbb4a784,2017,,,2,DT Christian,Washington Sundar,8,4,0,1,0,6,1,0,1,1,3,0,0
6480bb9fc28e897b3c53f359,2012,,,1,MS Dhoni,RA Jadeja,8,5,0,1,1,7,3,0,1,1,2,0,0
6480bba25855b7a7195a9bc5,2016,,,2,HH Pandya,RG Sharma,8,3,0,1,1,1,1,0,0,7,2,0,1
6480bba20559f15c3489f637,2015,,,1,KA Pollard,RG Sharma,8,8,1,0,1,6,5,1,0,2,3,0,0
6480bb9eb559e2934b31c47c,2012,,,1,DE Bollinger,SB Jakati,8,11,0,0,1,3,5,0,0,5,6,0,0
6480bb980b5b26e8c4335a4b,2022,,,2,D Pretorius,RA Jadeja,8,3,0,1,0,1,1,0,0,7,2,0,1
6480bb9ff2e0b1df0c3972c9,2012,,,2,DJ Hussey,Gurkeerat Singh,8,6,2,0,1,0,1,0,0,8,5,2,0
6480bb9d967f5a4cfbd8c74d,2011,,,1,JR Hopes,Y Venugopal Rao,8,7,0,1,1,7,3,0,1,1,4,0,0
6480bb9cf1471ad233c7b0af,2009,,,2,SK Trivedi,SK Warne,8,5,0,1,1,1,2,0,0,6,3,0,1
6480bb9c12f907c7b81b11a9,2009,,,1,LR Shukla,SS Shaikh,8,14,1,0,1,2,7,0,0,6,7,1,0
6480bb941ab79050c3c90ee5,2018,,,1,KD Karthik,RK Singh,8,10,1,0,1,6,6,1,0,2,4,0,0
6480bb984f0f3dc0df6d4531,2022,,,1,KA Pollard,Tilak Varma,8,17,0,0,1,4,14,0,0,2,3,0,0
6480bb9bca2c11520f5b3b9e,2007/08,,,2,JR Hopes,SE Marsh,8,9,1,0,1,2,5,0,0,6,4,1,0
6480bb9c3b082d71291a593c,2009,,,2,JDP Oram,ML Hayden,8,7,0,1,1,1,3,0,0,7,4,0,1
6480bb94aad1a08ca4276b4e,2018,,,1,KK Nair,MP Stoinis,8,11,0,0,1,3,5,0,0,5,6,0,0
6480bba0ffae8617ee64bd19,2013,,,1,MEK Hussey,SK Raina,8,12,0,0,1,3,5,0,0,4,7,0,0
6480bb953b102c650968cba2,2019,,,2,AT Rayudu,SR Watson,8,13,0,1,1,7,3,0,1,0,10,0,0
6480bb994877788ec5b187ff,2023,,,1,AT Rayudu,S Dube,8,5,0,1,1,1,1,0,0,7,4,0,1
6480bb9f146f5849bb759148,2013,,,2,AD Mathews,MR Marsh,8,5,0,1,1,1,2,0,0,7,3,0,1
6480bb9dc8b09381d0f01a9d,2011,,,2,JD Ryder,MK Pandey,8,8,0,1,1,7,4,0,1,1,4,0,0
6480bb9a07d46704efe103ef,2007/08,,,1,AC Gilchrist,RG Sharma,8,7,1,0,1,1,3,0,0,7,4,1,0
6480bb996c324f07ab7f763c,2023,,,2,N Jagadeesan,VR Iyer,8,9,0,1,1,1,5,0,0,7,4,0,1
6480bb9b82dc3ec84c520466,2009,,,1,JH Kallis,KP Pietersen,8,9,0,0,1,3,4,0,0,5,5,0,0
6480bb99349f00f851e8d2fd,2023,,,2,Ishan Kishan,RG Sharma,8,7,1,0,1,1,4,0,0,5,3,1,0
6480bb94c2dcb1007bf6788b,2017,,,1,A Choudhary,YS Chahal,8,10,0,0,1,4,6,0,0,4,4,0,0
6480bb93ec7e3351941d3b5b,2017,,,2,CH Gayle,TM Head,8,5,0,1,1,6,3,0,1,2,2,0,0
6480bb9bd918d2e963f0218a,2009,,,1,R Bishnoi,V Kohli,8,5,1,0,1,1,2,0,0,7,3,1,0
6480bb9c37b72d7a51019794,2009/10,,,1,DR Smith,RG Sharma,8,10,0,0,1,4,7,0,0,3,3,0,0
6480bb96686655f09172741d,2020/21,,,1,RR Pant,SS Iyer,8,11,0,0,1,4,5,0,0,4,6,0,0
6480bb955f4b3a84d6973620,2018,,,2,BA Stokes,DJM Short,8,5,1,0,1,1,2,0,0,6,3,1,0
6480bba1587a54176a9badf4,2014,,,1,R Vinay Kumar,SA Yadav,8,3,0,1,0,0,0,0,0,7,3,0,1
6480bb956b439141409fd739,2018,,,2,AR Patel,KL Rahul,8,12,0,0,1,4,5,0,0,4,7,0,0
6480bba38056992b92414bab,2016,,,2,B Kumar,KV Sharma,8,7,1,0,1,5,4,1,0,2,3,0,0
6480bba0a9f68a29bda72302,2013,,,2,LJ Wright,Yuvraj Singh,8,3,0,1,1,0,0,0,0,8,3,0,1
6480bb961570df6942a00888,2019,,,1,MK Pandey,YK Pathan,8,6,0,0,0,3,2,0,0,5,4,0,0
6480bba2c5a614e0fd10cd19,2016,,,2,G Gambhir,Shakib Al Hasan,8,7,1,0,1,2,3,0,0,6,4,1,0
6480bb993e61058e682e2ff4,2023,,,2,R Parag,SV Samson,8,12,0,0,1,5,7,0,0,3,5,0,0
6480bba0ad06ad631cf7665f,2014,,,2,KD Karthik,LRPL Taylor,8,7,1,0,1,1,1,0,0,6,6,1,0
6480bb98aae066234fd8f11e,2022,,,2,AR Patel,R Powell,8,4,2,0,1,8,4,2,0,0,0,0,0
6480bb9873e53eace3a69dc7,2022,,,1,Shubman Gill,WP Saha,8,7,1,0,1,7,5,1,0,0,2,0,0
6480bba0c1c8569f19cc70f0,2013,,,1,AM Rahane,BJ Hodge,8,7,1,0,1,5,4,1,0,3,3,0,0
6480bb98634dba60191637ad,2021,,,2,KS Williamson,WP Saha,8,11,1,0,1,1,6,0,0,7,5,1,0
6480bb9932735ca83d38f6e7,2022,,,2,Shashank Singh,Washington Sundar,8,15,0,0,1,6,9,0,0,2,6,0,0
6480bb97220be892fbfc2a36,2021,,,1,HH Pandya,KA Pollard,8,6,2,0,1,4,2,1,0,4,4,1,0
6480bb9f79be50f1621abcc6,2012,,,1,AM Nayar,PP Chawla,8,6,1,0,1,3,2,0,0,5,4,1,0
6480bba0d2cdb40c68c4739c,2013,,,2,KA Pollard,R Dhawan,8,5,1,0,1,5,2,1,0,3,3,0,0
6480bba2bae80e615447f251,2015,,,1,DJ Bravo,P Negi,8,7,1,0,1,2,3,0,0,6,4,1,0
6480bb9ccba48a6bb44ccc21,2009,,,2,AM Nayar,Harbhajan Singh,8,3,0,1,1,7,2,0,1,1,1,0,0
6480bb9a7577454a5220c94b,2007/08,,,1,DJ Bravo,RV Uthappa,8,8,1,0,1,1,5,0,0,6,3,1,0
6480bb9f231505ffc493730f,2012,,,2,CL White,KC Sangakkara,8,8,1,0,1,6,3,1,0,1,5,0,0
6480bb9eda28fb340ed37b49,2012,,,1,DW Steyn,JP Duminy,8,5,0,1,1,7,3,0,1,1,2,0,0
6480bb9927b39ebcfd7820b0,2022,,,2,AD Russell,RK Singh,8,6,1,0,1,2,3,0,0,6,3,1,0
6480bb9da398a7c3c645732c,2011,,,2,M Kartik,NL McCullum,8,2,0,1,0,0,0,0,0,8,2,0,1
6480bba1d21281c7385d5ce4,2014,,,2,GJ Maxwell,V Sehwag,8,6,1,0,1,6,3,1,0,2,3,0,0
6480bba2256bfaaf14c57ead,2015,,,2,G Gambhir,RV Uthappa,8,6,1,0,1,1,3,0,0,5,3,1,0
6480bb9a9dc58f49d783faa9,2023,,,2,JE Root,SO Hetmyer,8,7,0,1,1,1,2,0,0,7,5,0,1
6480bb9a81d7fd0ac0307b4d,2023,,,2,DJ Hooda,Ravi Bishnoi,8,12,0,0,1,4,6,0,0,3,6,0,0
6480bba1f5d65d6146678a7f,2015,,,1,AD Mathews,Yuvraj Singh,8,8,1,0,1,3,3,0,0,5,5,1,0
6480bb9ce544a2fc17a48bee,2009,,,2,AN Ghosh,BB McCullum,8,11,1,0,1,7,7,1,0,1,4,0,0
6480bba1e64915b9e7c849ca,2014,,,2,DA Miller,GJ Maxwell,8,7,0,0,1,1,2,0,0,5,5,0,0
6480bb97c48a16e84b55a325,2020/21,,,1,AJ Finch,D Padikkal,8,13,1,0,1,7,8,1,0,0,5,0,0
6480bb9834c7569d5fa64353,2022,,,2,M Prasidh Krishna,YS Chahal,8,13,0,0,1,3,5,0,0,5,8,0,0
6480bb9552e25b3867e5c38a,2019,,,1,Q de Kock,RG Sharma,8,15,1,0,1,4,7,1,0,3,8,0,0
6480bba3041017fe2c0593f2,2016,,,1,DJ Bravo,DR Smith,8,4,0,1,1,2,2,0,0,6,2,0,1
6480bb9b72f6a46338302131,2009,,,1,AC Gilchrist,HH Gibbs,8,10,1,0,1,5,5,1,0,0,5,0,0
6480bb96b7b695186bbb6a3e,2019,,,1,JJ Bumrah,KA Pollard,8,2,2,0,0,0,0,0,0,8,2,2,0
6480bb9a7194d8b20952afae,2007/08,,,1,G Gambhir,KD Karthik,8,7,0,0,1,5,3,0,0,2,4,0,0
6480bb9edd901481f13ce9ba,2012,,,2,AB McDonald,DL Vettori,8,6,1,0,0,6,3,1,0,2,3,0,0
6480bb93ec7e3351941d3b5b,2017,,,2,A Choudhary,YS Chahal,8,5,0,1,1,6,2,0,1,2,3,0,0
6480bb98a95cb1650c81c926,2022,,,1,R Parag,TA Boult,8,10,0,0,1,3,3,0,0,5,7,0,0
6480bb9dec749d630afd07d1,2011,,,1,DT Christian,MS Gony,8,3,0,1,1,7,2,0,1,0,1,0,0
6480bba1af9481df8b4f9f0f,2015,,,2,AN Ahmed,HV Patel,8,4,1,0,0,5,2,1,0,3,2,0,0
6480bb99ecbdaaf953b8eee5,2023,,,1,DP Conway,S Dube,8,7,1,0,1,7,4,1,0,1,3,0,0
6480bb9bc80883a975281815,2009,,,1,DW Steyn,R Vinay Kumar,8,2,2,0,0,0,0,0,0,8,2,2,0
6480bb954da239b357833c8a,2018,,,1,NV Ojha,RR Pant,8,6,1,0,1,1,4,0,0,5,2,1,0
6480bb9a81d7fd0ac0307b4d,2023,,,1,C Green,Ishan Kishan,8,6,2,0,1,8,4,2,0,0,2,0,0
6480bba237377ccc608266d2,2016,,,1,AR Patel,DA Miller,8,5,1,0,1,0,2,0,0,5,3,1,0
6480bb9c12e6c723b248799b,2009,,,1,MV Boucher,RV Uthappa,8,8,1,0,1,5,6,1,0,3,2,0,0
6480bb96f1eadf803ffc292c,2020/21,,,1,RR Pant,SS Iyer,8,9,1,0,1,1,4,0,0,6,5,1,0
6480bb9ee779ef1e445d0506,2012,,,1,Harbhajan Singh,SL Malinga,8,8,1,0,1,3,5,0,0,5,3,1,0
6480bba10e78f50f124b406a,2015,,,2,MS Dhoni,RA Jadeja,8,8,1,0,1,1,3,0,0,7,5,1,0
6480bb995f3db9699a1f794d,2022,,,2,R Ashwin,SO Hetmyer,8,9,1,0,1,2,2,0,0,6,7,1,0
6480bb942fc9529eb2869c17,2018,,,2,AT Rayudu,SR Watson,8,6,0,1,1,1,2,0,0,7,4,0,1
6480bb9b6ded6d116cfe02ee,2009,,,1,I Sharma,LR Shukla,8,9,1,0,1,2,2,0,0,6,7,1,0
6480bb9b9dd7fe8c5cbdbab0,2009,,,2,AB de Villiers,V Sehwag,8,11,1,0,1,2,2,0,0,6,9,1,0
6480bb96593f4f87a2c294bc,2020/21,,,2,Abhishek Sharma,PK Garg,8,6,1,0,1,6,3,1,0,2,3,0,0
6480bb98bd3ca4df44cf9d8f,2022,,,1,F du Plessis,V Kohli,8,8,1,0,1,4,5,1,0,4,3,0,0
6480bb993e44f97eccb361fe,2023,,,1,A Badoni,KL Rahul,8,5,1,0,1,2,2,0,0,6,3,1,0
6480bb953aab41e7ed166b9d,2019,,,2,Q de Kock,Yuvraj Singh,8,4,2,0,1,8,4,2,0,0,0,0,0
6480bb9ef8d4c23c6e5be4c7,2011,,,2,DPMD Jayawardene,PA Patel,8,10,0,0,1,3,7,0,0,2,3,0,0
6480bb9e38040b358f5a34d8,2012,,,1,JP Duminy,PA Patel,8,2,2,0,0,8,2,2,0,0,0,0,0
6480bba0ca27548122e36880,2013,,,2,EJG Morgan,YK Pathan,8,9,0,0,0,4,6,0,0,3,3,0,0
6480bba38060854b4fab1831,2016,,,1,CH Gayle,V Kohli,8,7,0,1,1,0,0,0,0,7,7,0,1
6480bb9a36f2ab9a44baa0f8,2023,,,1,D Padikkal,SO Hetmyer,8,13,0,0,1,3,5,0,0,4,8,0,0
6480bb9edb0554f003f5428a,2012,,,1,MK Tiwary,YK Pathan,8,4,0,1,1,1,1,0,0,7,3,0,1
6480bb9eb35365cccf73d55c,2011,,,1,CJ Ferguson,MK Pandey,8,13,1,0,1,0,3,0,0,8,10,1,0
6480bb996c5ae75a32d978e8,2022,,,1,DP Conway,RD Gaikwad,8,14,0,0,1,5,9,0,0,2,5,0,0
6480bb99409885bcc7b67109,2023,,,1,D Padikkal,R Ashwin,8,3,1,0,0,7,2,1,0,1,1,0,0
6480bb97ce8cbd211049f957,2021,,,1,KA Pollard,KH Pandya,8,7,0,0,1,5,4,0,0,3,3,0,0
6480bb9e34659755628e7471,2012,,,1,CJ Ferguson,RV Uthappa,8,9,0,0,1,3,6,0,0,5,3,0,0
6480bb95af5853799812b0f6,2019,,,1,V Shankar,YK Pathan,8,9,0,0,1,6,5,0,0,1,4,0,0
6480bb9b69f390d624466843,2007/08,,,1,LR Shukla,Salman Butt,8,6,2,0,1,4,4,1,0,4,2,1,0
6480bb9f302200e3bc89464e,2012,,,2,AM Rahane,R Dravid,8,9,1,0,1,6,7,1,0,2,2,0,0
6480bba0c9e6d590ed35eb56,2014,,,2,AT Rayudu,RG Sharma,8,14,0,0,1,6,9,0,0,2,5,0,0
6480bb9cafc843037dc1e863,2009,,,1,RV Uthappa,V Kohli,8,6,2,0,1,4,5,1,0,4,1,1,0
6480bb993e44f97eccb361fe,2023,,,2,K Rabada,M Shahrukh Khan,8,4,1,0,0,0,1,0,0,8,3,1,0
6480bb94cb5adf24f5ad15c3,2017,,,1,KV Sharma,MJ McClenaghan,8,12,0,0,1,4,7,0,0,3,5,0,0
6480bb9dc4ec5a52f8bcc465,2009/10,,,2,SR Tendulkar,SS Tiwary,8,9,0,0,1,4,4,0,0,4,5,0,0
6480bb9ec07aa72ec89917f0,2012,,,2,JA Morkel,R Ashwin,8,5,1,0,1,0,0,0,0,8,5,1,0
6480bba2db1e2def1b597ed3,2015,,,2,DA Miller,NLTC Perera,8,11,0,0,1,5,4,0,0,3,7,0,0
6480bb9d6ea22feab98beb5b,2011,,,2,DH Yagnik,STR Binny,8,8,0,0,0,1,1,0,0,7,7,0,0
6480bb95e25835586d412978,2018,,,1,KK Nair,Yuvraj Singh,8,5,0,1,1,0,1,0,0,8,4,0,1
6480bba1bd00c57fb3301f04,2014,,,1,PP Chawla,SA Yadav,8,8,0,0,1,2,2,0,0,5,6,0,0
6480bb9ed74d222a3da56dfa,2012,,,2,LR Shukla,Shakib Al Hasan,8,7,0,0,1,3,4,0,0,3,3,0,0
6480bb9eda28fb340ed37b49,2012,,,2,JH Kallis,YK Pathan,8,5,0,1,1,1,1,0,0,6,4,0,1
6480bba0dcd1149b9b0b501f,2013,,,1,M Rawat,WD Parnell,8,11,0,0,1,3,5,0,0,5,6,0,0
6480bb9f1faffe780b407e67,2013,,,1,MN Samuels,RV Uthappa,8,16,0,0,1,3,9,0,0,5,7,0,0
6480bb97aabcd4374e076d04,2021,,,1,Abhishek Sharma,WP Saha,8,10,0,0,1,2,2,0,0,6,8,0,0
6480bba16af3f513920ef499,2015,,,1,MC Henriques,NV Ojha,8,5,0,1,1,2,3,0,0,6,2,0,1
6480bba37e4fcb8af147f79b,2016,,,2,JP Duminy,KK Nair,8,9,1,0,1,5,4,1,0,3,5,0,0
6480bba0001885407e860a8d,2013,,,1,A Ashish Reddy,PA Patel,8,8,1,0,1,5,6,1,0,2,2,0,0
6480bba2b5d601f8354f5b5a,2016,,,2,AR Patel,MG Johnson,8,13,1,0,1,6,8,1,0,2,5,0,0
6480bb9a9514379c05d59c38,2023,,,1,D Padikkal,YBK Jaiswal,8,6,1,0,1,2,4,0,0,5,2,1,0
6480bb98a95cb1650c81c926,2022,,,2,SS Prabhudessai,Shahbaz Ahmed,8,10,0,0,1,2,7,0,0,4,3,0,0
6480bb9eee740f701b0ee154,2011,,,2,IK Pathan,Y Nagar,8,4,0,1,0,7,2,0,1,1,2,0,0
6480bb9e713e850d3dd0cba9,2012,,,2,BB McCullum,JH Kallis,8,11,0,0,1,2,3,0,0,5,8,0,0
6480bb9c89f35f11aae1f2d0,2009/10,,,2,SK Trivedi,SW Tait,8,8,0,1,1,7,5,0,1,1,3,0,0
6480bb99af95c6c90c4c3924,2023,,,1,C Green,SA Yadav,8,4,0,1,1,1,1,0,0,7,3,0,1
6480bb9b3a5e1af467fb027b,2009,,,1,R Dravid,R Vinay Kumar,8,9,0,0,1,3,3,0,0,5,6,0,0
6480bb94b991069934e5c7d2,2018,,,1,BA Stokes,RA Tripathi,8,7,1,0,1,3,3,0,0,5,4,1,0
6480bb9dfa7d0510ae3a7b40,2011,,,1,JR Hopes,M Morkel,8,3,0,1,0,0,0,0,0,8,3,0,1
6480bb9df57ec21d17310ad2,2011,,,2,A Mishra,I Sharma,8,2,0,1,0,6,1,0,1,1,1,0,0
6480bb931b06a170006b4713,2017,,,2,JP Faulkner,RA Jadeja,8,3,1,0,0,4,2,0,0,4,1,1,0
6480bb9f895e5780080c8059,2012,,,2,IK Pathan,Y Venugopal Rao,8,9,1,0,1,5,7,1,0,1,2,0,0
6480bba273adb498d96b27a9,2016,,,1,CR Brathwaite,RR Pant,8,4,0,1,1,7,3,0,1,1,1,0,0
6480bb9c12e6c723b248799b,2009,,,1,A Kumble,RV Uthappa,8,6,0,0,0,1,1,0,0,3,5,0,0
6480bb9d1f9a3cf1fa86e11c,2011,,,2,MA Agarwal,TM Dilshan,8,12,1,0,1,1,4,0,0,7,8,1,0
6480bb931b06a170006b4713,2017,,,2,KD Karthik,SK Raina,8,6,1,0,1,3,3,0,0,5,3,1,0
6480bb98d2cd0fa3ed0ffc21,2022,,,1,Harpreet Brar,M Shahrukh Khan,8,16,0,1,1,8,11,0,1,0,5,0,0
6480bb9a3ffea6235f54cc1e,2023,,,1,JJ Roy,VR Iyer,8,5,1,0,1,1,1,0,0,7,4,1,0
6480bb9be88c31fc563da86f,2009,,,2,IK Pathan,PP Chawla,8,8,1,0,1,5,5,1,0,3,3,0,0
6480bb9f955d5c84cde78f58,2012,,,1,J Botha,STR Binny,8,4,1,0,0,7,3,1,0,1,1,0,0
6480bb9c454e9eefca545bde,2009/10,,,2,AC Voges,P Dogra,8,4,1,0,1,7,3,1,0,1,1,0,0
6480bb9efe3f9991539e7f6c,2012,,,2,M Manhas,R Sharma,8,5,0,1,1,6,2,0,1,2,3,0,0
6480bb9f955d5c84cde78f58,2012,,,2,AP Majumdar,RV Uthappa,8,7,1,0,1,1,1,0,0,6,6,1,0
6480bb9d1f9a3cf1fa86e11c,2011,,,2,MA Agarwal,Z Khan,8,7,1,0,1,7,4,1,0,0,3,0,0
6480bba23b270561e8026bd2,2015,,,2,PA Patel,RG Sharma,8,3,0,1,0,1,1,0,0,7,2,0,1
6480bb948a69b3d86293b12b,2017,,,2,A Mishra,Mohammed Shami,8,2,2,0,0,8,2,2,0,0,0,0,0
6480bb99f816e64203e3c687,2023,,,2,SN Thakur,SP Narine,8,3,0,1,0,1,1,0,0,7,2,0,1
6480bba0ad06ad631cf7665f,2014,,,2,M Vijay,MA Agarwal,8,13,1,0,1,6,6,1,0,2,7,0,0
6480bba133267f04941acf7d,2014,,,2,G Gambhir,RV Uthappa,8,12,1,0,1,6,10,1,0,2,2,0,0
6480bb93f866249511c76dbc,2017,,,1,BB McCullum,SK Raina,8,14,0,0,1,4,9,0,0,3,5,0,0
6480bb9f4780a208e13bfb3d,2013,,,2,BJ Hodge,DH Yagnik,8,4,2,0,1,4,2,1,0,4,2,1,0
6480bba2ab35be3ffcfa932a,2016,,,2,DJ Hooda,EJG Morgan,8,6,1,0,1,5,4,1,0,1,2,0,0
6480bb9fd26b695cee9d8761,2013,,,2,BJ Hodge,R Dravid,8,12,0,0,1,4,7,0,0,4,5,0,0
6480bb9a8cf29e28434bb1d5,2023,,,2,HH Pandya,V Shankar,8,11,1,0,1,1,2,0,0,6,9,1,0
6480bb9aef150645306cc170,2023,,,2,AR Patel,SN Khan,8,7,1,0,1,3,3,0,0,5,4,1,0
6480bb9ed74d222a3da56dfa,2012,,,1,MA Agarwal,SS Tiwary,8,11,0,0,1,5,6,0,0,3,5,0,0
6480bb9cba868c69775db687,2009,,,2,MS Dhoni,PA Patel,8,10,0,0,1,6,6,0,0,2,4,0,0
6480bba265483f7db002ec7c,2015,,,1,DA Miller,M Vijay,8,5,1,0,1,8,5,1,0,0,0,0,0
6480bb9a6e44b0c8da00ca72,2007/08,,,1,IK Pathan,K Goel,8,10,0,0,1,6,3,0,0,2,7,0,0
6480bba2ad3f26917361061f,2016,,,2,JP Duminy,KK Nair,8,5,1,0,0,7,5,1,0,0,0,0,0
6480bb96e2809aa0bc35c7e9,2019,,,2,MK Pandey,Rashid Khan,8,2,0,1,0,8,2,0,1,0,0,0,0
6480bba1670ace74604a420f,2015,,,2,Imran Tahir,JA Morkel,8,5,1,0,1,2,2,0,0,6,3,1,0
6480bb9be7cbbb90a12dc916,2009,,,1,MS Dhoni,S Badrinath,8,6,0,1,1,8,4,0,1,0,2,0,0
6480bb9bc74c35e494cec477,2007/08,,,1,M Kaif,SR Watson,8,3,1,0,0,3,1,0,0,5,2,1,0
6480bba1d21281c7385d5ce4,2014,,,1,HV Patel,MA Starc,8,5,1,0,1,6,3,1,0,2,2,0,0
6480bb96d1b3bea0aa2127e4,2020/21,,,1,Q de Kock,RG Sharma,8,8,0,1,1,1,3,0,0,6,5,0,1
6480bb9ca21b98f1be8254e2,2009/10,,,2,A Mithun,R Dravid,8,7,1,0,1,5,3,1,0,3,4,0,0
6480bb9871b0ff7264721cbc,2022,,,2,Abhishek Sharma,KS Williamson,8,9,1,0,1,7,6,1,0,0,3,0,0
6480bba090c88df75eba18e6,2014,,,2,AB Dinda,R Rampaul,8,3,0,1,1,0,0,0,0,8,3,0,1
6480bb9c757dbd7f92b1130a,2009/10,,,2,R Sathish,SR Tendulkar,8,9,1,0,1,3,5,0,0,4,4,1,0
6480bba22349149c9ec92d49,2016,,,1,AM Rahane,SS Tiwary,8,11,0,0,1,4,5,0,0,3,6,0,0
6480bba0b5eabeb0a150b93f,2013,,,2,B Kumar,M Manhas,8,15,1,0,1,6,12,1,0,2,3,0,0
6480bb9a61edc0c77bc4bc86,2007/08,,,1,S Dhawan,Shoaib Malik,8,5,1,0,1,7,4,1,0,1,1,0,0
6480bb9f022f0e8cd6e9cdeb,2012,,,1,AD Russell,LRPL Taylor,8,4,0,1,1,8,3,0,1,0,1,0,0
6480bb97372fc5d5ef4c436a,2021,,,1,CR Woakes,R Ashwin,8,4,1,0,1,0,0,0,0,7,4,1,0
6480bb9b72f6a46338302131,2009,,,1,DB Ravi Teja,RJ Harris,8,5,0,0,0,3,1,0,0,5,4,0,0
6480bb956b439141409fd739,2018,,,1,K Gowtham,RA Tripathi,8,6,1,0,1,5,3,1,0,2,3,0,0
6480bb982f070b023b901b3e,2021,,,1,Q de Kock,RG Sharma,8,11,1,0,1,0,1,0,0,7,10,1,0
6480bba0d2cdb40c68c4739c,2013,,,2,KD Karthik,RG Sharma,8,13,1,0,1,4,8,1,0,2,5,0,0
6480bb9a3ffea6235f54cc1e,2023,,,2,Abhishek Sharma,RA Tripathi,8,6,1,0,1,3,3,0,0,5,3,1,0
6480bba20130c44ed20c9bcf,2016,,,1,KA Pollard,PA Patel,8,8,0,1,1,1,3,0,0,7,5,0,1
6480bb9f23c17ccb47aa9e58,2013,,,2,Azhar Mahmood,DJ Hussey,8,7,1,0,1,3,4,0,0,5,3,1,0
6480bb9c5d0fccb6a3a6d37d,2009,,,2,LA Carseldine,YK Pathan,8,10,1,0,1,6,5,1,0,1,5,0,0
6480bb9eeeaf037e5e41ab86,2012,,,2,PC Valthaty,SE Marsh,8,10,1,0,1,6,7,1,0,2,3,0,0
6480bb9cdf6c63fec90a42df,2009/10,,,1,MK Tiwary,SC Ganguly,8,7,2,0,1,8,3,2,0,0,4,0,0
6480bb973d64aa91e60b4088,2021,,,1,DJ Bravo,DL Chahar,8,2,0,1,0,8,2,0,1,0,0,0,0
6480bb96686655f09172741d,2020/21,,,2,Mohammed Siraj,Navdeep Saini,8,9,1,0,1,5,4,1,0,3,5,0,0
6480bb97a4220e27710e38de,2021,,,2,EJG Morgan,KD Karthik,8,10,0,0,1,4,5,0,0,2,5,0,0
6480bba0ddcc30675d83403c,2013,,,2,GH Vihari,S Dhawan,8,9,0,0,1,2,3,0,0,4,6,0,0
6480bb9a7577454a5220c94b,2007/08,,,2,M Kaif,SA Asnodkar,8,12,0,0,1,4,7,0,0,4,5,0,0
6480bb9e692eaa193a417426,2012,,,2,GJ Maxwell,Y Venugopal Rao,8,11,0,0,1,3,4,0,0,5,7,0,0
6480bb97668d35800fa74139,2021,,,1,CH Gayle,DJ Hooda,8,9,1,0,1,2,5,0,0,6,4,1,0
6480bb95b84f125c6212267a,2019,,,2,MM Ali,V Kohli,8,15,0,0,1,2,8,0,0,2,7,0,0
6480bb9866dd8ba9b48863c2,2022,,,2,A Badoni,KH Pandya,8,7,2,0,1,4,3,1,0,4,4,1,0
6480bba04b49d2ff5f997e02,2013,,,2,S Nadeem,UT Yadav,8,8,1,0,1,6,5,1,0,2,3,0,0
6480bb984f6c41cd28aa0353,2022,,,1,KL Rahul,Q de Kock,8,10,1,0,1,7,6,1,0,1,4,0,0
6480bb947a7c9fe868fc901a,2017,,,1,PJ Cummins,RR Pant,8,4,0,1,1,7,3,0,1,1,1,0,0
6480bba2ebdcfb98389cee5a,2015,,,1,JP Duminy,SS Iyer,8,10,1,0,1,6,7,1,0,2,3,0,0
6480bb9d6ea22feab98beb5b,2011,,,2,LRPL Taylor,R Dravid,8,7,0,0,1,4,3,0,0,4,4,0,0
6480bb9b6ded6d116cfe02ee,2009,,,1,BB McCullum,CH Gayle,8,13,0,0,1,1,6,0,0,5,7,0,0
6480bb9e30b7f3c09cfbdabb,2011,,,2,ND Doshi,SW Tait,8,19,1,0,1,0,13,0,0,8,6,1,0
6480bb9bdde9db92f880e40d,2007/08,,,1,LR Shukla,SC Ganguly,8,7,1,0,1,5,4,1,0,2,3,0,0
6480bb94b991069934e5c7d2,2018,,,1,DJM Short,SV Samson,8,11,1,0,1,1,3,0,0,7,8,1,0
6480bba24f6e6e2c212c7469,2016,,,2,A Mishra,NM Coulter-Nile,8,15,1,0,1,3,9,0,0,5,6,1,0
6480bba358370ecde0231113,2016,,,1,MS Dhoni,SS Tiwary,8,10,1,0,1,2,4,0,0,6,6,1,0
6480bb9f8d3b0a3d1e28a4b7,2013,,,2,A Ashish Reddy,NLTC Perera,8,9,0,0,1,4,5,0,0,3,4,0,0
6480bba32e54551792a9e915,2016,,,2,MJ Guptill,N Rana,8,4,2,0,1,4,3,1,0,4,1,1,0
6480bb974123cbc9756ceefa,2021,,,2,MA Agarwal,N Pooran,8,12,0,0,1,3,5,0,0,3,7,0,0
6480bba388682c5ca10ff37a,2016,,,1,AB de Villiers,KL Rahul,8,6,1,0,1,1,2,0,0,7,4,1,0
6480bb9f6f311344dac147cc,2012,,,2,AD Mathews,B Kumar,8,7,1,0,1,1,2,0,0,7,5,1,0
6480bb970d7cbd85b6ada680,2021,,,1,KL Rahul,N Pooran,8,5,0,1,1,7,2,0,1,0,3,0,0
6480bb99e520ec7a66b73adb,2022,,,1,AR Patel,SN Thakur,8,7,0,0,1,3,2,0,0,4,5,0,0
6480bb9a3d3f26063faa9f71,2007/08,,,1,LR Shukla,WP Saha,8,3,2,0,1,8,3,2,0,0,0,0,0
6480bba26ca6ec72ba377236,2016,,,1,KS Williamson,MC Henriques,8,6,1,0,1,5,3,1,0,3,3,0,0
6480bb9fd4a1af6234c9e57c,2012,,,1,AB de Villiers,V Kohli,8,8,1,0,1,8,7,1,0,0,1,0,0
6480bb9b82dc3ec84c520466,2009,,,2,LR Shukla,MN van Wyk,8,7,0,0,1,2,3,0,0,5,4,0,0
6480bba2c04b3acd88a50839,2015,,,2,JP Duminy,SS Iyer,8,7,1,0,1,3,3,0,0,5,4,1,0
6480bba0c63a6317296391b7,2013,,,2,KK Cooper,STR Binny,8,5,0,1,0,7,4,0,1,0,1,0,0
6480bb96f1eadf803ffc292c,2020/21,,,2,AJ Tye,R Tewatia,8,10,0,1,1,6,6,0,1,1,4,0,0
6480bb9f79be50f1621abcc6,2012,,,1,Mandeep Singh,SE Marsh,8,9,0,1,1,7,6,0,1,1,3,0,0
6480bb958f737f809dfb65e1,2019,,,1,AR Patel,K Rabada,8,6,1,0,1,5,2,1,0,3,4,0,0
6480bba2c5a614e0fd10cd19,2016,,,1,PA Patel,RG Sharma,8,7,0,1,1,1,2,0,0,7,5,0,1
6480bba2fbc243afec641844,2015,,,2,BB McCullum,F du Plessis,8,5,1,0,1,5,4,1,0,3,1,0,0
6480bb98dd9a2108c79e1014,2022,,,1,JM Bairstow,JM Sharma,8,7,1,0,1,0,3,0,0,8,4,1,0
6480bb977f55a1c473670850,2021,,,1,K Yadav,Mustafizur Rahman,8,8,0,1,0,0,1,0,0,8,7,0,1
6480bb99d2bd76016d47896d,2023,,,2,DA Warner,R Powell,8,10,0,0,1,7,7,0,0,1,3,0,0
6480bba1ff55936e203ca5a6,2014,,,1,DA Miller,GJ Bailey,8,5,1,0,1,5,3,1,0,3,2,0,0
6480bb98634dba60191637ad,2021,,,1,DJ Hooda,Harpreet Brar,8,6,1,0,1,4,2,1,0,4,4,0,0
6480bba19e29de4f208211ac,2014,,,2,RR Rossouw,VR Aaron,8,5,0,1,1,7,3,0,1,1,2,0,0
6480bb94988cb8c136ec7e46,2018,,,1,KK Nair,Yuvraj Singh,8,7,1,0,1,6,5,1,0,2,2,0,0
6480bb987c720def5fbaf218,2022,,,2,JD Unadkat,M Ashwin,8,5,0,1,1,8,3,0,1,0,2,0,0
6480bb94cb5adf24f5ad15c3,2017,,,1,JJ Bumrah,SL Malinga,8,3,0,1,0,1,1,0,0,7,2,0,1
6480bb9f210b6e50fb2072ae,2013,,,2,EJG Morgan,MK Tiwary,8,6,0,0,1,2,5,0,0,5,1,0,0
6480bb9dfb2e8e8c2002df86,2011,,,1,DT Christian,JP Duminy,8,17,0,0,1,4,6,0,0,4,11,0,0
6480bb980095555db76d49cb,2022,,,2,GJ Maxwell,KD Karthik,8,2,2,0,0,8,2,2,0,0,0,0,0
6480bb946efcc4cd9aa80399,2018,,,2,KD Karthik,RK Singh,8,7,1,0,1,1,1,0,0,6,6,1,0
6480bba2b5d601f8354f5b5a,2016,,,2,M Vijay,M Vohra,8,9,1,0,1,1,5,0,0,7,4,1,0
6480bb9e565ef5f11c5c8f55,2011,,,2,A Mithun,CK Langeveldt,8,8,0,1,1,7,4,0,1,1,4,0,0
6480bba2fbc243afec641844,2015,,,1,BE Hendricks,R Dhawan,8,6,0,1,0,1,2,0,0,7,4,0,1
6480bb9f2305d07e3c65be11,2013,,,2,AD Mascarenhas,P Kumar,8,11,0,0,0,5,5,0,0,3,6,0,0
6480bb9e93f969bcc8a79433,2011,,,2,M Vijay,MEK Hussey,8,23,0,0,1,5,14,0,0,2,9,0,0
6480bb931e6d2b03141b586d,2017,,,2,CR Woakes,MK Pandey,8,9,0,0,1,3,5,0,0,5,4,0,0
6480bba0208e8fbb34afdc50,2013,,,1,KL Rahul,MC Henriques,8,4,2,0,1,8,4,2,0,0,0,0,0
6480bb994aafcf67cd092a7d,2023,,,1,DA Warner,MR Marsh,8,10,2,0,1,4,6,1,0,4,4,1,0
6480bb99433f6e11060ba714,2022,,,2,K Rabada,RD Chahar,8,2,0,1,1,6,2,0,1,0,0,0,0
6480bb9deba74e341b44c765,2009/10,,,2,Anirudh Singh,DR Smith,8,13,1,0,1,3,3,0,0,5,10,1,0
6480bb9e41b781523bd5aafe,2012,,,2,IK Pathan,V Sehwag,8,6,1,0,1,4,4,0,0,4,2,1,0
6480bba17bce347084729c56,2015,,,1,AT Rayudu,CJ Anderson,8,13,1,0,1,2,2,0,0,5,11,1,0
6480bb9affc08d6384ac3992,2023,,,1,GD Phillips,HC Brook,8,7,1,0,1,5,4,1,0,1,3,0,0
6480bb9f7bae5ad85c4473ba,2012,,,1,JEC Franklin,SR Tendulkar,8,14,1,0,1,1,9,0,0,7,5,1,0
6480bb94283e3f5a1a95839f,2018,,,1,RA Jadeja,SK Raina,8,2,0,1,0,0,0,0,0,8,2,0,1
6480bba16796f9a72374865f,2015,,,2,AJ Finch,RG Sharma,8,9,1,0,1,5,5,1,0,2,4,0,0
6480bb993e61058e682e2ff4,2023,,,2,SO Hetmyer,TA Boult,8,3,0,1,0,8,2,0,1,0,1,0,0
6480bb9ab99ef699d66ad5a0,2023,,,2,Ishan Kishan,TH David,8,6,1,0,1,1,2,0,0,7,4,1,0
6480bb97aed297ca9686c94a,2021,,,2,F du Plessis,SM Curran,8,7,1,0,0,3,3,0,0,5,4,1,0
6480bb9e6d7f7f691dde322d,2012,,,2,A Mishra,JP Duminy,8,10,1,0,1,1,6,0,0,7,4,1,0
6480bb9d69cb9046a72d8fbe,2009/10,,,2,HH Gibbs,RG Sharma,8,9,0,0,1,5,4,0,0,2,5,0,0
6480bb96b56e8d513b451da1,2020/21,,,1,EJG Morgan,PJ Cummins,8,23,0,0,1,4,6,0,0,4,17,0,0
6480bb9d6ea22feab98beb5b,2011,,,1,M Vijay,MEK Hussey,8,11,1,0,1,5,6,1,0,3,5,0,0
6480bba17bce347084729c56,2015,,,2,GJ Maxwell,M Vijay,8,6,1,0,1,6,4,1,0,2,2,0,0
6480bb94aad1a08ca4276b4e,2018,,,1,AR Patel,MP Stoinis,8,4,0,1,1,1,1,0,0,6,3,0,1
6480bb9bb7a4f1e16df25c8e,2009,,,2,HH Gibbs,VVS Laxman,8,11,0,0,1,4,6,0,0,4,5,0,0
6480bba3b830360cf7031278,2016,,,1,Harbhajan Singh,TG Southee,8,12,0,0,1,5,8,0,0,3,4,0,0
6480bb9b2e179d359c1d446d,2009,,,1,RP Singh,Y Venugopal Rao,8,8,1,0,1,2,4,0,0,5,4,1,0
6480bb995193664eda3e9e10,2022,,,1,RK Singh,TG Southee,8,8,0,1,1,7,4,0,1,0,4,0,0
6480bb9538916411f52016bf,2019,,,1,CA Lynn,KD Karthik,8,7,1,0,1,2,3,0,0,6,4,1,0
6480bba2aecb4103bab63c15,2016,,,2,AD Russell,SA Yadav,8,9,1,0,1,3,4,0,0,5,5,1,0
6480bba0f1ebf9ff255e1c91,2013,,,2,GH Vihari,KV Sharma,8,10,1,0,1,2,2,0,0,6,8,1,0
6480bb990b96e91d3fbf421b,2022,,,1,HV Patel,Shahbaz Ahmed,8,5,0,1,1,1,2,0,0,6,3,0,1
6480bb95b98d000799e11963,2018,,,1,SN Khan,TG Southee,8,4,1,0,0,6,3,1,0,1,1,0,0
6480bb9f60d58ee39ba047b9,2013,,,2,GH Vihari,KC Sangakkara,8,20,0,0,1,4,11,0,0,3,9,0,0
6480bb9619eaed447b2a05d4,2020/21,,,2,KA Pollard,SA Yadav,8,2,2,0,0,4,1,1,0,4,1,1,0
6480bb9a3ffea6235f54cc1e,2023,,,2,Abdul Samad,M Jansen,7,8,0,0,1,2,4,0,0,1,4,0,0
6480bb9e56c724ba25b94666,2011,,,1,Bipul Sharma,RJ Harris,7,5,1,0,1,1,1,0,0,6,4,1,0
6480bb9f36ad55c3c7fd6548,2012,,,1,RG Sharma,SL Malinga,7,4,0,1,1,0,1,0,0,7,3,0,1
6480bb995f3db9699a1f794d,2022,,,1,AT Rayudu,MM Ali,7,10,0,0,1,3,6,0,0,3,4,0,0
6480bb9480627b50308b7903,2017,,,2,JJ Bumrah,KH Pandya,7,3,0,1,1,0,1,0,0,7,2,0,1
6480bba0c63a6317296391b7,2013,,,1,AP Tare,RG Sharma,7,5,1,0,1,6,4,1,0,1,1,0,0
6480bb9da9ca2f2d3738d79e,2011,,,2,R Sharma,SB Wagh,7,4,1,0,1,5,2,1,0,2,2,0,0
6480bb964c4bea88164f168d,2020/21,,,1,AD Russell,Shubman Gill,7,7,1,0,1,1,2,0,0,6,5,1,0
6480bb9bed3e2a1a008f93a6,2007/08,,,2,Mohammad Hafeez,SC Ganguly,7,14,1,0,1,5,11,1,0,1,3,0,0
6480bba1e64915b9e7c849ca,2014,,,1,KD Karthik,MA Agarwal,7,4,0,1,1,1,2,0,0,6,2,0,1
6480bb96e8ba017befb2bc8a,2020/21,,,1,MP Stoinis,RR Pant,7,5,1,0,1,2,3,0,0,5,2,1,0
6480bb9746dfc5c467942a84,2021,,,2,KH Pandya,SS Tiwary,7,9,0,0,1,4,5,0,0,3,4,0,0
6480bb9ef7c6084992b7cdf8,2012,,,2,AA Jhunjhunwala,B Chipli,7,7,1,0,1,4,5,1,0,2,2,0,0
6480bb97aabcd4374e076d04,2021,,,1,JO Holder,Rashid Khan,7,9,0,0,1,4,4,0,0,3,5,0,0
6480bb96686655f09172741d,2020/21,,,2,AJ Finch,V Kohli,7,6,1,0,1,0,2,0,0,6,4,1,0
6480bba07fa24b891b818984,2013,,,2,KD Karthik,RG Sharma,7,5,0,1,1,0,3,0,0,7,2,0,1
6480bb94a964c10b5f10ae52,2017,,,2,R Tewatia,WP Saha,7,5,1,0,1,4,3,1,0,2,2,0,0
6480bb9ed74d222a3da56dfa,2012,,,1,CA Pujara,CH Gayle,7,10,0,1,1,6,9,0,1,1,1,0,0
6480bba0c63a6317296391b7,2013,,,1,AT Rayudu,Harbhajan Singh,7,7,0,0,1,4,5,0,0,3,2,0,0
6480bb9b5d0191a0a2611916,2009,,,1,KC Sangakkara,PP Chawla,7,5,1,0,1,5,3,1,0,0,2,0,0
6480bb9866dd8ba9b48863c2,2022,,,1,Anuj Rawat,F du Plessis,7,5,1,0,1,4,5,1,0,0,0,0,0
6480bb9c13817091131f76e3,2009/10,,,1,Jaskaran Singh,RP Singh,7,4,0,0,0,3,2,0,0,4,2,0,0
6480bba19052ba503c5f7c27,2015,,,2,AM Rahane,KK Nair,7,8,1,0,1,6,3,1,0,1,5,0,0
6480bb9fc3369c6f5a549d05,2013,,,1,KM Jadhav,M Morkel,7,9,1,0,1,5,5,1,0,2,4,0,0
6480bb95d675b7da24db1a57,2019,,,1,Kuldeep Yadav,PP Chawla,7,4,1,0,0,2,2,0,0,5,2,1,0
6480bb982f070b023b901b3e,2021,,,1,HH Pandya,KA Pollard,7,8,0,0,1,2,4,0,0,3,4,0,0
6480bba1bd00c57fb3301f04,2014,,,2,GJ Bailey,M Vohra,7,9,0,0,1,1,2,0,0,6,7,0,0
6480bba048fb3d33ea0711e7,2013,,,1,LA Pomersbach,P Awana,7,3,0,1,1,7,2,0,1,0,1,0,0
6480bb94566b0cf89fca84f9,2018,,,2,WP Saha,YK Pathan,7,4,0,1,1,1,1,0,0,6,3,0,1
6480bb9dbefe5e2cceb23e01,2011,,,2,MEK Hussey,SK Raina,7,7,1,0,1,2,3,0,0,5,4,1,0
6480bb9c50838010977c168c,2009,,,2,B Lee,IK Pathan,7,8,1,0,1,6,7,1,0,1,1,0,0
6480bb9e1751fd9db64a2834,2011,,,1,SR Tendulkar,TL Suman,7,9,1,0,1,1,3,0,0,5,6,1,0
6480bb98cce4ab46512c2c03,2022,,,1,DJ Bravo,MS Dhoni,7,3,1,0,0,1,1,0,0,6,2,1,0
6480bb939b2499e9af6ee18c,2017,,,1,JC Buttler,RG Sharma,7,11,0,0,1,3,6,0,0,3,5,0,0
6480bb94a964c10b5f10ae52,2017,,,2,MM Sharma,Swapnil Singh,7,13,0,0,1,3,4,0,0,4,9,0,0
6480bb9ba9d43057d652a5fe,2009,,,2,Harbhajan Singh,JP Duminy,7,6,1,0,1,6,5,1,0,1,1,0,0
6480bb9bcf9df9e7ae0416ba,2009,,,1,R Dravid,RV Uthappa,7,7,1,0,1,0,2,0,0,6,5,1,0
6480bb9d86effd7e5e6a5261,2011,,,1,MEK Hussey,S Badrinath,7,5,1,0,1,2,2,0,0,5,3,1,0
6480bb9e5de755887230bb00,2012,,,2,DJ Bravo,JA Morkel,7,4,1,0,0,5,2,1,0,2,2,0,0
6480bb987b6845947f7ca137,2022,,,1,D Padikkal,JC Buttler,7,13,1,0,1,2,5,0,0,5,8,1,0
6480bb9db9ed29ce1ee8764f,2011,,,2,AM Nayar,RJ Harris,7,5,1,0,0,5,4,1,0,1,1,0,0
6480bb943565d22d24ec0ae8,2017,,,2,C de Grandhomme,CR Woakes,7,6,1,0,1,1,3,0,0,6,3,1,0
6480bb9e692eaa193a417426,2012,,,2,Y Nagar,Y Venugopal Rao,7,12,0,0,1,2,4,0,0,5,8,0,0
6480bb9dd89d4266d59a4592,2011,,,2,KD Karthik,R McLaren,7,7,0,0,1,2,3,0,0,5,4,0,0
6480bba0e883438915efc1e6,2013,,,1,AM Nayar,SPD Smith,7,10,0,0,1,2,4,0,0,5,6,0,0
6480bba2a94dd2c01769b3ae,2016,,,1,AJ Finch,SK Raina,7,5,1,0,1,5,4,1,0,1,1,0,0
6480bb9908b154f78b12b8fb,2023,,,2,GJ Maxwell,V Kohli,7,7,1,0,1,5,4,1,0,2,3,0,0
6480bb94cf431881ac3e9cbf,2018,,,1,GJ Maxwell,RR Pant,7,10,0,0,1,4,6,0,0,2,4,0,0
6480bba13b673297bce003e2,2014,,,2,CH Gayle,YV Takawale,7,12,1,0,1,6,9,1,0,1,3,0,0
6480bba287d112bccc55ccd2,2015,,,2,KD Karthik,Mandeep Singh,7,7,0,0,1,2,4,0,0,3,3,0,0
6480bb97ce8cbd211049f957,2021,,,1,Q de Kock,RG Sharma,7,12,0,0,1,3,5,0,0,4,7,0,0
6480bba0ffae8617ee64bd19,2013,,,2,DA Warner,KM Jadhav,7,9,0,0,1,4,5,0,0,2,4,0,0
6480bb96ee2a21f0d9b9f37f,2020/21,,,2,KL Nagarkoti,RA Tripathi,7,5,1,0,1,2,2,0,0,5,3,1,0
6480bb9802d8f5ec4413766d,2022,,,1,HH Pandya,R Tewatia,7,5,1,0,1,1,1,0,0,6,4,1,0
6480bb9d105fba311a23a588,2011,,,2,MA Agarwal,TM Dilshan,7,8,0,0,1,1,4,0,0,1,4,0,0
6480bba2f3ed8323f852acfa,2016,,,1,MC Henriques,NV Ojha,7,5,1,0,0,5,3,1,0,2,2,0,0
6480bb97aed297ca9686c94a,2021,,,1,DJ Hooda,M Shahrukh Khan,7,10,1,0,1,7,8,1,0,0,2,0,0
6480bba373508e4f3f4be6c0,2016,,,2,GJ Bailey,UT Khawaja,7,11,1,0,1,1,5,0,0,6,6,1,0
6480bb97493381c4d7dc7bf4,2021,,,1,Mustafizur Rahman,S Gopal,7,4,0,1,0,0,0,0,0,7,4,0,1
6480bb96267b63eb2c6747b0,2019,,,2,MP Stoinis,UT Yadav,7,4,0,1,0,7,4,0,1,0,0,0,0
6480bb95d675b7da24db1a57,2019,,,1,AD Russell,KD Karthik,7,5,1,0,1,5,2,1,0,2,3,0,0
6480bba3e9fa951efcfc8bfb,2016,,,2,CR Brathwaite,SW Billings,7,8,0,0,1,2,2,0,0,4,6,0,0
6480bb9af85f41b4de44ca19,2023,,,1,MS Dhoni,RA Jadeja,7,5,1,0,1,1,2,0,0,6,3,1,0
6480bba0ffae8617ee64bd19,2013,,,2,BJ Rohrer,DA Warner,7,9,0,0,1,4,5,0,0,2,4,0,0
6480bb9b0e32875998e9bfdc,2009,,,1,A Mishra,M Manhas,7,8,1,0,1,0,4,0,0,7,4,1,0
6480bb9c3b082d71291a593c,2009,,,1,P Kumar,R Vinay Kumar,7,3,1,0,0,1,1,0,0,6,2,1,0
6480bb9be2940d96c1f903ca,2007/08,,,2,JH Kallis,SP Goswami,7,10,1,0,1,5,5,1,0,2,5,0,0
6480bb9552e25b3867e5c38a,2019,,,2,DJ Bravo,DL Chahar,7,4,0,1,1,6,3,0,1,1,1,0,0
6480bb958f77e7d3929d28e3,2018,,,1,AJ Finch,KL Rahul,7,9,1,0,1,4,6,1,0,1,3,0,0
6480bba11eff9b230a172302,2014,,,2,JP Faulkner,SPD Smith,7,3,1,0,0,2,1,0,0,5,2,1,0
6480bb94b9d954a885cc531b,2017,,,1,LMP Simmons,PA Patel,7,13,0,0,1,3,7,0,0,4,6,0,0
6480bb99ed38bcb4025b8d86,2023,,,2,MG Bracewell,Shahbaz Ahmed,7,7,0,0,1,2,2,0,0,1,5,0,0
6480bb95f45dffe4751efc46,2019,,,2,CH Gayle,KL Rahul,7,10,1,0,1,5,7,1,0,1,3,0,0
6480bb9ba6cd609c32579bde,2009,,,1,BJ Hodge,CH Gayle,7,10,1,0,1,1,6,0,0,6,4,1,0
6480bb99a620a7afdb3217fe,2023,,,2,DA Warner,R Powell,7,4,1,0,1,5,2,1,0,2,2,0,0
6480bba358370ecde0231113,2016,,,1,MS Dhoni,R Bhatia,7,2,0,1,1,7,2,0,1,0,0,0,0
6480bb958f77e7d3929d28e3,2018,,,1,CH Gayle,KL Rahul,7,8,1,0,1,0,2,0,0,6,6,1,0
6480bb973da000031d26fbba,2021,,,1,AK Markram,N Pooran,7,5,1,0,1,5,2,1,0,2,3,0,0
6480bb9e1a26096ce68e9ca3,2012,,,2,CH Gayle,TM Dilshan,7,12,0,0,1,4,8,0,0,3,4,0,0
6480bb9bc80883a975281815,2009,,,2,NK Patel,T Henderson,7,21,0,0,1,3,11,0,0,2,10,0,0
6480bba000b91f6c5cf57fdb,2013,,,1,KV Sharma,NLTC Perera,7,5,0,0,1,4,3,0,0,2,2,0,0
6480bb9ee0795047740de5a7,2011,,,1,AL Menaria,AM Rahane,7,9,0,0,1,2,5,0,0,4,4,0,0
6480bb981b01a21305fd65d5,2022,,,1,B Sai Sudharsan,LH Ferguson,7,4,1,0,1,2,1,0,0,5,3,1,0
6480bb9bbb0ec0266749f518,2007/08,,,1,Misbah-ul-Haq,R Dravid,7,6,1,0,1,1,3,0,0,6,3,1,0
6480bb9dd778cb6c44535092,2009/10,,,2,AT Rayudu,R McLaren,7,5,1,0,1,5,3,1,0,0,2,0,0
6480bb985efffbcafdef9f19,2021,,,1,C Sakariya,Kartik Tyagi,7,6,1,0,1,5,4,1,0,1,2,0,0
6480bb94bf9a1728b1b12f4d,2018,,,1,Rashid Khan,WP Saha,7,6,1,0,1,1,3,0,0,6,3,1,0
6480bba2a215721aadf7a90a,2015,,,2,CH Morris,JP Faulkner,7,6,0,0,1,3,3,0,0,2,3,0,0
6480bb9b2abb1e5479b853f5,2009,,,2,MC Henriques,WP Saha,7,4,1,0,0,6,3,1,0,1,1,0,0
6480bb9754755bb7a7427d52,2021,,,1,EJG Morgan,RA Tripathi,7,3,0,1,1,0,0,0,0,7,3,0,1
6480bb9bcf9df9e7ae0416ba,2009,,,1,D du Preez,P Kumar,7,4,0,1,1,0,0,0,0,7,4,0,1
6480bb9f90a251567178de39,2012,,,1,Mandeep Singh,N Saini,7,14,0,0,1,2,4,0,0,3,10,0,0
6480bb974086cbea889134af,2021,,,1,F du Plessis,RD Gaikwad,7,10,1,0,1,0,3,0,0,5,7,1,0
6480bba265483f7db002ec7c,2015,,,1,R Dhawan,WP Saha,7,5,1,0,1,3,3,0,0,4,2,1,0
6480bb9e30b7f3c09cfbdabb,2011,,,2,AL Menaria,SW Tait,7,9,0,0,1,4,6,0,0,2,3,0,0
6480bb98960cf9374ee9420d,2022,,,2,DR Sams,KA Pollard,7,8,0,0,1,3,5,0,0,2,3,0,0
6480bb9d7aa8d2c4c947d164,2009/10,,,2,RG Sharma,TL Suman,7,6,1,0,1,6,5,1,0,1,1,0,0
6480bb9fa1611443840261b7,2012,,,2,R Vinay Kumar,SS Tiwary,7,8,0,0,1,1,3,0,0,6,5,0,0
6480bb9c7b7d7712bdc663de,2009/10,,,1,DJ Bravo,SS Tiwary,7,10,1,0,1,2,8,0,0,5,2,1,0
6480bb9ca668b7b36823fb21,2009,,,2,Mohammad Ashraful,SR Tendulkar,7,12,0,0,1,2,10,0,0,1,2,0,0
6480bb9b17739118ee6c3bd0,2007/08,,,1,Mohammad Hafeez,Salman Butt,7,10,1,0,1,4,8,1,0,0,2,0,0
6480bb9c761c43b2dfb9767d,2009,,,1,K Goel,S Sreesanth,7,14,0,0,0,3,4,0,0,1,10,0,0
6480bb9a365c63af4b3de24c,2023,,,2,DA Warner,RR Rossouw,7,5,1,0,1,0,0,0,0,5,5,1,0
6480bb9e34659755628e7471,2012,,,2,AD Mascarenhas,Bipul Sharma,7,9,0,0,1,5,5,0,0,2,4,0,0
6480bb94f1c027945eeb8b10,2017,,,1,DA Warner,S Dhawan,7,7,1,0,1,6,6,1,0,1,1,0,0
6480bb97fcc6fccd233157f9,2021,,,1,SO Hetmyer,SS Iyer,7,10,0,0,1,3,4,0,0,4,6,0,0
6480bb98c0ad46409044aad2,2022,,,1,CJ Jordan,DJ Bravo,7,3,0,0,0,6,3,0,0,0,0,0,0
6480bb9f79be50f1621abcc6,2012,,,2,AM Rahane,R Dravid,7,8,1,0,1,5,6,1,0,1,2,0,0
6480bb9371e90dbd44ee19a3,2017,,,1,RR Pant,SW Billings,7,6,1,0,1,1,1,0,0,6,5,1,0
6480bb96c40b697b63d08717,2019,,,2,KMA Paul,RR Pant,7,4,0,1,1,0,0,0,0,6,4,0,1
6480bb9a1032ce724214f6dd,2007/08,,,1,DJ Bravo,DJ Thornely,7,3,0,1,1,1,1,0,0,6,2,0,1
6480bb9894cc2d00f057a1f1,2021,,,1,RR Pant,SS Iyer,7,7,1,0,1,6,6,1,0,1,1,0,0
6480bb9e9162dceff15dc334,2011,,,1,BJ Hodge,DPMD Jayawardene,7,10,0,0,1,4,6,0,0,3,4,0,0
6480bb9eb35365cccf73d55c,2011,,,2,G Gambhir,SP Goswami,7,4,1,0,1,1,1,0,0,6,3,1,0
6480bb9b72f6a46338302131,2009,,,2,SR Tendulkar,ST Jayasuriya,7,10,1,0,1,2,3,0,0,5,7,1,0
6480bb966539f85263cb6429,2019,,,2,A Mishra,TA Boult,7,6,1,0,1,6,5,1,0,1,1,0,0
6480bb977453ebef15f59e25,2021,,,1,AD Russell,Shubman Gill,7,14,0,0,1,3,8,0,0,4,6,0,0
6480bb948a69b3d86293b12b,2017,,,2,Mohammed Shami,SS Iyer,7,6,1,0,1,4,2,1,0,1,4,0,0
6480bb9b2a5f2fd5053534dc,2007/08,,,1,PR Shah,SD Chitnis,7,5,0,0,1,4,3,0,0,3,2,0,0
6480bb9a3d3f26063faa9f71,2007/08,,,1,Umar Gul,WP Saha,7,2,0,1,0,6,2,0,1,0,0,0,0
6480bb9774a44376e3b5eb6f,2021,,,1,KD Karthik,TL Seifert,7,6,0,0,1,1,2,0,0,2,4,0,0
6480bb96e76ccde6082d7564,2020/21,,,2,GJ Maxwell,Mandeep Singh,7,5,1,0,1,6,4,1,0,0,1,0,0
6480bba0a4e7c61a5656729e,2014,,,1,GJ Maxwell,V Sehwag,7,8,0,0,1,6,6,0,0,1,2,0,0
6480bb99c26e725b7b6f1637,2023,,,2,D Padikkal,SO Hetmyer,7,10,0,0,1,3,5,0,0,2,5,0,0
6480bba0b46cf5430edef3f5,2014,,,1,CJ Anderson,KA Pollard,7,12,0,0,1,2,8,0,0,4,4,0,0
6480bb9df57ec21d17310ad2,2011,,,2,B Chipli,DT Christian,7,10,0,0,1,4,5,0,0,3,5,0,0
6480bba35038a60ea566794a,2016,,,1,BB McCullum,ER Dwivedi,7,6,1,0,1,1,1,0,0,5,5,1,0
6480bb9a9801c2dda3fe88e9,2007/08,,,1,B Lee,Yuvraj Singh,7,9,1,0,0,1,3,0,0,6,6,1,0
6480bba0dcd1149b9b0b501f,2013,,,2,G Gambhir,JH Kallis,7,10,1,0,1,4,4,1,0,2,6,0,0
6480bb979e8cc2484c1a8c7b,2020/21,,,1,Ishan Kishan,Q de Kock,7,5,0,1,1,1,1,0,0,6,4,0,1
6480bb9552e25b3867e5c38a,2019,,,2,DL Chahar,SN Thakur,7,8,1,0,1,6,6,1,0,1,2,0,0
6480bb9be7cbbb90a12dc916,2009,,,2,DJ Bravo,SR Tendulkar,7,6,1,0,1,5,4,1,0,2,2,0,0
6480bba38ce35716815a1845,2016,,,1,AD Russell,SA Yadav,7,7,1,0,1,2,2,0,0,5,5,1,0
6480bb94704f6dfeb7f4d270,2017,,,2,C de Grandhomme,YK Pathan,7,5,1,0,1,5,2,1,0,2,3,0,0
6480bb9429a15517bb46f3be,2018,,,1,Ishan Kishan,SA Yadav,7,8,0,0,1,1,2,0,0,6,6,0,0
6480bb9384cbae8edee3707f,2017,,,1,MG Johnson,MJ McClenaghan,7,3,1,0,0,7,3,1,0,0,0,0,0
6480bb9e65a802582c071438,2012,,,2,KD Karthik,RG Sharma,7,10,0,0,1,3,6,0,0,4,4,0,0
6480bb9d80e97e178e5f68de,2011,,,2,EJG Morgan,MK Tiwary,7,7,1,0,1,6,6,1,0,1,1,0,0
6480bb9fcbbfd8053f253537,2012,,,2,DB Das,YK Pathan,7,8,0,0,0,1,3,0,0,4,5,0,0
6480bb9b4fc6889967a3cd54,2007/08,,,1,AC Gilchrist,Shahid Afridi,7,8,1,0,1,6,7,1,0,0,1,0,0
6480bb98634dba60191637ad,2021,,,1,Harpreet Brar,Mohammed Shami,7,3,1,0,0,6,3,1,0,0,0,0,0
6480bba29f384ce360fa8131,2016,,,1,DA Miller,GJ Maxwell,7,8,0,0,1,5,4,0,0,2,4,0,0
6480bb9ea49fe0f895bf242a,2012,,,2,GB Hogg,SK Trivedi,7,11,0,0,1,2,5,0,0,5,6,0,0
6480bb9ce93a7b4315d8fa30,2009,,,2,DA Warner,G Gambhir,7,9,0,0,1,4,6,0,0,2,3,0,0
6480bb9f3700dfaa08e18c43,2012,,,2,DJ Bravo,S Anirudha,7,6,0,0,1,6,5,0,0,1,1,0,0
6480bb9c8f3ef1685cdf4017,2009,,,2,BB McCullum,SC Ganguly,7,3,0,1,1,6,3,0,1,0,0,0,0
6480bb9aa37f3b44678752d9,2023,,,2,Shubman Gill,WP Saha,7,11,0,0,1,5,6,0,0,2,5,0,0
6480bb97b97c36ac8be3582f,2021,,,2,JO Holder,Rashid Khan,7,3,0,1,1,0,1,0,0,7,2,0,1
6480bb9932735ca83d38f6e7,2022,,,1,AM Rahane,SS Iyer,7,3,1,0,1,0,1,0,0,7,2,1,0
6480bb9359a2cade3b5213d3,2017,,,2,JC Buttler,PA Patel,7,11,0,0,1,2,5,0,0,3,6,0,0
6480bb99d2bd76016d47896d,2023,,,2,DA Warner,SN Khan,7,15,1,0,1,2,6,0,0,4,9,1,0
6480bb9ea49fe0f895bf242a,2012,,,2,AM Rahane,R Dravid,7,9,1,0,1,4,4,1,0,3,5,0,0
6480bb974123cbc9756ceefa,2021,,,2,AK Markram,SN Khan,7,3,0,1,1,7,2,0,1,0,1,0,0
6480bba19e29de4f208211ac,2014,,,1,CJ Anderson,RG Sharma,7,5,0,1,1,6,4,0,1,1,1,0,0
6480bb93182304739a535742,2017,,,1,A Zampa,AB Dinda,7,8,1,0,1,0,3,0,0,6,5,1,0
6480bba19e29de4f208211ac,2014,,,2,MA Starc,RR Rossouw,7,7,1,0,1,5,4,1,0,2,3,0,0
6480bba1105add9a994c58a7,2014,,,1,JP Duminy,KM Jadhav,7,13,0,0,1,4,5,0,0,3,8,0,0
6480bba34d78f594b07da1bc,2016,,,1,AB de Villiers,V Kohli,7,4,0,1,1,0,2,0,0,7,2,0,1
6480bb9c12f907c7b81b11a9,2009,,,1,DJ Hussey,LR Shukla,7,12,1,0,1,1,4,0,0,6,8,1,0
6480bba0dcd1149b9b0b501f,2013,,,2,RN ten Doeschate,YK Pathan,7,10,0,0,1,3,4,0,0,3,6,0,0
6480bb97ce8cbd211049f957,2021,,,1,KA Pollard,RG Sharma,7,8,0,0,1,2,4,0,0,1,4,0,0
6480bb9a7d91d721555835e5,2007/08,,,2,BJ Hodge,SC Ganguly,7,7,1,0,1,1,3,0,0,5,4,1,0
6480bb9f36da1a646c80be45,2013,,,2,MC Juneja,S Nadeem,7,7,1,0,1,5,4,1,0,2,3,0,0
6480bba26ca6ec72ba377236,2016,,,2,AB de Villiers,SR Watson,7,8,1,0,1,5,5,1,0,2,3,0,0
6480bba2f39653e2f61baca2,2015,,,1,HH Pandya,PA Patel,7,10,1,0,1,5,8,1,0,0,2,0,0
6480bb9516b0dbc1972e5c3c,2018,,,1,CA Lynn,N Rana,7,9,1,0,1,4,4,1,0,3,5,0,0
6480bb97dee20878b0c4246c,2021,,,1,RR Pant,SS Iyer,7,8,0,0,1,5,5,0,0,2,3,0,0
6480bb97c48a16e84b55a325,2020/21,,,1,D Padikkal,V Kohli,7,8,0,0,1,1,1,0,0,6,7,0,0
6480bb99b4febfb641fddd39,2023,,,1,TH David,Tilak Varma,7,10,0,0,1,4,7,0,0,2,3,0,0
6480bb9c5d0fccb6a3a6d37d,2009,,,2,AS Raut,SK Warne,7,4,0,1,1,6,3,0,1,1,1,0,0
6480bb9ff2e0b1df0c3972c9,2012,,,1,V Sehwag,Y Venugopal Rao,7,6,1,0,1,2,4,0,0,5,2,1,0
6480bb9c963968000dfd00d1,2009/10,,,1,PA Patel,S Badrinath,7,6,1,0,1,5,4,1,0,2,2,0,0
6480bb97f2f0fabec8f94d86,2020/21,,,1,N Rana,SP Narine,7,7,0,1,1,0,0,0,0,7,7,0,1
6480bb94c2dcb1007bf6788b,2017,,,2,AR Patel,MM Sharma,7,5,1,0,1,1,1,0,0,6,4,1,0
6480bb9e1d754facf4fad618,2012,,,2,B Kumar,M Kartik,7,5,0,0,0,1,2,0,0,4,3,0,0
6480bb99fe078839da40e7ab,2023,,,1,JJ Roy,N Rana,7,11,1,0,1,2,4,0,0,4,7,1,0
6480bb94bf9a1728b1b12f4d,2018,,,1,KS Williamson,MK Pandey,7,8,0,0,1,5,5,0,0,2,3,0,0
6480bba2f39653e2f61baca2,2015,,,2,JP Duminy,KM Jadhav,7,9,1,0,1,5,7,1,0,1,2,0,0
6480bba0adee98d459585bed,2014,,,2,AT Rayudu,MEK Hussey,7,14,0,0,1,4,10,0,0,3,4,0,0
6480bba07b5396a7b65684d3,2013,,,2,Iqbal Abdulla,SP Narine,7,10,0,0,1,1,4,0,0,3,6,0,0
6480bb9f87652064dab6c573,2013,,,2,DB Das,YK Pathan,7,7,1,0,1,1,3,0,0,6,4,1,0
6480bb9b5d0191a0a2611916,2009,,,2,GC Smith,SA Asnodkar,7,7,0,0,1,2,3,0,0,3,4,0,0
6480bb951677500061c85592,2019,,,1,Q de Kock,SA Yadav,7,8,1,0,1,0,0,0,0,7,8,1,0
6480bba15f6842352b6338ae,2014,,,2,MS Dhoni,SK Raina,7,6,1,0,1,6,3,1,0,1,3,0,0
6480bb9e1a26096ce68e9ca3,2012,,,1,R Dravid,SP Goswami,7,4,1,0,1,4,2,1,0,1,2,0,0
6480bb9d967f5a4cfbd8c74d,2011,,,1,M Morkel,Y Nagar,7,8,1,0,1,6,5,1,0,1,3,0,0
6480bba136257b71aa9952cf,2014,,,2,DA Miller,GJ Bailey,7,5,1,0,1,6,3,1,0,1,2,0,0
6480bb9eae43aed76989151b,2011,,,1,AB de Villiers,V Kohli,7,10,1,0,1,1,4,0,0,6,6,1,0
6480bba33195e5ebac1da82a,2016,,,1,RG Sharma,UBT Chand,7,12,1,0,1,6,8,1,0,0,4,0,0
6480bb94d8aa9021808a4760,2017,,,2,CA Lynn,RV Uthappa,7,3,0,1,1,6,2,0,1,1,1,0,0
6480bb964c4bea88164f168d,2020/21,,,2,JC Archer,TK Curran,7,5,0,1,1,6,4,0,1,1,1,0,0
6480bb96e2809aa0bc35c7e9,2019,,,2,Abhishek Sharma,MK Pandey,7,7,0,0,1,2,3,0,0,5,4,0,0
6480bb9e300070746cc2eb67,2011,,,2,SS Tiwary,V Kohli,7,10,0,0,1,2,6,0,0,4,4,0,0
6480bba0adee98d459585bed,2014,,,2,AP Tare,CJ Anderson,7,10,1,0,1,5,5,1,0,1,5,0,0
6480bba2557febf92f9f79ab,2015,,,1,DJ Bravo,F du Plessis,7,9,1,0,1,5,7,1,0,2,2,0,0
6480bb9c0dec1a788da66d33,2009/10,,,1,AA Jhunjhunwala,AC Voges,7,5,1,0,1,4,2,1,0,3,3,0,0
6480bb9f7bae5ad85c4473ba,2012,,,1,DR Smith,Harbhajan Singh,7,3,0,1,1,7,2,0,1,0,1,0,0
6480bba2a01f4062fc561247,2016,,,1,MM Sharma,SE Marsh,7,6,1,0,1,1,3,0,0,6,3,1,0
6480bb982f070b023b901b3e,2021,,,1,JJ Bumrah,KH Pandya,7,4,0,1,0,1,1,0,0,6,3,0,1
6480bba1ebb63d1bd8c60b9d,2014,,,1,DA Miller,GJ Bailey,7,3,0,1,0,6,2,0,1,1,1,0,0
6480bb966c197bad273f91f1,2020/21,,,2,JC Buttler,SPD Smith,7,8,1,0,1,1,1,0,0,6,7,1,0
6480bb9429a15517bb46f3be,2018,,,1,A Dananjaya,M Markande,7,5,0,0,0,2,2,0,0,4,3,0,0
6480bb9ba6cd609c32579bde,2009,,,1,AB Agarkar,WP Saha,7,3,1,0,0,0,0,0,0,7,3,1,0
6480bb966539f85263cb6429,2019,,,2,A Mishra,J Suchith,7,20,0,0,1,2,6,0,0,5,14,0,0
6480bb945460b25d997060fb,2018,,,1,CA Lynn,SP Narine,7,15,0,1,1,6,11,0,1,1,4,0,0
6480bb9c2778066dafd78a71,2009/10,,,1,JA Morkel,R Ashwin,7,3,0,1,1,7,2,0,1,0,1,0,0
6480bb95f214d4f82ab97ee5,2018,,,1,BA Stokes,K Gowtham,7,11,0,0,1,4,6,0,0,3,5,0,0
6480bb9c266a85f1960d87e9,2009,,,1,DL Vettori,KD Karthik,7,6,0,0,1,1,2,0,0,6,4,0,0
6480bb9448fe25ec89c5fcff,2017,,,1,LMP Simmons,N Rana,7,5,1,0,1,2,3,0,0,5,2,1,0
6480bb9e156723e64d6bd26b,2012,,,1,PA Patel,S Dhawan,7,10,1,0,1,1,5,0,0,6,5,1,0
6480bb9cf1471ad233c7b0af,2009,,,2,GC Smith,RJ Quiney,7,11,1,0,1,0,4,0,0,5,7,1,0
6480bb979e91d1ff9b54c737,2020/21,,,1,K Rabada,SS Iyer,7,4,0,1,1,0,0,0,0,7,4,0,1
6480bb9ef8d4c23c6e5be4c7,2011,,,2,RA Jadeja,RR Powar,7,6,0,0,1,1,2,0,0,6,4,0,0
6480bb9e156723e64d6bd26b,2012,,,2,RE Levi,TL Suman,7,11,1,0,1,2,2,0,0,5,9,1,0
6480bb9b9dd7fe8c5cbdbab0,2009,,,1,JA Morkel,MS Gony,7,3,0,1,1,0,1,0,0,6,2,0,1
6480bb9c121ee402b7b2eda6,2009,,,1,JH Kallis,MK Pandey,7,12,0,0,1,5,7,0,0,2,5,0,0
6480bb9825eb960aded1ff64,2022,,,1,RD Gaikwad,S Dube,7,11,0,0,1,4,4,0,0,3,7,0,0
6480bb94cf431881ac3e9cbf,2018,,,1,G Gambhir,JJ Roy,7,14,0,0,1,3,10,0,0,3,4,0,0
6480bb97b97c36ac8be3582f,2021,,,2,JO Holder,V Shankar,7,7,0,0,1,4,4,0,0,2,3,0,0
6480bb9ca21b98f1be8254e2,2009/10,,,1,KD Karthik,PD Collingwood,7,5,1,0,1,6,4,1,0,1,1,0,0
6480bb964592640608a9163c,2020/21,,,2,BA Stokes,JC Buttler,7,8,1,0,1,5,6,1,0,2,2,0,0
6480bba1b8e3071cc513602a,2014,,,1,JP Faulkner,R Bhatia,7,9,0,0,1,4,6,0,0,3,3,0,0
6480bb9b9614f21d90333e15,2007/08,,,2,D Salunkhe,M Rawat,7,5,1,0,1,6,3,1,0,0,2,0,0
6480bba0f1ebf9ff255e1c91,2013,,,1,AM Rahane,R Dravid,7,15,1,0,1,1,9,0,0,6,6,1,0
6480bb98cce4ab46512c2c03,2022,,,2,MK Pandey,Q de Kock,7,6,0,0,1,5,6,0,0,0,0,0,0
6480bb9a7577454a5220c94b,2007/08,,,2,M Rawat,Sohail Tanvir,7,6,1,0,1,1,2,0,0,6,4,1,0
6480bba01a3f8444c7a33ba6,2014,,,1,SR Watson,SV Samson,7,8,0,1,1,7,6,0,1,0,2,0,0
6480bb9d5cca30c933d4baf4,2011,,,2,DH Yagnik,SK Warne,7,5,1,0,0,2,2,0,0,5,3,1,0
6480bb9d716a89dbf5e486d0,2011,,,2,DA Warner,UBT Chand,7,14,0,0,1,4,4,0,0,2,10,0,0
6480bb9ce93a7b4315d8fa30,2009,,,1,AC Gilchrist,RG Sharma,7,9,1,0,1,1,2,0,0,6,7,1,0
6480bba373508e4f3f4be6c0,2016,,,2,GJ Bailey,IK Pathan,7,5,0,0,1,4,3,0,0,1,2,0,0
6480bb9e93f969bcc8a79433,2011,,,2,MEK Hussey,SK Raina,7,11,0,0,1,1,2,0,0,4,9,0,0
6480bb9f00ef088221497043,2013,,,1,MK Tiwary,R Bhatia,7,9,0,0,1,5,5,0,0,1,4,0,0
6480bba000b91f6c5cf57fdb,2013,,,2,BJ Hodge,JP Faulkner,7,4,0,1,1,1,1,0,0,6,3,0,1
6480bb95f214d4f82ab97ee5,2018,,,1,Anureet Singh,JD Unadkat,7,9,0,0,1,3,4,0,0,3,5,0,0
6480bb95014388d3e8c62904,2019,,,1,TG Southee,YS Chahal,7,6,0,0,0,6,5,0,0,1,1,0,0
6480bb9a6ecee5429e0468be,2023,,,1,KS Sharma,MP Stoinis,7,6,1,0,1,1,2,0,0,6,4,1,0
6480bb970d7cbd85b6ada680,2021,,,2,AB de Villiers,RM Patidar,7,11,0,0,1,3,9,0,0,2,2,0,0
6480bb99409885bcc7b67109,2023,,,1,SO Hetmyer,YBK Jaiswal,7,4,1,0,1,3,2,0,0,4,2,1,0
6480bb9825eb960aded1ff64,2022,,,1,RD Gaikwad,RV Uthappa,7,14,0,0,1,2,4,0,0,3,10,0,0
6480bb9f68a0a232d83c338c,2012,,,2,AT Rayudu,DR Smith,7,6,1,0,1,1,1,0,0,6,5,1,0
6480bb9e335bec070f88430f,2011,,,2,M Vijay,MEK Hussey,7,13,0,0,1,2,6,0,0,4,7,0,0
6480bb9bee2e48d9c41b1e23,2009,,,2,TL Suman,Y Venugopal Rao,7,10,0,0,1,3,5,0,0,2,5,0,0
6480bb9d1f9a3cf1fa86e11c,2011,,,1,B Chipli,DT Christian,7,4,1,0,1,7,3,1,0,0,1,0,0
6480bba1ff55936e203ca5a6,2014,,,1,GJ Bailey,R Dhawan,7,10,0,0,1,3,4,0,0,4,6,0,0
6480bb9aa37f3b44678752d9,2023,,,2,A Manohar,DA Miller,7,6,1,0,1,2,3,0,0,5,3,1,0
6480bb9936b7698da2c2030c,2023,,,1,JO Holder,SO Hetmyer,7,5,1,0,1,0,1,0,0,7,4,1,0
6480bb9936b7698da2c2030c,2023,,,1,JC Buttler,SO Hetmyer,7,8,0,0,1,4,4,0,0,3,4,0,0
6480bba250b404cdcbff22c8,2015,,,1,P Negi,RA Jadeja,7,4,0,0,1,3,3,0,0,2,1,0,0
6480bba136257b71aa9952cf,2014,,,2,DA Miller,WP Saha,7,3,0,1,1,1,1,0,0,6,2,0,1
6480bb957ae1619e0d648dec,2019,,,1,DA Warner,JM Bairstow,7,10,0,0,1,1,4,0,0,1,6,0,0
6480bb9dd89d4266d59a4592,2011,,,1,A Mithun,AB de Villiers,7,4,1,0,0,6,3,1,0,0,1,0,0
6480bba20130c44ed20c9bcf,2016,,,1,PA Patel,RG Sharma,7,9,1,0,1,0,0,0,0,7,9,1,0
6480bb9ccba48a6bb44ccc21,2009,,,2,DJ Bravo,ST Jayasuriya,7,13,1,0,1,5,8,1,0,2,5,0,0
6480bba01893b0faadb9c761,2013,,,1,MG Johnson,SL Malinga,7,4,0,1,0,7,3,0,1,0,1,0,0
6480bba2b5d601f8354f5b5a,2016,,,2,AR Patel,M Vohra,7,12,0,0,1,2,7,0,0,4,5,0,0
6480bba16af3f513920ef499,2015,,,2,MK Pandey,SA Yadav,7,4,1,0,0,5,2,1,0,2,2,0,0
6480bba140ee53a14fe06e0d,2014,,,1,AT Rayudu,KA Pollard,7,3,0,1,1,7,2,0,1,0,1,0,0
6480bb9fc3369c6f5a549d05,2013,,,1,IK Pathan,KM Jadhav,7,12,0,0,1,2,6,0,0,5,6,0,0
6480bb9d5cca30c933d4baf4,2011,,,1,R McLaren,Sunny Singh,7,6,1,0,1,2,3,0,0,5,3,1,0
6480bba01a3f8444c7a33ba6,2014,,,2,F du Plessis,MS Dhoni,7,11,0,0,1,4,6,0,0,3,5,0,0
6480bba38056992b92414bab,2016,,,1,SA Yadav,YK Pathan,7,5,1,0,0,6,3,1,0,1,2,0,0
6480bb94dcc956fa4ca06b92,2018,,,1,BB McCullum,V Kohli,7,10,0,0,1,3,6,0,0,3,4,0,0
6480bb9f02801d2090cdba0d,2012,,,2,KD Karthik,RJ Peterson,7,9,0,0,1,4,5,0,0,3,4,0,0
6480bba0c7bf2b92ac8d836a,2013,,,2,JP Faulkner,SR Watson,7,8,1,0,1,1,4,0,0,6,4,1,0
6480bb9e5ab10d1241d6509d,2012,,,1,CH Gayle,TM Dilshan,7,15,0,0,1,2,7,0,0,4,8,0,0
6480bb9b283b30d0503656f7,2007/08,,,1,G Gambhir,V Sehwag,7,6,1,0,1,7,4,1,0,0,2,0,0
6480bb962831291a868490e7,2020/21,,,1,KD Karthik,N Rana,7,10,0,0,1,3,6,0,0,3,4,0,0
6480bb95fa6394e733c532a9,2018,,,1,MK Pandey,Shakib Al Hasan,7,6,1,0,1,1,2,0,0,6,4,1,0
6480bb984f0f3dc0df6d4531,2022,,,1,DR Sams,TH David,7,4,0,1,1,0,2,0,0,7,2,0,1
6480bba20559f15c3489f637,2015,,,1,LMP Simmons,UBT Chand,7,8,1,0,1,2,4,0,0,5,4,1,0
6480bb9ef7c6084992b7cdf8,2012,,,2,DT Christian,JP Duminy,7,10,0,0,1,3,5,0,0,4,5,0,0
6480bb9651b51fdcda05e4c8,2020/21,,,1,EJG Morgan,KL Nagarkoti,7,4,0,1,0,6,3,0,1,1,1,0,0
6480bb9f00ef088221497043,2013,,,2,M Vijay,MEK Hussey,7,17,0,0,1,2,5,0,0,5,12,0,0
6480bba0c1c8569f19cc70f0,2013,,,1,JP Faulkner,STR Binny,7,3,1,0,0,3,2,0,0,4,1,1,0
6480bb9996eb97dd08b62f78,2023,,,2,LS Livingstone,P Simran Singh,7,7,1,0,1,2,4,0,0,5,3,1,0
6480bb9d867c041656e9a75f,2009/10,,,2,B Sumanth,WPUJC Vaas,7,12,0,0,1,3,4,0,0,3,8,0,0
6480bb9db6a011b38afed5dc,2011,,,1,M Manhas,Yuvraj Singh,7,13,0,0,1,4,7,0,0,2,6,0,0
6480bb9c12f907c7b81b11a9,2009,,,2,MM Patel,SK Warne,7,13,0,0,1,4,5,0,0,3,8,0,0
6480bb938ed49c6d5c211429,2017,,,1,C de Grandhomme,YK Pathan,7,5,0,1,1,0,2,0,0,7,3,0,1
6480bb96b7b695186bbb6a3e,2019,,,1,Ishan Kishan,KH Pandya,7,7,0,0,1,0,0,0,0,7,7,0,0
6480bb945901306d3cb2b759,2018,,,2,AM Rahane,BA Stokes,7,9,0,0,1,2,3,0,0,5,6,0,0
6480bb9439fcd1191cf17a90,2017,,,1,DR Smith,KD Karthik,7,6,1,0,1,4,4,1,0,3,2,0,0
6480bb9e502d7987de08e5d5,2012,,,1,B Kumar,M Manhas,7,4,1,0,0,7,4,1,0,0,0,0,0
6480bb96ee2a21f0d9b9f37f,2020/21,,,1,SO Hetmyer,SS Iyer,7,5,0,1,0,7,5,0,1,0,0,0,0
6480bb95f214d4f82ab97ee5,2018,,,1,JC Archer,JD Unadkat,7,6,1,0,1,6,5,1,0,1,1,0,0
6480bb9a9514379c05d59c38,2023,,,1,R Ashwin,TA Boult,7,2,1,0,0,5,2,1,0,0,0,0,0
6480bb9f7bae5ad85c4473ba,2012,,,2,JA Morkel,RA Jadeja,7,3,0,1,1,0,1,0,0,6,2,0,1
6480bb964a4d5a1709db428e,2020/21,,,2,GJ Maxwell,KL Rahul,7,4,0,1,1,0,2,0,0,7,2,0,1
6480bb9d038ed22e46cbeccb,2011,,,1,A Mishra,I Sharma,7,7,1,0,0,6,5,1,0,1,2,0,0
6480bba3fc9599eca1b87a77,2016,,,2,KD Karthik,RA Jadeja,7,11,0,0,1,2,4,0,0,3,7,0,0
6480bba1f2392e6761d39d66,2014,,,2,Harbhajan Singh,PP Ojha,7,2,0,1,0,6,1,0,1,1,1,0,0
6480bb9f59fd8000010baf09,2013,,,1,KB Arun Karthik,V Kohli,7,10,0,0,1,5,5,0,0,2,5,0,0
6480bba2f05e90a9005771d2,2015,,,1,A Ashish Reddy,EJG Morgan,7,7,1,0,1,6,6,1,0,1,1,0,0
6480bb9edb0554f003f5428a,2012,,,1,JH Kallis,YK Pathan,7,4,0,1,1,6,3,0,1,0,1,0,0
6480bb97752fcb9cd9f23692,2021,,,1,KL Rahul,N Pooran,7,3,0,1,1,7,2,0,1,0,1,0,0
6480bb98dd9a2108c79e1014,2022,,,1,Arshdeep Singh,VG Arora,7,14,1,0,1,5,10,1,0,2,4,0,0
6480bba0be153677ce53c58e,2014,,,2,CA Pujara,GJ Maxwell,7,4,1,0,1,1,2,0,0,5,2,1,0
6480bb931b06a170006b4713,2017,,,2,DR Smith,SK Raina,7,6,1,0,1,5,4,1,0,2,2,0,0
6480bb99c6aa5989a16174d1,2023,,,1,KD Karthik,MK Lomror,7,9,0,0,1,3,5,0,0,3,4,0,0
6480bb9e34659755628e7471,2012,,,2,AC Gilchrist,PC Valthaty,7,13,1,0,1,5,8,1,0,1,5,0,0
6480bba1568e0f3990191600,2014,,,2,KK Nair,SR Watson,7,8,1,0,1,6,3,1,0,1,5,0,0
6480bb9b09e6c98206422ae5,2009,,,1,BJ Hodge,LR Shukla,7,9,0,0,1,2,4,0,0,5,5,0,0
6480bba32e54551792a9e915,2016,,,2,HH Pandya,KA Pollard,7,5,0,1,1,1,1,0,0,6,4,0,1
6480bb9ee7a29c9b96ed61e5,2011,,,1,AM Nayar,R McLaren,7,15,0,0,1,3,7,0,0,4,8,0,0
6480bb95af5853799812b0f6,2019,,,2,CA Lynn,N Rana,7,12,0,1,1,7,11,0,1,0,1,0,0
6480bba0a3e806f41a4dab41,2013,,,1,MK Tiwary,RN ten Doeschate,7,6,1,0,1,6,5,1,0,1,1,0,0
6480bb97fcc6fccd233157f9,2021,,,2,R Parag,SV Samson,7,9,1,0,1,2,7,0,0,5,2,1,0
6480bb952f20835ddd6e533f,2019,,,2,BA Stokes,RA Tripathi,7,3,0,1,1,6,2,0,1,1,1,0,0
6480bb9f7ff1377c4d13a645,2013,,,2,B Kumar,MR Marsh,7,7,1,0,1,1,3,0,0,6,4,1,0
6480bba25855b7a7195a9bc5,2016,,,2,JC Buttler,RG Sharma,7,11,0,0,1,2,6,0,0,5,5,0,0
6480bba0fee4ae82492a666f,2013,,,1,DJG Sammy,PA Patel,7,3,0,1,1,7,3,0,1,0,0,0,0
6480bb9f54d17f50da495682,2012,,,2,DA Warner,NV Ojha,7,8,1,0,1,7,6,1,0,0,2,0,0
6480bb9558345af5a1bb044d,2019,,,1,AB de Villiers,MP Stoinis,7,4,0,1,1,7,2,0,1,0,2,0,0
6480bb9836d24b9817a35f7d,2022,,,1,E Lewis,MK Pandey,7,6,1,0,1,4,4,1,0,2,2,0,0
6480bb9a8053274c083224d9,2023,,,1,Arshad Khan,T Stubbs,7,4,1,0,1,1,2,0,0,6,2,1,0
6480bba3caa5150f2db7a1dc,2016,,,1,KS Williamson,S Dhawan,7,10,1,0,1,6,9,1,0,1,1,0,0
6480bba18e95c84faca0bdb6,2015,,,2,CH Morris,JP Faulkner,7,4,0,1,1,7,3,0,1,0,1,0,0
6480bba278153a5979e31ec9,2016,,,1,MS Dhoni,NLTC Perera,7,3,1,0,0,4,1,1,0,3,2,0,0
6480bba2679194b06d4834db,2016,,,2,Harbhajan Singh,KH Pandya,7,7,0,0,0,1,3,0,0,5,4,0,0
6480bba1f2392e6761d39d66,2014,,,2,KA Pollard,RG Sharma,7,5,1,0,1,2,2,0,0,5,3,1,0
6480bb96902b7c96b94f406a,2019,,,1,CA Lynn,RV Uthappa,7,13,0,0,1,3,7,0,0,4,6,0,0
6480bb969d80bbba2884b855,2020/21,,,2,Abdul Samad,JO Holder,7,2,0,1,0,0,0,0,0,7,2,0,1
6480bb94f46306dbde97aa5c,2017,,,2,PP Chawla,SA Yadav,7,8,0,0,1,2,6,0,0,3,2,0,0
6480bba18a289cc4b8d173a4,2014,,,1,M de Lange,S Gopal,7,6,1,0,1,1,2,0,0,6,4,1,0
6480bba23b270561e8026bd2,2015,,,1,DA Warner,S Dhawan,7,6,1,0,1,6,4,1,0,1,2,0,0
6480bb94fc240a33621b10a6,2018,,,1,CA Lynn,N Rana,7,9,0,0,1,4,4,0,0,3,5,0,0
6480bb973d98bfd2d4a5f108,2020/21,,,2,EJG Morgan,KD Karthik,7,6,1,0,1,6,4,1,0,1,2,0,0
6480bb9404b444be6724e41e,2017,,,1,CJ Anderson,KK Nair,7,8,0,0,1,3,5,0,0,3,3,0,0
6480bba1670ace74604a420f,2015,,,2,JA Morkel,JP Duminy,7,7,0,0,1,2,2,0,0,5,5,0,0
6480bb962fbc99d08dc59f56,2020/21,,,1,AB de Villiers,V Kohli,7,9,0,0,1,2,5,0,0,5,4,0,0
6480bba1743abcb135a6a4c7,2015,,,1,GJ Bailey,MG Johnson,7,6,0,1,1,7,2,0,1,0,4,0,0
6480bb9fd4a1af6234c9e57c,2012,,,1,CH Gayle,MA Agarwal,7,9,0,1,1,0,0,0,0,7,9,0,1
6480bba210201df0f7975000,2016,,,2,SN Khan,STR Binny,7,3,0,1,1,6,2,0,1,1,1,0,0
6480bb9f146f5849bb759148,2013,,,1,A Ashish Reddy,GH Vihari,7,6,1,0,1,1,1,0,0,6,5,1,0
6480bba0ad06ad631cf7665f,2014,,,2,KD Karthik,M Vijay,7,8,1,0,1,2,2,0,0,5,6,1,0
6480bb9dc4ec5a52f8bcc465,2009/10,,,2,S Dhawan,SR Tendulkar,7,7,0,0,1,2,4,0,0,5,3,0,0
6480bb9e65a802582c071438,2012,,,2,RG Sharma,SR Tendulkar,7,8,1,0,1,1,4,0,0,6,4,1,0
6480bb9b77a0ff5cb3d0e3e0,2009,,,1,L Balaji,SB Jakati,7,7,0,0,1,2,3,0,0,4,4,0,0
6480bb95b84f125c6212267a,2019,,,2,SO Hetmyer,V Kohli,7,7,0,1,1,7,5,0,1,0,2,0,0
6480bb9800ba03eb1f9437d2,2022,,,1,AK Markram,N Pooran,7,8,0,0,1,4,3,0,0,3,5,0,0
6480bb9b3a5e1af467fb027b,2009,,,1,LRPL Taylor,RV Uthappa,7,9,0,0,1,1,4,0,0,6,5,0,0
6480bb969d80bbba2884b855,2020/21,,,1,CH Morris,Gurkeerat Singh,7,7,1,0,1,3,4,0,0,4,3,1,0
6480bb9f4780a208e13bfb3d,2013,,,1,AB de Villiers,CH Gayle,7,8,1,0,1,7,8,1,0,0,0,0,0
6480bb9f03dd3a09740f0bd0,2013,,,1,BJ Hodge,S Sreesanth,7,5,0,0,0,4,3,0,0,1,2,0,0
6480bb9a43249ece8e841e56,2023,,,1,F du Plessis,MK Lomror,7,7,0,0,1,6,4,0,0,1,3,0,0
6480bb9d4e112d675b2925df,2009/10,,,1,BB McCullum,MK Tiwary,7,8,0,0,1,4,3,0,0,3,5,0,0
6480bba20559f15c3489f637,2015,,,2,KL Rahul,S Dhawan,7,6,1,0,1,0,0,0,0,6,6,1,0
6480bb9f6f311344dac147cc,2012,,,1,DB Das,LR Shukla,7,5,0,1,1,7,4,0,1,0,1,0,0
6480bb95c8ecc2185a67f4fd,2019,,,2,JM Bairstow,KS Williamson,7,8,1,0,1,6,7,1,0,1,1,0,0
6480bb945460b25d997060fb,2018,,,1,Shubman Gill,TK Curran,7,5,0,0,1,1,3,0,0,2,2,0,0
6480bb9f6f311344dac147cc,2012,,,1,JH Kallis,YK Pathan,7,10,0,0,1,1,4,0,0,5,6,0,0
6480bb999424dd02cf40772a,2022,,,2,E Lewis,KL Rahul,7,7,0,0,1,1,3,0,0,2,4,0,0
6480bba179195d83fa7fbfbb,2014,,,1,JP Faulkner,R Bhatia,7,2,0,1,0,1,1,0,0,6,1,0,1
6480bb94ca3c1b1eac5e8dd3,2018,,,1,E Lewis,RG Sharma,7,13,1,0,1,0,2,0,0,7,11,1,0
6480bb94f06c6048c8088194,2018,,,1,DS Kulkarni,S Gopal,7,10,0,0,1,2,3,0,0,3,7,0,0
6480bb9d1f9a3cf1fa86e11c,2011,,,2,DL Vettori,R Ninan,7,10,0,0,1,2,4,0,0,3,6,0,0
6480bb9a24adc8d916dfe2db,2023,,,2,Fazalhaq Farooqi,M Markande,7,8,1,0,0,1,5,0,0,6,3,1,0
6480bb98af25209ef756aa2c,2021,,,1,D Padikkal,V Kohli,7,10,0,1,1,0,4,0,0,6,6,0,1
6480bb9c7a11e1cbeea46b0e,2009/10,,,2,AD Mascarenhas,SK Warne,7,4,0,0,0,5,3,0,0,1,1,0,0
6480bb9d91920239b62f48ad,2009/10,,,1,A Kumble,R Vinay Kumar,7,6,1,0,0,1,3,0,0,5,3,1,0
6480bb97e5be965d3c00760e,2021,,,1,HV Patel,Mohammed Siraj,7,6,1,0,1,5,5,1,0,2,1,0,0
6480bb9cd0eb4289b2222e37,2009/10,,,2,AA Jhunjhunwala,DR Martyn,7,9,1,0,1,5,7,1,0,2,2,0,0
6480bb977f55a1c473670850,2021,,,1,GD Phillips,S Dube,7,14,0,0,1,4,9,0,0,3,5,0,0
6480bb9fa1611443840261b7,2012,,,1,PA Reddy,S Dhawan,6,6,1,0,1,1,2,0,0,5,4,1,0
6480bba11a59d64bb4aa66f4,2014,,,1,DA Miller,WP Saha,6,9,0,0,1,4,5,0,0,2,4,0,0
6480bba2b99fcf06aaeac805,2015,,,1,AT Rayudu,Harbhajan Singh,6,2,1,0,0,6,2,1,0,0,0,0,0
6480bb9698a1d9136a13faf6,2020/21,,,1,CH Gayle,N Pooran,6,13,0,0,1,4,7,0,0,2,6,0,0
6480bba24f6e6e2c212c7469,2016,,,2,NM Coulter-Nile,Z Khan,6,12,1,0,1,2,3,0,0,4,9,1,0
6480bba280f09c38002cf14b,2015,,,1,G Gambhir,SA Yadav,6,8,0,0,1,2,4,0,0,4,4,0,0
6480bb9c12f907c7b81b11a9,2009,,,2,NV Ojha,SA Asnodkar,6,10,1,0,1,1,4,0,0,4,6,1,0
6480bb948f3284f793b2763c,2018,,,1,HH Pandya,MJ McClenaghan,6,1,1,0,0,4,1,1,0,0,0,0,0
6480bb9a4de9fe3e7319ce39,2007/08,,,1,LRPL Taylor,V Kohli,6,5,0,0,1,0,1,0,0,4,4,0,0
6480bba1603d86b7d278a366,2015,,,2,MM Sharma,P Negi,6,2,0,1,1,0,0,0,0,6,2,0,1
6480bba2563745309ee2bdfb,2016,,,1,DS Kulkarni,S Kaushik,6,4,0,0,0,6,4,0,0,0,0,0,0
6480bb99ed38bcb4025b8d86,2023,,,1,SN Thakur,SP Narine,6,4,1,0,1,5,3,1,0,0,1,0,0
6480bb9404b444be6724e41e,2017,,,1,KK Nair,SS Iyer,6,7,0,0,1,3,3,0,0,3,4,0,0
6480bba3bca9c998d5f3e3d0,2016,,,1,DA Miller,GJ Maxwell,6,2,0,1,0,6,2,0,1,0,0,0,0
6480bb9a0474602f26069e45,2007/08,,,2,MS Dhoni,SK Raina,6,12,0,0,1,1,7,0,0,5,5,0,0
6480bb9d79d603cc45fc9b3c,2011,,,2,DJ Hussey,SE Marsh,6,9,0,0,1,1,5,0,0,4,4,0,0
6480bb9523e6dc3c988ce398,2019,,,2,CA Lynn,SP Narine,6,6,0,0,1,1,2,0,0,1,4,0,0
6480bba255079696d5cfa453,2015,,,2,M Vijay,M Vohra,6,4,0,0,1,1,1,0,0,2,3,0,0
6480bb99fa79383bdc7df827,2022,,,2,MK Lomror,RM Patidar,6,3,0,1,1,6,3,0,1,0,0,0,0
6480bb9c9685addc4a78d7d0,2009/10,,,1,IK Pathan,KC Sangakkara,6,4,1,0,1,2,2,0,0,4,2,1,0
6480bb95816d3ad3bc382ab6,2018,,,2,Mohammed Siraj,YS Chahal,6,8,1,0,1,5,4,1,0,0,4,0,0
6480bb9e300070746cc2eb67,2011,,,1,DJ Bravo,S Badrinath,6,1,0,1,0,6,1,0,1,0,0,0,0
6480bba048fb3d33ea0711e7,2013,,,1,DA Miller,LA Pomersbach,6,14,1,0,1,6,7,1,0,0,7,0,0
6480bb9c2778066dafd78a71,2009/10,,,1,ML Hayden,SK Raina,6,3,0,1,1,0,0,0,0,6,3,0,1
6480bb983ad1bab18d1d8774,2022,,,2,KD Karthik,SE Rutherford,6,8,0,0,1,3,4,0,0,2,4,0,0
6480bb99c26e725b7b6f1637,2023,,,2,JC Buttler,SV Samson,6,7,0,0,1,3,3,0,0,2,4,0,0
6480bb9c963968000dfd00d1,2009/10,,,2,DPMD Jayawardene,Yuvraj Singh,6,7,1,0,1,0,2,0,0,6,5,1,0
6480bba3d3dc891a3092643e,2016,,,1,IK Pathan,MS Dhoni,6,9,0,0,1,2,3,0,0,4,6,0,0
6480bb988b447f26d7a96c0c,2022,,,2,KA Pollard,SA Yadav,6,7,0,0,1,3,3,0,0,3,4,0,0
6480bb9d40fc01528c7b7270,2009/10,,,2,LRPL Taylor,V Kohli,6,11,0,0,1,2,3,0,0,4,8,0,0
6480bb9c71030f4c6f018f55,2009,,,1,A Symonds,RG Sharma,6,8,0,0,1,2,4,0,0,3,4,0,0
6480bba0ad06ad631cf7665f,2014,,,2,JDS Neesham,S Nadeem,6,10,0,0,1,4,5,0,0,2,5,0,0
6480bb98291bb8b3f3e8145d,2022,,,2,AD Russell,PJ Cummins,6,5,1,0,1,1,2,0,0,4,3,1,0
6480bba3b818a7cff6fe4f89,2016,,,2,MK Pandey,YK Pathan,6,10,0,0,1,4,4,0,0,2,6,0,0
6480bb97a4220e27710e38de,2021,,,1,D Padikkal,V Kohli,6,9,1,0,1,0,3,0,0,5,6,1,0
6480bb9a7194d8b20952afae,2007/08,,,2,P Kumar,W Jaffer,6,5,1,0,1,6,5,1,0,0,0,0,0
6480bb9f36ad55c3c7fd6548,2012,,,1,KD Karthik,RG Sharma,6,11,0,0,1,3,8,0,0,1,3,0,0
6480bb9fd9db46138a9bb209,2013,,,1,MEK Hussey,SK Raina,6,11,0,0,1,5,8,0,0,1,3,0,0
6480bba326249b668a4713d6,2016,,,2,DJ Bravo,RA Jadeja,6,2,0,1,0,0,0,0,0,6,2,0,1
6480bb9fa1611443840261b7,2012,,,2,TM Dilshan,V Kohli,6,10,1,0,1,1,5,0,0,4,5,1,0
6480bb9c963968000dfd00d1,2009/10,,,1,JA Morkel,MS Gony,6,8,0,0,1,3,2,0,0,2,6,0,0
6480bb94d8ce46258c13e90e,2017,,,1,Harbhajan Singh,MG Johnson,6,1,0,1,0,6,1,0,1,0,0,0,0
6480bba11eff9b230a172302,2014,,,1,SP Narine,Shakib Al Hasan,6,4,0,0,0,1,1,0,0,4,3,0,0
6480bb95b84f125c6212267a,2019,,,2,C de Grandhomme,Mohammed Siraj,6,7,0,0,1,4,4,0,0,0,3,0,0
6480bb94f46306dbde97aa5c,2017,,,2,AS Rajpoot,UT Yadav,6,10,1,0,1,4,7,1,0,2,3,0,0
6480bb970127afddc00607cc,2021,,,1,KS Williamson,MK Pandey,6,4,1,0,1,1,1,0,0,5,3,1,0
6480bb9ed6aefcc9cd13d851,2012,,,2,SC Ganguly,SPD Smith,6,6,1,0,1,0,2,0,0,6,4,1,0
6480bb94aa9b082aa58a3822,2017,,,2,KK Nair,SV Samson,6,11,1,0,1,1,1,0,0,4,10,1,0
6480bb95f2e3c32afe233820,2018,,,2,AB de Villiers,MM Ali,6,5,1,0,1,0,2,0,0,6,3,1,0
6480bb956b439141409fd739,2018,,,1,JC Buttler,RA Tripathi,6,8,1,0,1,5,3,1,0,1,5,0,0
6480bb953b102c650968cba2,2019,,,1,PA Patel,YS Chahal,6,15,0,0,1,2,3,0,0,4,12,0,0
6480bb96edb3270eba0af1d4,2020/21,,,2,AT Rayudu,RA Jadeja,6,7,0,0,1,5,5,0,0,1,2,0,0
6480bb99fe078839da40e7ab,2023,,,1,JJ Roy,SP Narine,6,6,1,0,1,0,0,0,0,4,6,1,0
6480bb972a7d4e1071ea662e,2021,,,1,J Yadav,RD Chahar,6,8,0,0,1,4,5,0,0,2,3,0,0
6480bb99f33a7dd80eb0a544,2023,,,1,DJ Hooda,KH Pandya,6,2,1,0,0,0,0,0,0,5,2,1,0
6480bb9dd4e6757f7ded95e9,2009/10,,,2,A Symonds,RG Sharma,6,8,0,0,1,4,6,0,0,1,2,0,0
6480bba069c0322e91e50958,2013,,,2,RN ten Doeschate,YK Pathan,6,6,0,0,1,1,5,0,0,1,1,0,0
6480bb96ebf33df82879ad4c,2020/21,,,2,KM Jadhav,MS Dhoni,6,14,0,0,1,2,8,0,0,4,6,0,0
6480bb9f0f1f6c03d8e2f039,2013,,,1,AD Mathews,MK Pandey,6,6,1,0,1,0,1,0,0,6,5,1,0
6480bb9e692eaa193a417426,2012,,,2,DAJ Bracewell,M Morkel,6,6,0,0,0,4,3,0,0,2,3,0,0
6480bb938ed49c6d5c211429,2017,,,2,MC Henriques,Yuvraj Singh,6,5,1,0,1,5,3,1,0,1,2,0,0
6480bba18a289cc4b8d173a4,2014,,,1,AP Tare,Harbhajan Singh,6,5,1,0,1,5,4,1,0,1,1,0,0
6480bb93c1cc671d66c471ba,2017,,,1,JC Buttler,N Rana,6,6,1,0,1,1,4,0,0,5,2,1,0
6480bba2a94dd2c01769b3ae,2016,,,2,Q de Kock,SV Samson,6,8,0,0,1,2,4,0,0,4,4,0,0
6480bb94bf9a1728b1b12f4d,2018,,,1,MK Pandey,WP Saha,6,5,0,0,1,1,2,0,0,5,3,0,0
6480bba18a2fe828fa106f6c,2014,,,1,BJ Hodge,KK Nair,6,9,1,0,1,2,7,0,0,4,2,1,0
6480bb9e19dd5297ba8ca5f7,2011,,,2,KC Sangakkara,S Sohal,6,7,0,0,1,3,3,0,0,3,4,0,0
6480bb9af968df9497d2b9c4,2007/08,,,1,I Sharma,LR Shukla,6,3,1,0,0,0,0,0,0,4,3,1,0
6480bba1c0aa361f3c6e454c,2015,,,1,LMP Simmons,RG Sharma,6,5,1,0,1,4,4,1,0,2,1,0,0
6480bb94605dacb25c83dc35,2018,,,1,AJ Finch,KL Rahul,6,9,0,0,1,2,4,0,0,3,5,0,0
6480bba388682c5ca10ff37a,2016,,,1,Iqbal Abdulla,Sachin Baby,6,3,1,0,0,4,2,1,0,1,1,0,0
6480bba38056992b92414bab,2016,,,2,NV Ojha,Yuvraj Singh,6,4,1,0,1,0,1,0,0,6,3,1,0
6480bb9f36ad55c3c7fd6548,2012,,,2,BB McCullum,G Gambhir,6,8,1,0,1,1,5,0,0,5,3,1,0
6480bb9eee740f701b0ee154,2011,,,1,M Vijay,MEK Hussey,6,6,1,0,1,1,2,0,0,5,4,1,0
6480bb9e28b7a946a6921fa6,2011,,,2,JEC Franklin,KA Pollard,6,11,0,0,1,2,5,0,0,3,6,0,0
6480bb96ec7d98e34055e8fc,2020/21,,,1,R Parag,SPD Smith,6,4,1,0,1,6,4,1,0,0,0,0,0
6480bb9e41b781523bd5aafe,2012,,,1,G Gambhir,JH Kallis,6,6,1,0,1,6,5,1,0,0,1,0,0
6480bb9f02801d2090cdba0d,2012,,,2,RG Sharma,SR Tendulkar,6,8,0,0,1,3,5,0,0,2,3,0,0
6480bb9b7557e68b433167d5,2007/08,,,1,JA Morkel,S Badrinath,6,6,0,0,1,5,4,0,0,1,2,0,0
6480bba0a222eb875a07f5a3,2014,,,2,NJ Maddinson,PA Patel,6,11,1,0,1,4,6,1,0,2,5,0,0
6480bba0d4b2f9be71a5f230,2014,,,2,JP Duminy,NM Coulter-Nile,6,1,0,1,0,6,1,0,1,0,0,0,0
6480bb9bc8bcea920f081be8,2009,,,1,LRPL Taylor,V Kohli,6,9,0,0,1,4,6,0,0,2,3,0,0
6480bb99537b54b870dc74d1,2023,,,2,DA Miller,R Tewatia,6,3,1,0,0,1,1,0,0,5,2,1,0
6480bb974123cbc9756ceefa,2021,,,1,KS Bharat,Shahbaz Ahmed,6,2,0,1,1,0,0,0,0,6,2,0,1
6480bb973e451a92813d78cc,2020/21,,,2,SP Narine,Shubman Gill,6,8,1,0,1,0,2,0,0,6,6,1,0
6480bb9774a44376e3b5eb6f,2021,,,2,FA Allen,M Shahrukh Khan,6,1,0,1,0,0,0,0,0,6,1,0,1
6480bb94f06c6048c8088194,2018,,,2,S Dhawan,WP Saha,6,9,1,0,1,0,4,0,0,5,5,1,0
6480bba16e510ff78ef635a1,2014,,,1,AP Tare,CJ Anderson,6,1,0,1,0,6,1,0,1,0,0,0,0
6480bba2563745309ee2bdfb,2016,,,2,AR Patel,WP Saha,6,6,0,0,1,0,2,0,0,6,4,0,0
6480bb9d85a6220ec9bc7dcb,2011,,,1,M Manhas,MK Pandey,6,11,1,0,1,0,4,0,0,6,7,1,0
6480bb9523e6dc3c988ce398,2019,,,2,KD Karthik,N Rana,6,1,0,1,0,0,0,0,0,6,1,0,1
6480bb9772f78629131db057,2021,,,1,DJ Bravo,RA Jadeja,6,3,1,0,0,4,2,1,0,1,1,0,0
6480bb948211fe47e65f2e77,2018,,,1,Basil Thampi,YK Pathan,6,10,0,0,1,3,6,0,0,3,4,0,0
6480bb9836af59f8283f4081,2022,,,2,DR Sams,TH David,6,1,0,1,0,6,1,0,1,0,0,0,0
6480bb9d5d93b08a19c16313,2009/10,,,1,M Vijay,ML Hayden,6,3,0,0,1,1,1,0,0,0,2,0,0
6480bb9a5d25d853e1cbfe3e,2007/08,,,1,Kamran Akmal,M Kaif,6,8,1,0,1,0,0,0,0,5,8,1,0
6480bb94f46306dbde97aa5c,2017,,,2,G Gambhir,IR Jaggi,6,9,1,0,1,5,4,1,0,1,5,0,0
6480bb985efffbcafdef9f19,2021,,,2,AK Markram,MA Agarwal,6,7,0,0,1,2,3,0,0,4,4,0,0
6480bb9b5d0191a0a2611916,2009,,,2,AS Raut,RA Jadeja,6,12,0,0,1,1,4,0,0,5,8,0,0
6480bb9ca668b7b36823fb21,2009,,,2,DS Kulkarni,Harbhajan Singh,6,2,1,0,0,0,0,0,0,6,2,1,0
6480bb97d5e3b0911408f222,2020/21,,,1,Gurkeerat Singh,Washington Sundar,6,3,1,0,0,1,1,0,0,5,2,1,0
6480bb9c54a72690027ba3d4,2009/10,,,1,PA Patel,SK Raina,6,10,0,0,1,1,4,0,0,5,6,0,0
6480bb94f46306dbde97aa5c,2017,,,2,NM Coulter-Nile,SA Yadav,6,4,0,1,1,6,4,0,1,0,0,0,0
6480bb9ddcbb8fbbad6614c8,2009/10,,,1,A Mishra,A Nehra,6,7,0,0,1,4,3,0,0,1,4,0,0
6480bb99d2bd76016d47896d,2023,,,1,K Gowtham,KH Pandya,6,1,0,1,0,6,1,0,1,0,0,0,0
6480bb96c0ffb76dab723a2b,2019,,,1,A Mishra,RR Pant,6,5,0,0,1,0,1,0,0,6,4,0,0
6480bb95a09b947e0837a38a,2019,,,2,KA Pollard,Q de Kock,6,7,0,0,1,2,2,0,0,4,5,0,0
6480bba28724848c0f3ef034,2015,,,2,PP Chawla,UT Yadav,6,5,1,0,0,0,3,0,0,5,2,1,0
6480bb9dd89d4266d59a4592,2011,,,2,KD Karthik,SE Marsh,6,6,1,0,1,6,4,1,0,0,2,0,0
6480bb94f1c027945eeb8b10,2017,,,2,KA Pollard,KV Sharma,6,6,1,0,1,1,2,0,0,5,4,1,0
6480bb9f146f5849bb759148,2013,,,2,MK Pandey,MN Samuels,6,10,1,0,1,1,1,0,0,5,9,1,0
6480bb9e9162dceff15dc334,2011,,,2,AC Gilchrist,SE Marsh,6,11,0,0,1,3,8,0,0,1,3,0,0
6480bb94a0422f6d0abe276b,2017,,,2,CH Morris,CJ Anderson,6,8,0,0,1,4,3,0,0,2,5,0,0
6480bb94fbd0b904d63e0e07,2017,,,1,Anureet Singh,I Sharma,6,4,1,0,1,1,2,0,0,5,2,1,0
6480bb9737b1d7284b5297c1,2021,,,2,AB de Villiers,HV Patel,6,5,0,0,1,3,3,0,0,3,2,0,0
6480bb9a8cf29e28434bb1d5,2023,,,1,MK Pandey,PK Garg,6,8,0,0,1,1,4,0,0,5,4,0,0
6480bb95b33a36f0dd77d1a1,2018,,,2,BA Stokes,JC Buttler,6,1,0,1,0,0,0,0,0,6,1,0,1
6480bb9a17692bfb5bd3894c,2007/08,,,1,Joginder Sharma,S Badrinath,6,1,0,1,0,0,0,0,0,6,1,0,1
6480bb9e05381e16815803e9,2011,,,1,KD Karthik,Mandeep Singh,6,7,0,0,1,1,3,0,0,4,4,0,0
6480bb9eae43aed76989151b,2011,,,2,G Gambhir,JH Kallis,6,8,0,0,1,2,4,0,0,4,4,0,0
6480bb966c9efd5bf35d10b9,2019,,,2,BA Stokes,SPD Smith,6,5,1,0,1,5,2,1,0,1,3,0,0
6480bb972a7d4e1071ea662e,2021,,,1,JJ Bumrah,RD Chahar,6,5,1,0,1,2,2,0,0,4,3,1,0
6480bba0f858e6c12b25d8c3,2014,,,1,G Gambhir,JH Kallis,6,9,1,0,1,1,5,0,0,5,4,1,0
6480bb962fbc99d08dc59f56,2020/21,,,2,KL Rahul,N Pooran,6,1,0,1,0,0,0,0,0,6,1,0,1
6480bba21bbf76a62abea528,2016,,,1,AM Rahane,SPD Smith,6,4,1,0,1,1,1,0,0,4,3,1,0
6480bba210201df0f7975000,2016,,,2,SR Watson,TM Head,6,15,0,0,1,4,9,0,0,2,6,0,0
6480bb9fc28e897b3c53f359,2012,,,2,JEC Franklin,KA Pollard,6,10,0,0,1,3,5,0,0,2,5,0,0
6480bb9ab655ac367694708c,2007/08,,,2,DS Lehmann,M Kaif,6,8,0,0,1,1,2,0,0,4,6,0,0
6480bb952f20835ddd6e533f,2019,,,2,DS Kulkarni,S Gopal,6,4,1,0,0,5,3,1,0,1,1,0,0
6480bb9894cc2d00f057a1f1,2021,,,2,LH Ferguson,RA Tripathi,6,1,0,1,0,0,0,0,0,6,1,0,1
6480bba09d6b23c8722fd208,2013,,,2,KA Pollard,RG Sharma,6,9,0,0,1,3,4,0,0,2,5,0,0
6480bb9fa3a890f94f179477,2013,,,1,PP Chawla,R Sathish,6,4,1,0,1,4,2,1,0,2,2,0,0
6480bb979e8cc2484c1a8c7b,2020/21,,,1,KA Pollard,SS Tiwary,6,4,0,1,1,6,4,0,1,0,0,0,0
6480bb953b102c650968cba2,2019,,,1,PA Patel,S Dube,6,8,0,0,1,4,3,0,0,2,5,0,0
6480bb99864a94e086c8395e,2022,,,2,DR Sams,Ishan Kishan,6,5,1,0,1,1,1,0,0,5,4,1,0
6480bb9c3803ef7726af83ab,2009/10,,,1,M Vijay,MS Dhoni,6,2,0,1,1,6,2,0,1,0,0,0,0
6480bb94ee669473878c11c2,2017,,,1,Kuldeep Yadav,UT Yadav,6,11,0,0,1,4,7,0,0,2,4,0,0
6480bb962a1612c936d161ba,2019,,,2,DJ Bravo,M Vijay,6,10,0,0,1,3,5,0,0,2,5,0,0
6480bba0e883438915efc1e6,2013,,,1,B Kumar,R Sharma,6,5,0,0,1,6,4,0,0,0,1,0,0
6480bb9d69cb9046a72d8fbe,2009/10,,,2,A Symonds,MD Mishra,6,8,1,0,1,4,3,1,0,2,5,0,0
6480bb9480627b50308b7903,2017,,,1,IK Pathan,JP Faulkner,6,11,0,0,1,2,3,0,0,3,8,0,0
6480bba04b49d2ff5f997e02,2013,,,2,IK Pathan,UT Yadav,6,9,0,0,1,1,4,0,0,5,5,0,0
6480bb9f36da1a646c80be45,2013,,,2,M Morkel,MC Juneja,6,7,0,0,1,4,4,0,0,2,3,0,0
6480bb9341152e168005ccc9,2017,,,1,AF Milne,S Aravind,6,7,0,0,1,0,1,0,0,5,6,0,0
6480bb9f5867d07199aa832a,2013,,,1,DJ Bravo,MS Dhoni,6,7,0,0,1,1,4,0,0,4,3,0,0
6480bb9ef18c54e7aafdd223,2012,,,1,MS Bisla,Shakib Al Hasan,6,5,0,0,1,1,2,0,0,1,3,0,0
6480bb954714437843ab3647,2019,,,1,AR Patel,CH Morris,6,10,0,0,1,3,4,0,0,2,6,0,0
6480bb9d61e9b86b0f0aae49,2009/10,,,2,CL White,RV Uthappa,6,5,0,0,1,4,3,0,0,2,2,0,0
6480bb93d5dc00a79edede9c,2017,,,2,NV Ojha,Rashid Khan,6,6,0,0,1,4,4,0,0,1,2,0,0
6480bb9e28b7a946a6921fa6,2011,,,1,AB de Villiers,LA Pomersbach,6,6,0,0,1,1,2,0,0,4,4,0,0
6480bb9fe31a789bcb52d583,2012,,,1,AP Majumdar,SC Ganguly,6,8,0,0,1,5,6,0,0,1,2,0,0
6480bb99695e001cdaca81e0,2022,,,2,Ishan Kishan,RG Sharma,6,5,1,0,1,6,5,1,0,0,0,0,0
6480bb9763013a01eae041f2,2020/21,,,1,Q de Kock,RG Sharma,6,5,0,1,1,0,0,0,0,6,5,0,1
6480bb9b2de4e62ee60b7e5c,2009,,,1,A Kumble,R Vinay Kumar,6,4,1,0,0,5,3,1,0,1,1,0,0
6480bb947a7c9fe868fc901a,2017,,,2,TM Head,V Kohli,6,6,0,0,1,2,2,0,0,3,4,0,0
6480bb956b439141409fd739,2018,,,2,KL Rahul,MA Agarwal,6,8,0,0,1,3,5,0,0,2,3,0,0
6480bba0a3e806f41a4dab41,2013,,,2,MC Henriques,R Vinay Kumar,6,5,1,0,1,1,2,0,0,5,3,1,0
6480bb96edb3270eba0af1d4,2020/21,,,2,DL Chahar,SN Thakur,6,6,0,0,0,5,5,0,0,1,1,0,0
6480bb9ded279701c84af803,2011,,,2,DT Christian,JP Duminy,6,5,1,0,1,1,1,0,0,5,4,1,0
6480bb9f0f959bc6104820c3,2013,,,1,AD Russell,J Botha,6,6,0,0,1,4,3,0,0,2,3,0,0
6480bb96d1b3bea0aa2127e4,2020/21,,,2,EJG Morgan,N Rana,6,9,1,0,1,6,8,1,0,0,1,0,0
6480bba154ce29a67e4752df,2015,,,1,AB de Villiers,D Wiese,6,7,1,0,1,0,1,0,0,6,6,1,0
6480bba237377ccc608266d2,2016,,,2,KA Pollard,PA Patel,6,5,0,0,1,5,3,0,0,1,2,0,0
6480bb9c3b082d71291a593c,2009,,,2,JDP Oram,S Badrinath,6,17,0,0,1,4,8,0,0,2,9,0,0
6480bb9a24adc8d916dfe2db,2023,,,2,Abhishek Sharma,Anmolpreet Singh,6,5,1,0,1,1,1,0,0,5,4,1,0
6480bb9cb881721acc1bab60,2009,,,2,DJ Hussey,Mashrafe Mortaza,6,2,0,1,1,6,2,0,1,0,0,0,0
6480bba1c0aa361f3c6e454c,2015,,,2,DR Smith,SK Raina,6,4,0,1,1,6,4,0,1,0,0,0,0
6480bb9c2f07203e8e510386,2009/10,,,2,M Manhas,MF Maharoof,6,3,1,0,0,5,2,1,0,1,1,0,0
6480bba35038a60ea566794a,2016,,,2,DA Warner,S Dhawan,6,7,1,0,1,5,3,1,0,0,4,0,0
6480bba287d112bccc55ccd2,2015,,,2,D Wiese,SN Khan,6,8,0,0,1,3,4,0,0,2,4,0,0
6480bb93d5dc00a79edede9c,2017,,,1,HH Pandya,N Rana,6,5,1,0,1,1,2,0,0,5,3,1,0
6480bb9f7258f976eb8fe943,2012,,,1,AM Rahane,R Dravid,6,11,1,0,1,0,2,0,0,4,9,1,0
6480bb95085c25712f29bd36,2019,,,2,F du Plessis,SR Watson,6,5,1,0,1,1,2,0,0,5,3,1,0
6480bb96f1eadf803ffc292c,2020/21,,,2,R Tewatia,YBK Jaiswal,6,5,1,0,1,1,1,0,0,5,4,1,0
6480bb9f777b7b1e89543a6e,2013,,,2,KD Karthik,RT Ponting,6,13,0,0,1,3,5,0,0,3,8,0,0
6480bba16af3f513920ef499,2015,,,1,KL Rahul,MC Henriques,6,5,1,0,0,0,3,0,0,5,2,1,0
6480bba23ed328dbb847b4e7,2016,,,2,G Gambhir,RV Uthappa,6,6,1,0,1,5,2,1,0,1,4,0,0
6480bb9d54ae15d3d0ed9e5e,2011,,,1,BB McCullum,M Klinger,6,10,0,0,1,1,8,0,0,4,2,0,0
6480bb977453ebef15f59e25,2021,,,2,MP Stoinis,SO Hetmyer,6,4,1,0,0,6,3,1,0,0,1,0,0
6480bba2aecb4103bab63c15,2016,,,2,SP Narine,UT Yadav,6,1,0,1,0,0,0,0,0,6,1,0,1
6480bb9fcbbfd8053f253537,2012,,,1,IK Pathan,M Morkel,6,2,0,1,1,6,2,0,1,0,0,0,0
6480bba133267f04941acf7d,2014,,,1,DA Warner,IK Pathan,6,4,1,0,1,5,3,1,0,1,1,0,0
6480bb9cd0eb4289b2222e37,2009/10,,,2,M Morkel,SK Warne,6,15,0,0,1,2,8,0,0,4,7,0,0
6480bb97372fc5d5ef4c436a,2021,,,2,DA Miller,R Parag,6,10,0,0,1,4,5,0,0,2,5,0,0
6480bb9f955d5c84cde78f58,2012,,,1,AM Rahane,STR Binny,6,6,0,0,1,1,2,0,0,5,4,0,0
6480bba2eea6f31945e4c5e2,2016,,,1,G Gambhir,YK Pathan,6,5,1,0,1,5,4,1,0,1,1,0,0
6480bb94d8ce46258c13e90e,2017,,,1,Harbhajan Singh,RG Sharma,6,3,0,1,1,0,0,0,0,6,3,0,1
6480bba120182b9ca0b70004,2014,,,1,BR Dunk,RG Sharma,6,8,1,0,1,5,3,1,0,1,5,0,0
6480bb94738952e740c68749,2018,,,2,AJ Finch,MK Tiwary,6,4,0,1,1,6,2,0,1,0,2,0,0
6480bb9ef18c54e7aafdd223,2012,,,2,BA Bhatt,PP Chawla,6,2,0,1,0,6,2,0,1,0,0,0,0
6480bb96acacf3be646d300a,2020/21,,,2,A Nortje,TU Deshpande,6,6,1,0,1,1,3,0,0,5,3,1,0
6480bb9b09e6c98206422ae5,2009,,,1,AB Agarkar,SC Ganguly,6,6,0,0,1,1,1,0,0,2,5,0,0
6480bb9929c7e430acd1ef18,2022,,,2,R Powell,RV Patel,6,3,0,1,1,0,0,0,0,6,3,0,1
6480bb9d5d93b08a19c16313,2009/10,,,2,AB Agarkar,Iqbal Abdulla,6,3,1,0,0,5,2,1,0,0,1,0,0
6480bb94cb5adf24f5ad15c3,2017,,,2,AM Rahane,RA Tripathi,6,6,0,0,1,4,4,0,0,0,2,0,0
6480bba273adb498d96b27a9,2016,,,2,SP Narine,UT Yadav,6,4,0,0,1,4,3,0,0,1,1,0,0
6480bb9aded509be64de3bfb,2007/08,,,2,LR Shukla,M Kartik,6,6,0,0,1,3,3,0,0,3,3,0,0
6480bb973d64aa91e60b4088,2021,,,1,DJ Bravo,SN Thakur,6,4,0,0,1,4,3,0,0,1,1,0,0
6480bba2ab35be3ffcfa932a,2016,,,1,CH Gayle,V Kohli,6,8,1,0,1,1,4,0,0,4,4,1,0
6480bb9eb2690fb1ed356b42,2011,,,1,RG Sharma,SR Tendulkar,6,9,1,0,1,4,6,1,0,2,3,0,0
6480bba0587190387a754733,2013,,,2,CA Pujara,CH Gayle,6,12,1,0,1,2,5,0,0,4,7,1,0
6480bb9bca2c11520f5b3b9e,2007/08,,,2,DPMD Jayawardene,SE Marsh,6,7,1,0,1,1,1,0,0,5,6,1,0
6480bb94834e2b780c4782b5,2017,,,1,TA Boult,UT Yadav,6,9,0,0,0,5,8,0,0,1,1,0,0
6480bb9a8ac627a1ebf8dacf,2007/08,,,1,P Kumar,V Kohli,6,4,1,0,1,2,2,0,0,4,2,1,0
6480bb9e83b8575f74b8e962,2012,,,2,R Vinay Kumar,Z Khan,6,1,0,1,0,6,1,0,1,0,0,0,0
6480bb9525ace33768e8b671,2019,,,2,JM Bairstow,YK Pathan,6,1,0,1,0,6,1,0,1,0,0,0,0
6480bba2563745309ee2bdfb,2016,,,2,MM Sharma,WP Saha,6,3,1,0,1,0,0,0,0,6,3,1,0
6480bb998454ba791a8fdbf8,2023,,,1,A Nortje,Mustafizur Rahman,6,4,1,0,1,5,3,1,0,1,1,0,0
6480bb9bc8bcea920f081be8,2009,,,1,B Akhil,R Vinay Kumar,6,2,0,1,1,6,2,0,1,0,0,0,0
6480bba29fb420d92aef1d2a,2015,,,1,SA Yadav,YK Pathan,6,3,1,0,1,6,3,1,0,0,0,0,0
6480bba29fb420d92aef1d2a,2015,,,1,RN ten Doeschate,YK Pathan,6,7,0,0,1,3,3,0,0,3,4,0,0
6480bb9af85f41b4de44ca19,2023,,,2,Noor Ahmad,Rashid Khan,6,5,1,0,1,0,1,0,0,4,4,1,0
6480bba0f858e6c12b25d8c3,2014,,,1,M Morkel,UT Yadav,6,5,0,0,1,4,3,0,0,1,2,0,0
6480bba0f858e6c12b25d8c3,2014,,,2,R Dhawan,Sandeep Sharma,6,8,0,0,0,3,3,0,0,2,5,0,0
6480bb9bc80883a975281815,2009,,,1,R Dravid,R Vinay Kumar,6,2,0,1,1,6,2,0,1,0,0,0,0
6480bba0120becd670aec59d,2013,,,1,B Kumar,RV Uthappa,6,3,1,0,1,0,0,0,0,6,3,1,0
6480bb947a7c9fe868fc901a,2017,,,1,A Mishra,RR Pant,6,4,0,1,1,0,0,0,0,6,4,0,1
6480bb99bbae76f3f761d060,2023,,,2,CV Varun,RK Singh,6,9,0,1,0,0,3,0,0,6,6,0,1
6480bb9429a15517bb46f3be,2018,,,1,HH Pandya,KH Pandya,6,6,0,0,1,2,2,0,0,3,4,0,0
6480bb9d038ed22e46cbeccb,2011,,,1,DB Ravi Teja,DT Christian,6,7,1,0,1,1,2,0,0,5,5,1,0
6480bba1568e0f3990191600,2014,,,1,CH Gayle,V Kohli,6,15,1,0,1,2,6,0,0,4,9,1,0
6480bb957e6d387fe3a6b26e,2018,,,2,MM Ali,PA Patel,6,7,0,0,1,1,3,0,0,1,4,0,0
6480bb9baccf501985a56d64,2007/08,,,2,A Mishra,TM Dilshan,6,11,0,0,1,4,5,0,0,2,6,0,0
6480bb9a8cf29e28434bb1d5,2023,,,1,DA Warner,PK Garg,6,7,0,0,1,2,2,0,0,3,5,0,0
6480bb9db0ecec8acdd30619,2011,,,2,M Manhas,RV Uthappa,6,10,0,0,1,3,5,0,0,3,5,0,0
6480bb9c9685addc4a78d7d0,2009/10,,,2,DJ Hussey,MK Tiwary,6,9,0,0,1,3,5,0,0,3,4,0,0
6480bba28257fe87dd859e3e,2015,,,2,AT Rayudu,KA Pollard,6,3,1,0,0,4,1,1,0,1,2,0,0
6480bb9e59fe7a0f48b7f9b9,2012,,,2,AD Mathews,SPD Smith,6,2,1,0,0,6,2,1,0,0,0,0,0
6480bb95b98d000799e11963,2018,,,1,PA Patel,V Kohli,6,6,1,0,1,1,4,0,0,5,2,1,0
6480bba0e883438915efc1e6,2013,,,2,MEK Hussey,WP Saha,6,15,1,0,1,5,8,1,0,0,7,0,0
6480bb9d867c041656e9a75f,2009/10,,,1,G Gambhir,TM Dilshan,6,6,1,0,1,1,1,0,0,5,5,1,0
6480bb958e752648ab95362b,2019,,,1,CA Lynn,SP Narine,6,6,0,0,1,0,5,0,0,5,1,0,0
6480bb948211fe47e65f2e77,2018,,,2,JJ Bumrah,Mustafizur Rahman,6,7,1,0,1,5,4,1,0,1,3,0,0
6480bb979e91d1ff9b54c737,2020/21,,,1,S Dhawan,SS Iyer,6,5,1,0,1,1,2,0,0,5,3,1,0
6480bb9c37b72d7a51019794,2009/10,,,2,SK Warne,SR Watson,6,5,1,0,1,1,2,0,0,5,3,1,0
6480bb9553f3fc8903579544,2018,,,1,JP Duminy,KH Pandya,6,1,0,1,0,0,0,0,0,6,1,0,1
6480bba26bb69626041c4ba1,2015,,,2,RN ten Doeschate,YK Pathan,6,3,0,1,1,0,1,0,0,6,2,0,1
6480bba2d313234709068efb,2015,,,1,J Suchith,LMP Simmons,6,6,0,0,1,4,4,0,0,2,2,0,0
6480bb99cf7659c6e45bd01d,2023,,,1,AK Markram,H Klaasen,6,9,0,0,1,3,4,0,0,3,5,0,0
6480bb9b724406459cd357c9,2007/08,,,2,MV Boucher,R Vinay Kumar,6,6,0,0,1,3,3,0,0,1,3,0,0
6480bb97a4220e27710e38de,2021,,,2,AD Russell,PJ Cummins,6,2,0,1,1,0,0,0,0,6,2,0,1
6480bba328f7475f4b87d3ff,2016,,,2,Shakib Al Hasan,YK Pathan,6,13,0,0,1,3,8,0,0,2,5,0,0
6480bb97aad3147696268239,2021,,,2,Q de Kock,SA Yadav,6,6,0,0,1,3,3,0,0,3,3,0,0
6480bb96e61ac20a6e10582e,2019,,,1,F du Plessis,SR Watson,6,13,1,0,1,6,11,1,0,0,2,0,0
6480bb9bca2c11520f5b3b9e,2007/08,,,2,DPMD Jayawardene,IK Pathan,6,15,0,0,1,3,3,0,0,3,12,0,0
6480bb9ea75f51e7a33e90ed,2012,,,2,N Saini,P Kumar,6,7,0,0,1,2,2,0,0,4,5,0,0
6480bb9558c0acb502a3b1a9,2019,,,1,Mandeep Singh,R Ashwin,6,8,0,0,1,3,4,0,0,3,4,0,0
6480bb961ee814aee7b674ac,2020/21,,,1,PP Shaw,S Dhawan,6,10,1,0,1,5,8,1,0,0,2,0,0
6480bb9d61e9b86b0f0aae49,2009/10,,,2,LRPL Taylor,RV Uthappa,6,8,0,0,1,1,5,0,0,3,3,0,0
6480bb9740aaba2132c0eb0e,2021,,,2,HV Patel,KA Jamieson,6,11,1,0,1,0,8,0,0,5,3,1,0
6480bb969d80bbba2884b855,2020/21,,,1,Gurkeerat Singh,Mohammed Siraj,6,8,0,0,0,2,5,0,0,2,3,0,0
6480bba19e29de4f208211ac,2014,,,1,CM Gautam,RG Sharma,6,6,0,0,1,0,3,0,0,2,3,0,0
6480bba07b5396a7b65684d3,2013,,,1,DR Smith,KD Karthik,6,3,1,0,1,6,3,1,0,0,0,0,0
6480bba1d9f266a28a109f29,2015,,,1,DA Miller,GJ Bailey,6,6,0,0,1,1,3,0,0,4,3,0,0
6480bb9b4fc6889967a3cd54,2007/08,,,2,DJ Bravo,PR Shah,6,2,0,1,1,6,2,0,1,0,0,0,0
6480bb981f136a7564719d7f,2022,,,1,RD Chahar,VG Arora,6,9,0,0,1,3,3,0,0,2,6,0,0
6480bb9fcb2b412c0ebd4afa,2013,,,2,KB Arun Karthik,MC Henriques,6,6,1,0,1,0,1,0,0,5,5,1,0
6480bb99f649ea7a6d79892f,2023,,,1,S Dhawan,Sikandar Raza,6,6,0,0,1,0,0,0,0,5,6,0,0
6480bb956e3f7f62e4b24c01,2019,,,1,AJ Turner,AM Rahane,6,5,0,0,1,0,1,0,0,6,4,0,0
6480bba1587a54176a9badf4,2014,,,2,DJG Sammy,S Anirudha,6,9,0,0,1,2,4,0,0,3,5,0,0
6480bba0c63a6317296391b7,2013,,,1,AT Rayudu,KA Pollard,6,5,0,0,1,3,2,0,0,2,3,0,0
6480bb9824c4678d005d7aeb,2022,,,1,R Parag,SO Hetmyer,6,3,1,0,1,5,3,1,0,0,0,0,0
6480bb96c880c7df4e055f14,2020/21,,,2,GJ Maxwell,JDS Neesham,6,9,0,0,1,2,5,0,0,4,4,0,0
6480bb98d2cd0fa3ed0ffc21,2022,,,1,M Shahrukh Khan,RA Bawa,6,3,1,0,1,0,0,0,0,6,3,1,0
6480bb9ade063258af41163b,2007/08,,,1,BB McCullum,WP Saha,6,8,1,0,1,5,5,1,0,1,3,0,0
6480bb9a8cf29e28434bb1d5,2023,,,2,DA Miller,HH Pandya,6,10,1,0,1,0,3,0,0,6,7,1,0
6480bba1c67d2c9c1279a4c8,2014,,,1,AB de Villiers,HV Patel,6,4,1,0,0,5,2,1,0,1,2,0,0
6480bb9c9f9d5376b4227724,2009/10,,,2,TL Suman,Y Venugopal Rao,6,2,0,1,0,6,2,0,1,0,0,0,0
6480bb9cba868c69775db687,2009,,,2,JA Morkel,S Badrinath,6,4,1,0,0,5,3,1,0,1,1,0,0
6480bb9d54ae15d3d0ed9e5e,2011,,,2,B Lee,MV Boucher,6,5,0,0,1,1,2,0,0,5,3,0,0
6480bb9bed3e2a1a008f93a6,2007/08,,,1,SR Tendulkar,ST Jayasuriya,6,5,1,0,1,0,3,0,0,5,2,1,0
6480bb99315aee6cd9d56504,2023,,,2,KL Rahul,N Pooran,6,3,0,1,1,0,1,0,0,6,2,0,1
6480bba0c7bf2b92ac8d836a,2013,,,2,R Dravid,STR Binny,6,3,1,0,0,6,3,1,0,0,0,0,0
6480bb9a36f2ab9a44baa0f8,2023,,,1,D Padikkal,R Parag,6,8,0,0,1,2,2,0,0,4,6,0,0
6480bb93575636076d81e4c5,2017,,,1,DA Warner,Mohammad Nabi,6,5,1,0,1,4,2,1,0,2,3,0,0
6480bb9b1087ddfd207caa83,2009,,,2,IK Pathan,T Kohli,6,6,0,0,1,6,6,0,0,0,0,0,0
6480bb9813fa79617f791851,2022,,,1,JC Buttler,YBK Jaiswal,6,11,0,0,1,2,5,0,0,4,6,0,0
6480bb9341152e168005ccc9,2017,,,2,RA Tripathi,SPD Smith,6,4,1,0,1,4,2,1,0,2,2,0,0
6480bb991a76403912eef285,2023,,,2,Dhruv Jurel,JO Holder,6,3,1,0,0,4,2,1,0,1,1,0,0
6480bb9a0a8baa96f94e8db9,2023,,,2,DJ Hooda,MP Stoinis,6,6,0,1,1,0,1,0,0,6,5,0,1
6480bb9692a7f0d52bd43127,2019,,,2,Mandeep Singh,R Ashwin,6,2,0,1,1,0,0,0,0,6,2,0,1
6480bba071a7a0cbb02d505a,2013,,,2,AC Gilchrist,Mandeep Singh,6,3,1,0,1,6,3,1,0,0,0,0,0
6480bba3b830360cf7031278,2016,,,2,KS Williamson,S Dhawan,6,10,0,0,1,2,5,0,0,4,5,0,0
6480bb9aded509be64de3bfb,2007/08,,,2,Mohammad Hafeez,SC Ganguly,6,13,0,0,1,4,8,0,0,1,5,0,0
6480bb9498a98d52f9285b52,2017,,,2,AM Rahane,RA Tripathi,6,11,0,0,1,5,7,0,0,1,4,0,0
6480bb95e435367dc64d9844,2019,,,2,AJ Turner,SPD Smith,6,3,1,0,1,0,1,0,0,6,2,1,0
6480bb9993e6e474a4e37366,2023,,,1,C Green,Tilak Varma,6,6,1,0,1,1,3,0,0,5,3,1,0
6480bb96c95abb10156a6055,2020/21,,,1,JJ Bumrah,RD Chahar,6,5,0,0,0,5,3,0,0,1,2,0,0
6480bba154ce29a67e4752df,2015,,,2,KA Pollard,RG Sharma,6,4,1,0,1,5,3,1,0,1,1,0,0
6480bb9eae43aed76989151b,2011,,,2,MK Tiwary,MV Boucher,6,4,0,0,0,1,2,0,0,1,2,0,0
6480bba08cc4182f0127f2e2,2013,,,2,MEK Hussey,MS Dhoni,6,15,0,0,1,3,9,0,0,3,6,0,0
6480bba3d3dc891a3092643e,2016,,,2,AR Patel,F Behardien,6,7,1,0,1,1,2,0,0,5,5,1,0
6480bb95fa6394e733c532a9,2018,,,1,MK Pandey,YK Pathan,6,7,0,0,1,3,3,0,0,2,4,0,0
6480bb9d22388e966342dba8,2009/10,,,2,Harbhajan Singh,SR Tendulkar,6,4,1,0,1,1,2,0,0,5,2,1,0
6480bb96593f4f87a2c294bc,2020/21,,,2,B Kumar,Rashid Khan,6,4,0,0,1,0,2,0,0,1,2,0,0
6480bb9e56c724ba25b94666,2011,,,1,Bipul Sharma,SJ Srivastava,6,4,0,0,0,3,2,0,0,3,2,0,0
6480bb9e173228d1b18e376b,2012,,,1,KP Pietersen,V Sehwag,6,6,1,0,1,5,5,1,0,1,1,0,0
6480bb9fd9db46138a9bb209,2013,,,2,CH Gayle,MA Agarwal,6,11,1,0,1,4,10,1,0,1,1,0,0
6480bba06e8cb70fb4bdc83e,2013,,,2,BB Samantray,GH Vihari,6,5,0,0,0,2,2,0,0,4,3,0,0
6480bb985efffbcafdef9f19,2021,,,1,CH Morris,R Tewatia,6,6,0,0,1,4,3,0,0,1,3,0,0
6480bb942efd740a6ffc47df,2017,,,2,KM Jadhav,SR Watson,6,8,0,0,1,3,3,0,0,3,5,0,0
6480bb94cb5adf24f5ad15c3,2017,,,1,PA Patel,RG Sharma,6,4,1,0,1,5,2,1,0,1,2,0,0
6480bb974123cbc9756ceefa,2021,,,2,AK Markram,M Shahrukh Khan,6,6,1,0,1,5,3,1,0,1,3,0,0
6480bb9b17739118ee6c3bd0,2007/08,,,1,AB Agarkar,WP Saha,6,3,1,0,1,5,2,1,0,1,1,0,0
6480bb97c48a16e84b55a325,2020/21,,,1,AB de Villiers,MM Ali,6,3,1,0,1,5,2,1,0,0,1,0,0
6480bb988b447f26d7a96c0c,2022,,,2,KA Pollard,M Ashwin,6,2,0,1,1,0,0,0,0,6,2,0,1
6480bb99433f6e11060ba714,2022,,,2,Harpreet Brar,JM Sharma,6,9,0,0,1,1,2,0,0,5,7,0,0
6480bb955f4b3a84d6973620,2018,,,1,GJ Maxwell,RR Pant,6,3,0,1,1,0,0,0,0,6,3,0,1
6480bb98a95cb1650c81c926,2022,,,2,KD Karthik,Shahbaz Ahmed,6,6,1,0,1,6,4,1,0,0,2,0,0
6480bb958f737f809dfb65e1,2019,,,2,DJ Hooda,V Shankar,6,9,1,0,1,6,7,1,0,0,2,0,0
6480bb9c968c81bdfcc6df5b,2009,,,1,R Bhatia,TM Dilshan,6,3,1,0,1,4,2,1,0,1,1,0,0
6480bba32e54551792a9e915,2016,,,2,HH Pandya,Harbhajan Singh,6,9,0,0,1,1,4,0,0,3,5,0,0
6480bba0ad06ad631cf7665f,2014,,,1,M Manhas,RA Jadeja,6,2,0,1,1,0,0,0,0,6,2,0,1
6480bba2ebdcfb98389cee5a,2015,,,1,KM Jadhav,SS Iyer,6,4,1,0,0,1,1,0,0,5,3,1,0
6480bb96c3293977af83acbf,2019,,,1,MK Lomror,SV Samson,6,3,1,0,1,4,1,1,0,2,2,0,0
6480bb994877788ec5b187ff,2023,,,2,F du Plessis,V Kohli,6,4,1,0,1,0,0,0,0,6,4,1,0
6480bb97fcc6fccd233157f9,2021,,,2,LS Livingstone,YBK Jaiswal,6,6,0,0,1,1,3,0,0,5,3,0,0
6480bb9da9ca2f2d3738d79e,2011,,,1,AT Rayudu,RG Sharma,6,8,1,0,1,4,5,1,0,1,3,0,0
6480bb9b72f6a46338302131,2009,,,2,AM Nayar,JP Duminy,6,10,0,0,1,1,4,0,0,4,6,0,0
6480bb9ca181f55cb21526f5,2009/10,,,1,SR Tendulkar,ST Jayasuriya,6,9,0,0,1,3,4,0,0,2,5,0,0
6480bb9574ca455ec008e942,2018,,,2,CA Lynn,RV Uthappa,6,10,1,0,1,4,2,1,0,2,8,0,0
6480bb98e87e6f83b61088ea,2022,,,1,JM Sharma,LS Livingstone,6,4,1,0,1,1,1,0,0,5,3,1,0
6480bb9932735ca83d38f6e7,2022,,,2,M Jansen,Shashank Singh,6,4,1,0,1,1,2,0,0,5,2,1,0
6480bb9b4fc6889967a3cd54,2007/08,,,1,DB Ravi Teja,DNT Zoysa,6,2,0,1,1,6,2,0,1,0,0,0,0
6480bb976caaa0cc91f652c7,2021,,,1,AF Milne,SS Tiwary,6,3,1,0,0,1,1,0,0,5,2,1,0
6480bb9ce93a7b4315d8fa30,2009,,,1,PP Ojha,WPUJC Vaas,6,5,1,0,1,0,2,0,0,6,3,1,0
6480bb93182304739a535742,2017,,,1,A Zampa,DL Chahar,6,6,1,0,1,5,4,1,0,1,2,0,0
6480bb9ea75f51e7a33e90ed,2012,,,2,DJ Hussey,Mandeep Singh,6,6,0,0,1,3,2,0,0,3,4,0,0
6480bb94dfad571ef76493a9,2017,,,1,K Rabada,PJ Cummins,6,4,0,1,1,0,2,0,0,6,2,0,1
6480bb9d40fc01528c7b7270,2009/10,,,2,JH Kallis,MK Pandey,6,9,1,0,1,0,3,0,0,6,6,1,0
6480bb99ed38bcb4025b8d86,2023,,,1,SP Narine,UT Yadav,6,2,1,0,0,0,0,0,0,6,2,1,0
6480bb984a44a355b856fd1a,2022,,,1,HV Patel,PWH de Silva,6,17,0,0,1,4,7,0,0,0,10,0,0
6480bb9873e53eace3a69dc7,2022,,,2,N Rana,SS Iyer,6,12,1,0,1,2,7,0,0,4,5,1,0
6480bb9e2c96ab2b87d9466a,2011,,,1,A Symonds,KA Pollard,6,7,0,0,0,4,4,0,0,2,3,0,0
6480bb9e565ef5f11c5c8f55,2011,,,2,A Mithun,JJ van der Wath,6,7,0,0,1,3,3,0,0,3,4,0,0
6480bb9d76ba2d9dd45c74a8,2011,,,2,KM Jadhav,R Vinay Kumar,6,5,1,0,1,1,1,0,0,5,4,1,0
6480bba0d3cbb27b257a9c1f,2013,,,1,MS Gony,R Sathish,6,4,0,0,1,2,2,0,0,3,2,0,0
6480bb94dfad571ef76493a9,2017,,,1,KK Nair,SS Iyer,6,10,0,0,1,2,4,0,0,3,6,0,0
6480bb980ea7c3bcea4fdf9c,2022,,,1,DJ Hooda,KH Pandya,6,5,1,0,1,0,0,0,0,6,5,1,0
6480bb954714437843ab3647,2019,,,2,DA Warner,KS Williamson,6,11,0,0,1,3,3,0,0,3,8,0,0
6480bb9e6d7f7f691dde322d,2012,,,1,AT Rayudu,JEC Franklin,6,13,0,0,1,3,8,0,0,3,5,0,0
6480bb9fc524f8142f0b3461,2012,,,1,RV Uthappa,SPD Smith,6,9,0,0,1,2,6,0,0,2,3,0,0
6480bb9b09e6c98206422ae5,2009,,,2,GC Smith,RJ Quiney,6,2,0,1,1,0,0,0,0,6,2,0,1
6480bb9df60a79ae5f20b748,2011,,,1,RE van der Merwe,Y Venugopal Rao,6,5,1,0,1,2,3,0,0,4,2,1,0
6480bba24f6e6e2c212c7469,2016,,,2,KK Nair,MA Agarwal,6,11,0,0,1,3,5,0,0,2,6,0,0
6480bb9813fa79617f791851,2022,,,2,Anuj Rawat,V Kohli,6,6,0,0,1,2,3,0,0,4,3,0,0
6480bba1d9f266a28a109f29,2015,,,2,AD Mathews,KM Jadhav,6,7,0,0,1,2,2,0,0,3,5,0,0
6480bba19e29de4f208211ac,2014,,,1,AP Tare,RG Sharma,6,2,1,0,0,0,0,0,0,6,2,1,0
6480bba1af9481df8b4f9f0f,2015,,,2,CH Gayle,Mandeep Singh,6,3,0,1,1,0,0,0,0,6,3,0,1
6480bb9ed6aefcc9cd13d851,2012,,,1,BB Samantray,JP Duminy,6,5,0,0,0,2,2,0,0,4,3,0,0
6480bb9a36f2ab9a44baa0f8,2023,,,1,A Zampa,Sandeep Sharma,6,8,0,0,1,3,3,0,0,2,5,0,0
6480bb989bf19eb260a04f0e,2022,,,1,SP Narine,SS Iyer,6,2,0,1,1,6,2,0,1,0,0,0,0
6480bb9c761c43b2dfb9767d,2009,,,1,K Goel,PP Chawla,6,1,1,0,1,4,1,1,0,0,0,0,0
6480bb9b166300b6298fc71a,2009,,,1,RR Powar,S Sreesanth,6,11,1,0,0,2,3,0,0,4,8,1,0
6480bb9d182be5b0fbe5a4e2,2011,,,2,AT Rayudu,SR Tendulkar,6,7,1,0,1,5,4,1,0,1,3,0,0
6480bba0208e8fbb34afdc50,2013,,,1,AB de Villiers,V Kohli,6,2,0,1,1,6,2,0,1,0,0,0,0
6480bb97c92184fed1a879f3,2021,,,2,D Padikkal,V Kohli,6,6,1,0,1,1,2,0,0,5,4,1,0
6480bba0da054e3d917f71fb,2013,,,1,BJ Hodge,STR Binny,6,2,0,1,0,0,1,0,0,6,1,0,1
6480bba29f384ce360fa8131,2016,,,1,M Vijay,SE Marsh,6,11,0,0,1,2,5,0,0,4,6,0,0
6480bb9ca668b7b36823fb21,2009,,,2,AM Rahane,Harbhajan Singh,6,4,1,0,1,1,2,0,0,5,2,1,0
6480bb9fe7d0f611ba6ad229,2012,,,1,B Kumar,SPD Smith,6,10,0,0,1,2,4,0,0,4,6,0,0
6480bba25855b7a7195a9bc5,2016,,,1,KK Nair,SV Samson,6,6,1,0,1,5,5,1,0,1,1,0,0
6480bb9f7ff1377c4d13a645,2013,,,1,KD Karthik,SR Tendulkar,6,7,1,0,1,1,4,0,0,5,3,1,0
6480bb973d64aa91e60b4088,2021,,,2,C Sakariya,JD Unadkat,6,2,1,0,1,0,0,0,0,4,2,1,0
6480bba1bd00c57fb3301f04,2014,,,1,G Gambhir,RV Uthappa,6,4,1,0,1,1,1,0,0,5,3,1,0
6480bb9eeeaf037e5e41ab86,2012,,,2,AM Nayar,DJ Hussey,6,4,0,1,1,6,4,0,1,0,0,0,0
6480bb984f6c41cd28aa0353,2022,,,1,A Badoni,KH Pandya,6,3,1,0,1,0,0,0,0,6,3,1,0
6480bb99433f6e11060ba714,2022,,,2,JM Sharma,LS Livingstone,6,9,1,0,1,5,6,1,0,1,3,0,0
6480bb9c50838010977c168c,2009,,,2,S Sohal,SM Katich,6,11,0,0,1,3,9,0,0,2,2,0,0
6480bb9b50f9e801edc13d5a,2007/08,,,1,B Akhil,R Dravid,6,5,1,0,1,5,3,1,0,1,2,0,0
6480bb93d9581d69657887c3,2017,,,2,CR Brathwaite,RR Pant,6,11,0,0,1,1,5,0,0,5,6,0,0
6480bb9fe31a789bcb52d583,2012,,,1,CJ Ferguson,Harpreet Singh,6,7,0,0,1,1,3,0,0,5,4,0,0
6480bb9bc80883a975281815,2009,,,2,M Rawat,SK Warne,6,13,0,0,1,3,4,0,0,3,9,0,0
6480bb97fb920d483d0da2af,2020/21,,,2,Ravi Bishnoi,SS Cottrell,6,8,1,0,1,6,6,1,0,0,2,0,0
6480bb9f1faffe780b407e67,2013,,,1,AM Nayar,R Sharma,6,4,1,0,1,5,3,1,0,1,1,0,0
6480bb9f70156528a31bb270,2013,,,2,Harbhajan Singh,KA Pollard,6,3,1,0,0,1,1,0,0,5,2,1,0
6480bb96edb3270eba0af1d4,2020/21,,,2,AT Rayudu,SR Watson,6,10,1,0,1,2,6,0,0,4,4,1,0
6480bb94009d0662ee94f07b,2018,,,1,E Lewis,SA Yadav,6,4,1,0,1,6,4,1,0,0,0,0,0
6480bb949a2d28d1ad7d367f,2018,,,2,KL Rahul,Yuvraj Singh,6,9,1,0,1,0,1,0,0,6,8,1,0
6480bb9a24adc8d916dfe2db,2023,,,1,R Tewatia,Shubman Gill,6,5,0,0,1,3,3,0,0,2,2,0,0
6480bba280f09c38002cf14b,2015,,,1,PP Chawla,UT Yadav,6,2,0,1,1,6,2,0,1,0,0,0,0
6480bba210201df0f7975000,2016,,,1,PA Patel,RG Sharma,6,7,1,0,1,5,6,1,0,1,1,0,0
6480bb9aab9770e7260312df,2007/08,,,1,AS Yadav,WPUJC Vaas,6,4,1,0,1,4,2,1,0,1,2,0,0
6480bba1dd2f8125fc8b203f,2014,,,1,BR Dunk,CM Gautam,6,5,1,0,1,5,4,1,0,0,1,0,0
6480bb9525c593ee45bb038c,2019,,,1,KA Pollard,Yuvraj Singh,6,10,0,0,1,2,3,0,0,3,7,0,0
6480bb99b0fa4d217ed7f255,2023,,,2,AK Markram,H Klaasen,6,4,1,0,1,1,2,0,0,5,2,1,0
6480bb977f55a1c473670850,2021,,,1,C Sakariya,K Yadav,6,13,1,0,1,5,10,1,0,0,3,0,0
6480bba1670ace74604a420f,2015,,,2,A Mishra,JA Morkel,6,6,0,0,1,4,4,0,0,1,2,0,0
6480bb9faf20f0bc714af2ea,2013,,,1,EJG Morgan,MK Tiwary,6,7,1,0,1,6,5,1,0,0,2,0,0
6480bb962a1612c936d161ba,2019,,,2,Imran Tahir,MJ Santner,6,2,0,1,1,0,0,0,0,6,2,0,1
6480bb9b1fc007965b68d4d9,2009,,,2,JP Duminy,S Dhawan,6,10,0,0,1,3,3,0,0,3,7,0,0
6480bb95960e393c939ab44c,2018,,,2,BCJ Cutting,JJ Bumrah,6,2,0,1,1,6,2,0,1,0,0,0,0
6480bb9bed3e2a1a008f93a6,2007/08,,,2,LR Shukla,SC Ganguly,6,8,1,0,1,0,4,0,0,5,4,1,0
6480bba2b5d601f8354f5b5a,2016,,,2,AR Patel,WP Saha,6,14,0,0,1,3,7,0,0,3,7,0,0
6480bb97668d35800fa74139,2021,,,1,Arshdeep Singh,Mohammed Shami,6,3,0,0,1,1,2,0,0,1,1,0,0
6480bba2256bfaaf14c57ead,2015,,,2,M Morkel,UT Yadav,6,5,0,0,0,4,3,0,0,2,2,0,0
6480bb9b2ca4a7b325526f1f,2009,,,1,TL Suman,Y Venugopal Rao,6,4,0,0,0,6,4,0,0,0,0,0,0
6480bba326249b668a4713d6,2016,,,1,RV Uthappa,SA Yadav,6,6,1,0,1,4,3,1,0,2,3,0,0
6480bb953aab41e7ed166b9d,2019,,,2,MJ McClenaghan,Rasikh Salam,6,7,0,0,1,1,3,0,0,5,4,0,0
6480bb9abfe839459b1a28f6,2007/08,,,1,RG Sharma,SB Bangar,6,10,0,0,1,3,2,0,0,3,8,0,0
6480bb9fcb2b412c0ebd4afa,2013,,,1,DW Steyn,GH Vihari,6,5,0,0,0,3,3,0,0,2,2,0,0
6480bb9d6ea22feab98beb5b,2011,,,2,AL Menaria,R Dravid,6,13,0,0,1,2,8,0,0,4,5,0,0
6480bb9439fcd1191cf17a90,2017,,,1,AJ Finch,BB McCullum,6,6,1,0,1,0,0,0,0,6,6,1,0
6480bb94f06c6048c8088194,2018,,,1,AM Rahane,DJM Short,6,6,1,0,1,1,2,0,0,4,4,1,0
6480bb97d5e3b0911408f222,2020/21,,,1,CH Morris,V Kohli,6,6,0,0,1,2,3,0,0,2,3,0,0
6480bb954e496ec9b12aa120,2019,,,1,SPD Smith,SV Samson,6,10,1,0,1,4,5,1,0,2,5,0,0
6480bb9d76ba2d9dd45c74a8,2011,,,1,J Botha,LRPL Taylor,6,2,1,0,0,4,1,1,0,2,1,0,0
6480bb9bbb0ec0266749f518,2007/08,,,1,R Dravid,Z Khan,6,2,0,1,1,6,2,0,1,0,0,0,0
6480bb9836d24b9817a35f7d,2022,,,2,DA Miller,MS Wade,6,10,0,0,1,3,5,0,0,3,5,0,0
6480bb94fbd0b904d63e0e07,2017,,,1,AR Patel,SE Marsh,6,4,1,0,1,1,1,0,0,4,3,1,0
6480bb96e61ac20a6e10582e,2019,,,1,SK Raina,SR Watson,6,9,1,0,1,5,7,1,0,0,2,0,0
6480bb9be2940d96c1f903ca,2007/08,,,1,JA Morkel,SK Raina,6,9,0,0,1,1,5,0,0,5,4,0,0
6480bba280f09c38002cf14b,2015,,,2,DA Miller,WP Saha,6,3,0,1,1,0,0,0,0,6,3,0,1
6480bb9c454e9eefca545bde,2009/10,,,1,DPMD Jayawardene,RS Bopara,6,9,0,0,1,4,5,0,0,2,4,0,0
6480bb9a6e44b0c8da00ca72,2007/08,,,2,A Nehra,DS Kulkarni,6,17,0,0,0,2,10,0,0,2,7,0,0
6480bb9f59fd8000010baf09,2013,,,1,CH Gayle,V Kohli,6,3,0,1,1,6,3,0,1,0,0,0,0
6480bb96593f4f87a2c294bc,2020/21,,,2,Abhishek Sharma,Rashid Khan,6,3,1,0,1,1,1,0,0,5,2,1,0
6480bb9cff4ec2f71cdf18d1,2009/10,,,1,Harbhajan Singh,R Sathish,6,3,0,0,0,1,1,0,0,4,2,0,0
6480bb99b0fa4d217ed7f255,2023,,,2,Abhishek Sharma,RA Tripathi,6,6,0,0,1,3,2,0,0,3,4,0,0
6480bb96c10dfe3d8c259db3,2020/21,,,2,AM Rahane,RR Pant,6,6,0,0,1,4,4,0,0,2,2,0,0
6480bb9d5cca30c933d4baf4,2011,,,2,SA Asnodkar,SR Watson,6,6,1,0,1,5,4,1,0,1,2,0,0
6480bb98bc3569cc8d04101a,2022,,,1,Ishan Kishan,RG Sharma,6,17,0,0,1,2,5,0,0,3,12,0,0
6480bb988545a7776b8c9306,2022,,,2,Anuj Rawat,V Kohli,6,8,1,0,1,5,5,1,0,1,3,0,0
6480bb9b2de4e62ee60b7e5c,2009,,,1,JD Ryder,RV Uthappa,6,7,1,0,1,6,6,1,0,0,1,0,0
6480bb94fc240a33621b10a6,2018,,,1,CA Lynn,SP Narine,6,9,0,0,1,4,5,0,0,1,4,0,0
6480bba1e64915b9e7c849ca,2014,,,1,MK Tiwary,Mohammed Shami,6,8,0,0,0,5,6,0,0,1,2,0,0
6480bba32e54551792a9e915,2016,,,2,HH Pandya,R Vinay Kumar,6,4,1,0,1,5,3,1,0,1,1,0,0
6480bb98960cf9374ee9420d,2022,,,2,D Brevis,RG Sharma,5,8,0,0,1,3,5,0,0,2,3,0,0
6480bba2563745309ee2bdfb,2016,,,2,M Vijay,SE Marsh,5,7,0,0,1,3,4,0,0,1,3,0,0
6480bb9b52b93b56f5a16e52,2007/08,,,1,GD McGrath,Mohammad Asif,5,5,1,0,1,4,3,1,0,1,2,0,0
6480bb956e3f7f62e4b24c01,2019,,,1,AM Rahane,SV Samson,5,7,1,0,1,5,7,1,0,0,0,0,0
6480bb9dfa7d0510ae3a7b40,2011,,,1,AJ Finch,DA Warner,5,5,1,0,1,0,1,0,0,5,4,1,0
6480bb95b1f28cf5bcf5e167,2018,,,2,F du Plessis,RA Jadeja,5,7,0,0,1,2,2,0,0,3,5,0,0
6480bb9eb559e2934b31c47c,2012,,,1,JA Morkel,S Badrinath,5,8,0,0,1,1,4,0,0,3,4,0,0
6480bb93575636076d81e4c5,2017,,,2,DA Miller,M Vohra,5,9,0,0,1,1,6,0,0,4,3,0,0
6480bb9698a1d9136a13faf6,2020/21,,,1,DJ Hooda,JDS Neesham,5,5,0,0,1,3,2,0,0,2,3,0,0
6480bb98bd3ca4df44cf9d8f,2022,,,1,Anuj Rawat,F du Plessis,5,7,1,0,1,0,1,0,0,4,6,1,0
6480bb98adf21699eaa67796,2022,,,2,DP Conway,RV Uthappa,5,4,1,0,1,4,1,1,0,1,3,0,0
6480bb9affc08d6384ac3992,2023,,,2,F du Plessis,GJ Maxwell,5,3,1,0,1,4,2,1,0,0,1,0,0
6480bb9f5867d07199aa832a,2013,,,2,LRPL Taylor,RV Uthappa,5,10,0,0,1,3,7,0,0,2,3,0,0
6480bb9ade063258af41163b,2007/08,,,2,RP Singh,SB Bangar,5,3,1,0,1,1,1,0,0,4,2,1,0
6480bba13b673297bce003e2,2014,,,1,G Gambhir,RV Uthappa,5,5,1,0,1,4,4,1,0,1,1,0,0
6480bba19701e99975ce7c59,2015,,,1,SPD Smith,SV Samson,5,8,0,0,1,1,1,0,0,4,7,0,0
6480bba19701e99975ce7c59,2015,,,1,CH Morris,JP Faulkner,5,6,0,0,1,2,2,0,0,3,4,0,0
6480bb9a1032ce724214f6dd,2007/08,,,1,A Nehra,RR Raje,5,4,1,0,0,0,0,0,0,5,4,1,0
6480bb9a9dc58f49d783faa9,2023,,,2,JC Buttler,SV Samson,5,6,1,0,1,0,2,0,0,4,4,1,0
6480bb9a7d91d721555835e5,2007/08,,,1,SR Watson,YK Pathan,5,3,1,0,1,0,1,0,0,5,2,1,0
6480bb969d80bbba2884b855,2020/21,,,2,Abhishek Sharma,KS Williamson,5,7,0,0,1,2,3,0,0,3,4,0,0
6480bb9c7ac2dca34620d56e,2009/10,,,1,JA Morkel,SK Raina,5,6,0,0,1,1,3,0,0,2,3,0,0
6480bb94457bfc7687322f80,2017,,,1,Mandeep Singh,S Aravind,5,8,0,0,1,2,3,0,0,3,5,0,0
6480bb9a6a7169d0e413bcfa,2023,,,2,Ravi Bishnoi,Swapnil Singh,5,6,1,0,0,4,5,1,0,1,1,0,0
6480bb94738952e740c68749,2018,,,2,AJ Finch,KK Nair,5,9,0,0,1,2,2,0,0,3,7,0,0
6480bb9af968df9497d2b9c4,2007/08,,,1,BB McCullum,SC Ganguly,5,3,1,0,1,1,1,0,0,4,2,1,0
6480bba031c5cf0145ae8cfe,2014,,,2,CA Pujara,V Sehwag,5,10,0,0,1,2,3,0,0,2,7,0,0
6480bb94fc240a33621b10a6,2018,,,1,PP Chawla,Shubman Gill,5,4,0,0,0,2,2,0,0,2,2,0,0
6480bb950c59218964b27cc0,2018,,,1,BA Stokes,MK Lomror,5,8,0,0,1,1,2,0,0,3,6,0,0
6480bb9e5ad1f3182858e7c9,2012,,,1,JEC Franklin,RG Sharma,5,7,0,0,1,3,2,0,0,2,5,0,0
6480bb9ee4565d108b29626f,2012,,,1,F du Plessis,MEK Hussey,5,10,0,0,1,3,4,0,0,2,6,0,0
6480bb9d3c4dfa9f054aa47f,2011,,,2,AL Menaria,AS Raut,5,7,0,0,1,2,2,0,0,3,5,0,0
6480bb9774a44376e3b5eb6f,2021,,,2,DJ Hooda,KL Rahul,5,6,0,0,1,3,4,0,0,2,2,0,0
6480bb94ee669473878c11c2,2017,,,1,NM Coulter-Nile,SA Yadav,5,6,0,0,1,2,3,0,0,2,3,0,0
6480bb9db9ed29ce1ee8764f,2011,,,1,AJ Finch,Y Venugopal Rao,5,7,0,0,1,3,5,0,0,2,2,0,0
6480bb9a0a8baa96f94e8db9,2023,,,1,KD Karthik,MK Lomror,5,6,0,0,1,2,2,0,0,3,4,0,0
6480bb993e44f97eccb361fe,2023,,,1,A Badoni,Ravi Bishnoi,5,2,0,0,0,2,1,0,0,3,1,0,0
6480bb95c701f5c8388f7f88,2018,,,1,AR Patel,MM Sharma,5,8,0,0,1,2,3,0,0,3,5,0,0
6480bb9f23c17ccb47aa9e58,2013,,,2,AC Gilchrist,Mandeep Singh,5,8,0,0,1,0,2,0,0,1,6,0,0
6480bb9797043717cd96890a,2021,,,2,KS Williamson,PK Garg,5,6,1,0,1,5,5,1,0,0,1,0,0
6480bb95385ebb9bda58a643,2019,,,1,BCJ Cutting,Q de Kock,5,10,0,0,1,2,4,0,0,3,6,0,0
6480bb95c701f5c8388f7f88,2018,,,1,CH Gayle,KK Nair,5,3,1,0,1,4,2,1,0,1,1,0,0
6480bba0b46cf5430edef3f5,2014,,,1,AT Rayudu,KA Pollard,5,5,1,0,1,5,3,1,0,0,2,0,0
6480bb96267b63eb2c6747b0,2019,,,2,AB de Villiers,V Kohli,5,9,0,0,1,4,7,0,0,1,2,0,0
6480bba119569fcc2d7859a4,2014,,,2,AB de Villiers,S Rana,5,4,1,0,1,1,2,0,0,4,2,1,0
6480bb98291bb8b3f3e8145d,2022,,,1,AR Patel,DA Warner,5,10,0,0,1,3,5,0,0,1,5,0,0
6480bb9fc3369c6f5a549d05,2013,,,1,AB Agarkar,KM Jadhav,5,9,0,0,1,3,7,0,0,2,2,0,0
6480bba2db1e2def1b597ed3,2015,,,2,M Vohra,SE Marsh,5,5,1,0,1,0,1,0,0,5,4,1,0
6480bb955f4b3a84d6973620,2018,,,2,JC Archer,K Gowtham,5,2,1,0,0,0,0,0,0,5,2,1,0
6480bba0c3cc8c51bc6c1c3a,2013,,,1,JP Faulkner,STR Binny,5,2,1,0,0,1,1,0,0,4,1,1,0
6480bb9cff4ec2f71cdf18d1,2009/10,,,2,B Lee,K Goel,5,4,0,0,1,3,3,0,0,1,1,0,0
6480bb9ea75f51e7a33e90ed,2012,,,2,Bipul Sharma,DJ Hussey,5,3,1,0,1,1,1,0,0,4,2,1,0
6480bb9a8ac627a1ebf8dacf,2007/08,,,1,LRPL Taylor,MV Boucher,5,6,0,0,1,3,3,0,0,1,3,0,0
6480bb9c266a85f1960d87e9,2009,,,1,KD Karthik,PJ Sangwan,5,8,0,0,1,3,5,0,0,2,3,0,0
6480bba23b270561e8026bd2,2015,,,1,KV Sharma,P Kumar,5,6,0,0,1,3,4,0,0,2,2,0,0
6480bb9b17739118ee6c3bd0,2007/08,,,1,LR Shukla,WP Saha,5,3,1,0,1,4,2,1,0,1,1,0,0
6480bb93d9581d69657887c3,2017,,,2,KK Nair,SW Billings,5,5,1,0,1,4,3,1,0,1,2,0,0
6480bb9fe31a789bcb52d583,2012,,,1,AG Murtaza,B Kumar,5,9,0,0,0,3,5,0,0,2,4,0,0
6480bba031c5cf0145ae8cfe,2014,,,2,CA Pujara,WP Saha,5,6,0,0,1,3,3,0,0,2,3,0,0
6480bba2c3207713bd927ce5,2015,,,2,M Vohra,WP Saha,5,8,0,0,1,3,4,0,0,2,4,0,0
6480bb9e9f1ef9ac02266570,2011,,,1,B Chipli,S Sohal,5,3,1,0,1,5,2,1,0,0,1,0,0
6480bb99c26e725b7b6f1637,2023,,,1,KR Mayers,MP Stoinis,5,3,1,0,1,0,1,0,0,5,2,1,0
6480bb9f8d3b0a3d1e28a4b7,2013,,,2,A Mishra,KV Sharma,5,3,0,0,0,1,1,0,0,1,2,0,0
6480bb97ce981c1918dce924,2021,,,2,MK Pandey,WP Saha,5,8,0,0,1,3,3,0,0,2,5,0,0
6480bb9e6d7f7f691dde322d,2012,,,2,DT Christian,JP Duminy,5,6,1,0,1,5,5,1,0,0,1,0,0
6480bb95430629e254bbc4fd,2018,,,2,KD Karthik,PP Chawla,5,4,1,0,0,5,4,1,0,0,0,0,0
6480bb9b9614f21d90333e15,2007/08,,,2,M Kaif,NK Patel,5,9,1,0,1,1,5,0,0,4,4,1,0
6480bb9cff4ec2f71cdf18d1,2009/10,,,2,RS Bopara,SE Marsh,5,8,1,0,1,1,4,0,0,4,4,1,0
6480bb9eda28fb340ed37b49,2012,,,1,JP Duminy,S Dhawan,5,9,0,0,1,2,2,0,0,3,7,0,0
6480bb9df46e9f48932124df,2009/10,,,2,KD Karthik,PD Collingwood,5,8,0,0,1,3,3,0,0,2,5,0,0
6480bb9fc3369c6f5a549d05,2013,,,2,DJ Bravo,MEK Hussey,5,3,0,0,1,3,2,0,0,0,1,0,0
6480bba1d3370c13ea1f79f3,2014,,,2,JP Duminy,KD Karthik,5,6,0,0,1,4,4,0,0,1,2,0,0
6480bba01a3f8444c7a33ba6,2014,,,1,JP Faulkner,R Bhatia,5,3,1,0,1,4,2,1,0,1,1,0,0
6480bba286cca051953c976a,2015,,,2,GJ Bailey,M Vijay,5,8,0,0,1,1,3,0,0,3,5,0,0
6480bb966c197bad273f91f1,2020/21,,,2,JC Buttler,SV Samson,5,7,1,0,1,5,4,1,0,0,3,0,0
6480bb9eeeaf037e5e41ab86,2012,,,2,Harmeet Singh,JP Faulkner,5,3,0,0,0,1,1,0,0,4,2,0,0
6480bba11eff9b230a172302,2014,,,1,PP Chawla,Shakib Al Hasan,5,3,1,0,1,0,1,0,0,5,2,1,0
6480bb9d182be5b0fbe5a4e2,2011,,,1,AL Menaria,LRPL Taylor,5,5,1,0,0,4,4,1,0,1,1,0,0
6480bb9873e53eace3a69dc7,2022,,,1,HH Pandya,R Tewatia,5,6,0,0,1,0,1,0,0,4,5,0,0
6480bba2f36e449a59f4a812,2015,,,1,KM Jadhav,S Nadeem,5,9,0,0,1,2,2,0,0,2,7,0,0
6480bb954817ed0a4ba25bc2,2018,,,2,AR Patel,Yuvraj Singh,5,6,0,0,1,2,3,0,0,1,3,0,0
6480bb9e88141830a7a309b5,2011,,,2,MK Tiwary,YK Pathan,5,13,0,0,1,2,5,0,0,3,8,0,0
6480bb950c59218964b27cc0,2018,,,2,KK Nair,KL Rahul,5,8,0,0,1,3,5,0,0,2,3,0,0
6480bb9929c7e430acd1ef18,2022,,,1,DJ Bravo,MS Dhoni,5,3,0,0,0,1,1,0,0,4,2,0,0
6480bb9b1fc007965b68d4d9,2009,,,1,DB Ravi Teja,PP Ojha,5,4,0,0,1,0,2,0,0,0,2,0,0
6480bb99f816e64203e3c687,2023,,,2,RK Singh,VR Iyer,5,5,0,0,1,4,4,0,0,1,1,0,0
6480bb955f4b3a84d6973620,2018,,,1,GJ Maxwell,LE Plunkett,5,5,0,0,1,4,3,0,0,1,2,0,0
6480bb94dcc956fa4ca06b92,2018,,,2,CA Lynn,Shubman Gill,5,2,1,0,0,0,0,0,0,5,2,1,0
6480bb9a77f349a0fd8d96d6,2023,,,2,SV Samson,YBK Jaiswal,5,6,0,0,1,2,3,0,0,3,3,0,0
6480bb9623a26d3fbfe59f25,2020/21,,,2,UT Yadav,Washington Sundar,5,6,0,0,1,0,2,0,0,5,4,0,0
6480bb989bf19eb260a04f0e,2022,,,1,AD Russell,Aman Hakim Khan,5,4,1,0,1,0,1,0,0,5,3,1,0
6480bba119569fcc2d7859a4,2014,,,2,CH Gayle,PA Patel,5,5,1,0,1,0,1,0,0,4,4,1,0
6480bb9d66dc7da0d45e453c,2011,,,1,EJG Morgan,JH Kallis,5,7,1,0,1,4,3,1,0,1,4,0,0
6480bb977453ebef15f59e25,2021,,,1,EJG Morgan,Shubman Gill,5,5,0,0,1,0,2,0,0,4,3,0,0
6480bba1d21281c7385d5ce4,2014,,,2,L Balaji,MG Johnson,5,2,1,0,0,1,1,0,0,4,1,1,0
6480bb95a09b947e0837a38a,2019,,,2,KA Pollard,KH Pandya,5,3,0,0,1,1,1,0,0,1,2,0,0
6480bb94a964c10b5f10ae52,2017,,,2,EJG Morgan,WP Saha,5,6,1,0,1,4,4,1,0,1,2,0,0
6480bb9e59fe7a0f48b7f9b9,2012,,,1,M Morkel,NV Ojha,5,5,0,0,0,1,1,0,0,4,4,0,0
6480bb9ac9149c73fdf073b3,2023,,,2,DA Warner,PP Shaw,5,9,1,0,1,0,2,0,0,5,7,1,0
6480bba38056992b92414bab,2016,,,2,BB Sran,KV Sharma,5,5,0,0,0,2,2,0,0,3,3,0,0
6480bb9359a2cade3b5213d3,2017,,,1,AB de Villiers,KM Jadhav,5,5,0,0,1,1,2,0,0,3,3,0,0
6480bb9c761c43b2dfb9767d,2009,,,1,S Sohal,SM Katich,5,8,1,0,1,4,6,1,0,0,2,0,0
6480bba1d21281c7385d5ce4,2014,,,2,AR Patel,MG Johnson,5,9,0,0,1,2,3,0,0,2,6,0,0
6480bb9f00ef088221497043,2013,,,1,MK Tiwary,YK Pathan,5,2,1,0,1,0,0,0,0,5,2,1,0
6480bba2ab35be3ffcfa932a,2016,,,2,DJ Hooda,MC Henriques,5,6,1,0,1,1,2,0,0,4,4,1,0
6480bba1a6882d256a926a8b,2014,,,2,KP Pietersen,MK Tiwary,5,5,0,0,1,1,3,0,0,3,2,0,0
6480bb9c89e2e8ecb04f94cb,2009/10,,,1,TL Suman,Y Venugopal Rao,5,5,0,0,1,4,3,0,0,1,2,0,0
6480bb9ca5c1d511ad78e92d,2009,,,2,KD Karthik,MF Maharoof,5,6,0,0,1,3,4,0,0,2,2,0,0
6480bb961570df6942a00888,2019,,,1,DA Warner,JM Bairstow,5,9,0,0,1,4,7,0,0,0,2,0,0
6480bb99e909d98c8193bac5,2023,,,2,MA Agarwal,Washington Sundar,5,8,0,0,1,3,3,0,0,1,5,0,0
6480bb97f56e9d700b27a098,2021,,,2,PP Shaw,SPD Smith,5,6,1,0,1,1,1,0,0,4,5,1,0
6480bb98a95cb1650c81c926,2022,,,2,HV Patel,Mohammed Siraj,5,6,1,0,1,0,1,0,0,5,5,1,0
6480bb9eb2690fb1ed356b42,2011,,,2,B Chipli,JP Duminy,5,4,1,0,1,1,2,0,0,4,2,1,0
6480bba0f401cc6b6bc6ed10,2013,,,2,DW Steyn,KV Sharma,5,3,0,0,0,4,2,0,0,1,1,0,0
6480bb931e6d2b03141b586d,2017,,,2,C de Grandhomme,G Gambhir,5,5,0,0,1,1,2,0,0,4,3,0,0
6480bba3b830360cf7031278,2016,,,1,PA Patel,RG Sharma,5,6,1,0,1,0,4,0,0,5,2,1,0
6480bb9e95693a2c4c4531e8,2011,,,2,JR Hopes,TR Birt,5,5,1,0,1,5,5,1,0,0,0,0,0
6480bb948211fe47e65f2e77,2018,,,2,Ishan Kishan,SA Yadav,5,7,1,0,1,0,3,0,0,5,4,1,0
6480bba2b341a081c069198d,2015,,,1,AB de Villiers,V Kohli,5,9,0,0,1,1,1,0,0,4,8,0,0
6480bb9f7bae5ad85c4473ba,2012,,,2,M Vijay,SK Raina,5,8,1,0,1,5,8,1,0,0,0,0,0
6480bb9a0a8baa96f94e8db9,2023,,,2,A Mishra,KL Rahul,5,8,1,0,1,4,5,1,0,0,3,0,0
6480bb9d7aa8d2c4c947d164,2009/10,,,1,JH Kallis,LRPL Taylor,5,3,1,0,1,4,1,1,0,1,2,0,0
6480bb9c3803ef7726af83ab,2009/10,,,1,S Anirudha,S Badrinath,5,1,1,0,0,0,0,0,0,4,1,1,0
6480bb9affabe4960a987464,2007/08,,,1,V Kohli,W Jaffer,5,7,0,0,1,1,5,0,0,0,2,0,0
6480bb9498a98d52f9285b52,2017,,,2,MS Dhoni,Washington Sundar,5,3,1,0,1,4,2,1,0,1,1,0,0
6480bb9f302200e3bc89464e,2012,,,1,CL White,JP Duminy,5,6,0,0,1,1,4,0,0,1,2,0,0
6480bb954714437843ab3647,2019,,,2,DA Warner,V Shankar,5,6,0,0,1,4,5,0,0,1,1,0,0
6480bb99e520ec7a66b73adb,2022,,,2,DR Sams,Ramandeep Singh,5,3,1,0,0,0,1,0,0,4,2,1,0
6480bb9837deb0fb66704166,2022,,,1,R Powell,RR Pant,5,12,0,0,1,1,5,0,0,3,7,0,0
6480bb970d7cbd85b6ada680,2021,,,2,DR Sams,Shahbaz Ahmed,5,6,0,0,1,3,3,0,0,2,3,0,0
6480bb969d80bbba2884b855,2020/21,,,1,JR Philippe,Washington Sundar,5,4,0,0,1,0,4,0,0,0,0,0,0
6480bb96e76ccde6082d7564,2020/21,,,1,AD Russell,KD Karthik,5,3,1,0,1,5,3,1,0,0,0,0,0
6480bb976344f6d667dfd965,2021,,,1,Avesh Khan,K Rabada,5,4,1,0,1,5,3,1,0,0,1,0,0
6480bba296f606ef91305124,2016,,,1,DA Warner,MC Henriques,5,4,1,0,1,4,2,1,0,0,2,0,0
6480bb9d867c041656e9a75f,2009/10,,,2,B Sumanth,MR Marsh,5,9,0,0,1,1,4,0,0,4,5,0,0
6480bba3d3dc891a3092643e,2016,,,2,M Vijay,WP Saha,5,6,0,0,1,2,2,0,0,3,4,0,0
6480bb9d5cca30c933d4baf4,2011,,,1,PP Chawla,Sunny Singh,5,5,1,0,1,4,3,1,0,0,2,0,0
6480bba1743abcb135a6a4c7,2015,,,1,Anureet Singh,Karanveer Singh,5,6,1,0,0,0,2,0,0,5,4,1,0
6480bba373508e4f3f4be6c0,2016,,,1,G Gambhir,RV Uthappa,5,1,1,0,1,0,0,0,0,4,1,1,0
6480bb9aa37f3b44678752d9,2023,,,1,Ishan Kishan,SA Yadav,5,4,1,0,1,0,1,0,0,5,3,1,0
6480bb9c0dec1a788da66d33,2009/10,,,2,KB Arun Karthik,T Thushara,5,7,0,0,0,2,4,0,0,2,3,0,0
6480bb9d40fc01528c7b7270,2009/10,,,1,AA Jhunjhunwala,YK Pathan,5,9,0,0,1,1,3,0,0,3,6,0,0
6480bb96ee2a21f0d9b9f37f,2020/21,,,2,EJG Morgan,PJ Cummins,5,4,1,0,1,0,0,0,0,5,4,1,0
6480bba1cef79f12933bbf27,2014,,,2,S Dhawan,Y Venugopal Rao,5,2,1,0,0,1,1,0,0,4,1,1,0
6480bb9fe31a789bcb52d583,2012,,,1,JD Ryder,SC Ganguly,5,10,0,0,1,0,4,0,0,4,6,0,0
6480bb9d97cceb6330e84df0,2011,,,1,IK Pathan,RE van der Merwe,5,6,0,0,0,3,3,0,0,2,3,0,0
6480bba069c0322e91e50958,2013,,,1,GH Vihari,NLTC Perera,5,7,0,0,1,2,3,0,0,2,4,0,0
6480bb9d3ab782f83ce3e381,2011,,,2,G Gambhir,YK Pathan,5,4,1,0,1,4,2,1,0,1,2,0,0
6480bb99c6aa5989a16174d1,2023,,,1,DJ Willey,Mohammed Siraj,5,3,1,0,0,4,2,1,0,1,1,0,0
6480bb9480627b50308b7903,2017,,,2,KA Pollard,PA Patel,5,4,1,0,1,5,3,1,0,0,1,0,0
6480bb9bca2c11520f5b3b9e,2007/08,,,2,DPMD Jayawardene,WA Mota,5,9,1,0,1,4,6,1,0,1,3,0,0
6480bb9ef18c54e7aafdd223,2012,,,2,Mandeep Singh,SE Marsh,5,9,0,0,1,1,3,0,0,1,6,0,0
6480bb94b9d954a885cc531b,2017,,,2,DT Christian,Washington Sundar,5,3,0,0,1,4,2,0,0,0,1,0,0
6480bba2ad3f26917361061f,2016,,,1,KM Jadhav,V Kohli,5,8,0,0,1,2,4,0,0,3,4,0,0
6480bb9d0f6794fbf429449b,2011,,,2,RR Powar,RV Gomez,5,8,0,0,0,3,6,0,0,0,2,0,0
6480bba38ce35716815a1845,2016,,,1,AD Russell,YK Pathan,5,3,0,0,1,0,0,0,0,1,3,0,0
6480bb99fa79383bdc7df827,2022,,,2,HV Patel,Mohammed Siraj,5,9,0,0,1,2,3,0,0,3,6,0,0
6480bb9a87f64c1a12f62ece,2007/08,,,1,MEK Hussey,ML Hayden,5,9,1,0,1,5,9,1,0,0,0,0,0
6480bb953b102c650968cba2,2019,,,1,C de Grandhomme,PA Patel,5,7,1,0,1,4,6,1,0,1,1,0,0
6480bb9affabe4960a987464,2007/08,,,1,AA Noffke,CL White,5,4,0,0,1,1,2,0,0,2,2,0,0
6480bb96e18d7a1b3e62552d,2019,,,2,M Ashwin,P Simran Singh,5,5,1,0,1,0,0,0,0,5,5,1,0
6480bb94988cb8c136ec7e46,2018,,,1,AJ Tye,KK Nair,5,5,0,0,1,1,2,0,0,4,3,0,0
6480bb9a807eb5f39489408a,2023,,,2,MK Pandey,MR Marsh,5,4,1,0,1,1,2,0,0,4,2,1,0
6480bb9371e90dbd44ee19a3,2017,,,2,HM Amla,M Vohra,5,10,0,0,1,2,4,0,0,3,6,0,0
6480bb9cba868c69775db687,2009,,,1,MK Pandey,RE van der Merwe,5,7,0,0,1,3,2,0,0,2,5,0,0
6480bb94dfad571ef76493a9,2017,,,1,MN Samuels,PJ Cummins,5,11,0,0,1,1,3,0,0,4,8,0,0
6480bba2b341a081c069198d,2015,,,2,DJ Hooda,JP Faulkner,5,4,1,0,1,0,0,0,0,4,4,1,0
6480bb98de3641699db2c5a1,2021,,,2,R Ashwin,S Dhawan,5,8,0,0,1,2,3,0,0,3,5,0,0
6480bb98cbaaf700d226941a,2022,,,2,JJ Bumrah,KA Pollard,5,7,1,0,1,0,1,0,0,4,6,1,0
6480bb9baccf501985a56d64,2007/08,,,2,G Gambhir,S Dhawan,5,6,0,0,1,2,3,0,0,3,3,0,0
6480bba19cc161a3fb8a8795,2014,,,1,GJ Maxwell,M Vohra,5,8,0,0,1,2,2,0,0,3,6,0,0
6480bb95c28e7980e1768064,2018,,,2,AM Rahane,JC Buttler,5,4,1,0,1,4,3,1,0,1,1,0,0
6480bb9c266a85f1960d87e9,2009,,,1,M Manhas,TM Dilshan,5,11,0,0,1,3,6,0,0,2,5,0,0
6480bba15f6842352b6338ae,2014,,,2,BB McCullum,DR Smith,5,8,1,0,1,0,2,0,0,5,6,1,0
6480bb9cd6fe6fad0d6efbd9,2009/10,,,1,AA Jhunjhunwala,AD Mascarenhas,5,5,0,0,1,2,2,0,0,3,3,0,0
6480bb9a596c087c0396ec2e,2007/08,,,2,B Akhil,MV Boucher,5,6,0,0,0,3,5,0,0,1,1,0,0
6480bb9f1faffe780b407e67,2013,,,1,AD Mathews,LRPL Taylor,5,6,1,0,1,4,4,1,0,1,2,0,0
6480bb97372fc5d5ef4c436a,2021,,,1,PP Shaw,S Dhawan,5,12,0,0,1,2,5,0,0,3,7,0,0
6480bb9cafc843037dc1e863,2009,,,2,SR Tendulkar,ST Jayasuriya,5,9,1,0,1,0,3,0,0,4,6,1,0
6480bba255079696d5cfa453,2015,,,2,AR Patel,GJ Bailey,5,7,1,0,1,4,4,1,0,1,3,0,0
6480bb9ddfb0f2f6f8e813e5,2011,,,1,BB McCullum,PA Patel,5,1,0,0,1,0,1,0,0,0,0,0,0
6480bb9873e53eace3a69dc7,2022,,,2,SP Narine,SW Billings,5,4,1,0,1,0,0,0,0,4,4,1,0
6480bb9ded279701c84af803,2011,,,1,MS Dhoni,S Badrinath,5,3,1,0,1,0,1,0,0,5,2,1,0
6480bb99349f00f851e8d2fd,2023,,,1,Harpreet Brar,M Shahrukh Khan,5,2,1,0,1,5,2,1,0,0,0,0,0
6480bb9c761c43b2dfb9767d,2009,,,2,DJ Bravo,ST Jayasuriya,5,13,1,0,1,0,6,0,0,4,7,1,0
6480bb967d799ced7fe5d8e9,2020/21,,,1,M Ashwin,N Pooran,5,5,0,0,1,4,4,0,0,1,1,0,0
6480bb99a620a7afdb3217fe,2023,,,1,JC Buttler,SV Samson,5,8,0,0,1,5,4,0,0,0,4,0,0
6480bb9ae4498012aa089436,2023,,,1,AT Rayudu,DP Conway,5,9,0,0,1,3,5,0,0,2,4,0,0
6480bb9eb559e2934b31c47c,2012,,,1,DJ Bravo,JA Morkel,5,9,0,0,1,2,5,0,0,2,4,0,0
6480bba3fc9599eca1b87a77,2016,,,2,AJ Finch,DS Kulkarni,5,4,0,0,1,1,1,0,0,2,3,0,0
6480bb9c37b72d7a51019794,2009/10,,,2,AP Dole,M Morkel,5,5,1,0,1,4,4,1,0,1,1,0,0
6480bb98e87e6f83b61088ea,2022,,,1,M Shahrukh Khan,OF Smith,5,5,0,0,1,2,2,0,0,2,3,0,0
6480bb9d0f6794fbf429449b,2011,,,2,RA Jadeja,RV Gomez,5,4,1,0,1,4,4,1,0,0,0,0,0
6480bb9f777b7b1e89543a6e,2013,,,2,KA Pollard,KD Karthik,5,10,0,0,1,1,7,0,0,4,3,0,0
6480bb9ce544a2fc17a48bee,2009,,,1,JD Ryder,RV Uthappa,5,6,0,0,1,1,3,0,0,3,3,0,0
6480bb971c9e4a3ef11759f3,2021,,,2,N Rana,Shubman Gill,5,4,1,0,1,0,1,0,0,5,3,1,0
6480bb981dc3f7250f93bc92,2022,,,2,DA Warner,PP Shaw,5,8,1,0,1,0,1,0,0,5,7,1,0
6480bb9f0f1f6c03d8e2f039,2013,,,2,PA Patel,Q de Kock,5,12,0,0,1,2,4,0,0,2,8,0,0
6480bb9ec90f99c5ea40b014,2012,,,2,BJ Hodge,OA Shah,5,9,0,0,1,2,5,0,0,1,4,0,0
6480bb9be2940d96c1f903ca,2007/08,,,1,MS Dhoni,SP Fleming,5,11,0,0,1,4,8,0,0,1,3,0,0
6480bb9552e25b3867e5c38a,2019,,,1,SA Yadav,Yuvraj Singh,5,8,0,0,1,1,2,0,0,4,6,0,0
6480bba01a3f8444c7a33ba6,2014,,,1,R Bhatia,TG Southee,5,5,1,0,1,1,1,0,0,4,4,1,0
6480bb9a0a8baa96f94e8db9,2023,,,1,JR Hazlewood,PWH de Silva,5,3,1,0,0,1,2,0,0,4,1,1,0
6480bb9740aaba2132c0eb0e,2021,,,2,KA Jamieson,Navdeep Saini,5,7,0,0,1,2,3,0,0,2,4,0,0
6480bb95d4da0397e79acffa,2019,,,1,KD Karthik,RV Uthappa,5,2,1,0,0,1,1,0,0,4,1,1,0
6480bb97f2f0fabec8f94d86,2020/21,,,1,KD Karthik,RA Tripathi,5,4,0,0,0,1,2,0,0,3,2,0,0
6480bb9c89f35f11aae1f2d0,2009/10,,,2,AC Voges,P Dogra,5,13,0,0,1,3,4,0,0,2,9,0,0
6480bb9bc80883a975281815,2009,,,2,GC Smith,NK Patel,5,13,0,0,1,1,8,0,0,1,5,0,0
6480bb98436587de59527f2e,2022,,,1,Ishan Kishan,KA Pollard,5,9,0,0,1,2,3,0,0,3,6,0,0
6480bb952f20835ddd6e533f,2019,,,2,JC Archer,K Gowtham,5,5,0,0,1,2,2,0,0,3,3,0,0
6480bb9c12e6c723b248799b,2009,,,2,HH Gibbs,Y Venugopal Rao,5,4,1,0,1,5,2,1,0,0,2,0,0
6480bb9fcbbfd8053f253537,2012,,,1,IK Pathan,LRPL Taylor,5,10,0,0,1,2,4,0,0,3,6,0,0
6480bb9d80e97e178e5f68de,2011,,,1,M Vijay,S Anirudha,5,6,1,0,1,4,4,1,0,1,2,0,0
6480bb99cf7659c6e45bd01d,2023,,,1,H Klaasen,MA Agarwal,5,6,0,0,1,3,2,0,0,2,4,0,0
6480bb9f4780a208e13bfb3d,2013,,,2,A Chandila,SK Trivedi,5,9,0,0,1,2,3,0,0,3,6,0,0
6480bb98dd9a2108c79e1014,2022,,,1,K Rabada,M Shahrukh Khan,5,9,0,0,1,2,6,0,0,3,3,0,0
6480bba1a6882d256a926a8b,2014,,,2,Imran Tahir,MK Tiwary,5,8,1,0,1,4,6,1,0,1,2,0,0
6480bba01a3f8444c7a33ba6,2014,,,2,F du Plessis,SK Raina,5,6,0,0,1,3,3,0,0,2,3,0,0
6480bba18a2fe828fa106f6c,2014,,,1,Ankit Sharma,KK Nair,5,5,0,0,1,4,3,0,0,0,2,0,0
6480bb97aed297ca9686c94a,2021,,,1,Mohammed Shami,RP Meredith,5,5,0,0,0,5,5,0,0,0,0,0,0
6480bba3aa840e4e9450a200,2016,,,2,CH Gayle,V Kohli,5,7,1,0,1,1,4,0,0,4,3,1,0
6480bb9d05f8e769574069fa,2009/10,,,2,AB Agarkar,BAW Mendis,5,3,0,0,0,3,2,0,0,1,1,0,0
6480bb9f87652064dab6c573,2013,,,1,P Awana,PP Chawla,5,2,1,0,0,0,0,0,0,4,2,1,0
6480bba29fb420d92aef1d2a,2015,,,1,AD Russell,MK Pandey,5,6,0,0,1,1,3,0,0,4,3,0,0
6480bb998454ba791a8fdbf8,2023,,,1,DA Warner,YV Dhull,5,8,0,0,1,3,4,0,0,2,4,0,0
6480bb9e2c96ab2b87d9466a,2011,,,2,AB Agarkar,IK Pathan,5,6,0,0,1,2,3,0,0,1,3,0,0
6480bb96267b63eb2c6747b0,2019,,,2,H Klaasen,S Dube,5,5,0,0,1,3,3,0,0,2,2,0,0
6480bb9f36ad55c3c7fd6548,2012,,,2,DB Das,YK Pathan,5,9,0,0,1,2,3,0,0,3,6,0,0
6480bb9f146f5849bb759148,2013,,,2,MK Pandey,Yuvraj Singh,5,8,0,0,1,3,3,0,0,2,5,0,0
6480bb9651b51fdcda05e4c8,2020/21,,,2,SPD Smith,SV Samson,5,5,1,0,1,4,4,1,0,1,1,0,0
6480bb9e591b94e62772e66a,2012,,,2,Harbhajan Singh,RJ Peterson,5,6,0,0,1,3,4,0,0,2,2,0,0
6480bb984a44a355b856fd1a,2022,,,1,Anuj Rawat,F du Plessis,5,8,1,0,1,0,1,0,0,5,7,1,0
6480bba04b49d2ff5f997e02,2013,,,1,AD Mathews,RV Gomez,5,2,1,0,0,1,1,0,0,4,1,1,0
6480bb954e496ec9b12aa120,2019,,,2,F du Plessis,SK Raina,5,7,1,0,1,1,3,0,0,4,4,1,0
6480bb99433f6e11060ba714,2022,,,1,AR Patel,SN Thakur,5,7,0,0,1,2,3,0,0,3,4,0,0
6480bb950c59218964b27cc0,2018,,,1,JD Unadkat,MK Lomror,5,3,1,0,1,0,1,0,0,5,2,1,0
6480bb98e87e6f83b61088ea,2022,,,2,CJ Jordan,Mukesh Choudhary,5,5,0,0,1,3,3,0,0,2,2,0,0
6480bb998454ba791a8fdbf8,2023,,,1,DA Warner,R Powell,5,5,1,0,1,1,1,0,0,4,4,1,0
6480bb9eae43aed76989151b,2011,,,1,AB de Villiers,SS Tiwary,5,7,0,0,1,2,2,0,0,1,5,0,0
6480bb96c95abb10156a6055,2020/21,,,2,M Vijay,SR Watson,5,6,1,0,1,1,1,0,0,4,5,1,0
6480bb9b1fc007965b68d4d9,2009,,,1,DB Ravi Teja,RP Singh,5,6,0,0,1,1,2,0,0,4,4,0,0
6480bba28724848c0f3ef034,2015,,,1,AT Rayudu,RG Sharma,5,5,0,0,1,2,3,0,0,2,2,0,0
6480bba1b8e3071cc513602a,2014,,,2,B Kumar,IK Pathan,5,2,1,0,0,0,1,0,0,4,1,1,0
6480bb9b17739118ee6c3bd0,2007/08,,,1,I Sharma,WP Saha,5,3,0,0,0,2,1,0,0,3,2,0,0
6480bb9c50838010977c168c,2009,,,1,L Balaji,T Thushara,5,10,0,0,1,2,5,0,0,1,5,0,0
6480bba1d3b4ddc36050e3f3,2014,,,1,AR Patel,GJ Bailey,5,7,0,0,1,2,2,0,0,3,5,0,0
6480bb9a1e358307d26cd50d,2023,,,2,N Wadhera,RG Sharma,5,5,1,0,1,4,3,1,0,1,2,0,0
6480bba1603d86b7d278a366,2015,,,2,A Nehra,RG More,5,5,0,0,0,1,3,0,0,2,2,0,0
6480bb9a807eb5f39489408a,2023,,,2,RR Rossouw,RV Patel,5,9,0,0,1,2,5,0,0,2,4,0,0
6480bb94aa9b082aa58a3822,2017,,,2,CJ Anderson,RR Pant,5,9,0,0,1,3,7,0,0,1,2,0,0
6480bb9f895e5780080c8059,2012,,,1,AC Gilchrist,Mandeep Singh,5,7,0,0,1,0,6,0,0,0,1,0,0
6480bb9f70156528a31bb270,2013,,,1,CH Gayle,KK Nair,5,6,1,0,1,5,3,1,0,0,3,0,0
6480bba0ffae8617ee64bd19,2013,,,1,MS Dhoni,SK Raina,5,8,0,0,1,2,4,0,0,3,4,0,0
6480bba1603d86b7d278a366,2015,,,2,DJ Bravo,F du Plessis,5,4,1,0,1,1,1,0,0,4,3,1,0
6480bb9eda28fb340ed37b49,2012,,,1,A Mishra,JP Duminy,5,4,0,0,0,1,1,0,0,4,3,0,0
6480bb9651b51fdcda05e4c8,2020/21,,,2,JC Buttler,R Parag,5,9,1,0,1,5,2,1,0,0,7,0,0
6480bb98cbaaf700d226941a,2022,,,1,R Parag,TA Boult,5,3,1,0,1,4,2,1,0,1,1,0,0
6480bb9aa37f3b44678752d9,2023,,,2,HH Pandya,Shubman Gill,5,4,1,0,1,4,3,1,0,1,1,0,0
6480bb9ed74d222a3da56dfa,2012,,,1,AB de Villiers,SS Tiwary,5,9,0,0,1,4,6,0,0,1,3,0,0
6480bb9e335bec070f88430f,2011,,,2,S Badrinath,WP Saha,5,9,1,0,1,0,7,0,0,5,2,1,0
6480bb9d1ed71a4f47892d00,2009/10,,,2,AJ Finch,YK Pathan,5,10,0,0,1,3,5,0,0,2,5,0,0
6480bb99af95c6c90c4c3924,2023,,,2,Abdul Samad,MA Agarwal,5,5,0,0,1,1,1,0,0,2,4,0,0
6480bb9f210b6e50fb2072ae,2013,,,2,PJ Sangwan,SP Narine,5,3,1,0,0,4,2,1,0,1,1,0,0
6480bb9d5cca30c933d4baf4,2011,,,1,R McLaren,SE Marsh,5,8,0,0,1,0,4,0,0,3,4,0,0
6480bb984f0f3dc0df6d4531,2022,,,2,HH Pandya,WP Saha,5,5,0,0,1,2,2,0,0,3,3,0,0
6480bba2f36e449a59f4a812,2015,,,1,KM Jadhav,NM Coulter-Nile,5,9,1,0,1,1,1,0,0,4,8,1,0
6480bb9bed3e2a1a008f93a6,2007/08,,,2,DJ Hussey,SC Ganguly,5,8,0,0,1,2,7,0,0,1,1,0,0
6480bb98af25209ef756aa2c,2021,,,2,AF Milne,JJ Bumrah,5,6,1,0,1,0,0,0,0,5,6,1,0
6480bba1ff89cb428182daa6,2014,,,1,GJ Maxwell,V Sehwag,5,5,1,0,1,1,1,0,0,4,4,1,0
6480bba1c67d2c9c1279a4c8,2014,,,2,IK Pathan,KV Sharma,5,2,1,0,0,4,1,1,0,1,1,0,0
6480bb94fbd0b904d63e0e07,2017,,,1,GJ Maxwell,SE Marsh,5,7,1,0,1,0,2,0,0,5,5,1,0
6480bb95b98d000799e11963,2018,,,2,DJ Hooda,MK Pandey,5,5,0,0,0,1,1,0,0,3,4,0,0
6480bb9df60a79ae5f20b748,2011,,,1,AB Dinda,RE van der Merwe,5,7,1,0,1,0,5,0,0,5,2,1,0
6480bb9ab49fc97bbb30576f,2023,,,1,MK Lomror,V Kohli,5,5,0,0,1,1,3,0,0,2,2,0,0
6480bb951677500061c85592,2019,,,2,S Kaul,Sandeep Sharma,5,3,1,0,1,0,1,0,0,5,2,1,0
6480bb9efe3f9991539e7f6c,2012,,,2,A Nehra,AB Dinda,5,8,0,0,1,1,3,0,0,2,5,0,0
6480bb9525ace33768e8b671,2019,,,2,JM Bairstow,KS Williamson,5,8,0,0,1,2,3,0,0,3,5,0,0
6480bb94cfe5aeb50e36aef3,2017,,,2,DA Warner,MC Henriques,5,5,1,0,1,1,3,0,0,4,2,1,0
6480bb9f231505ffc493730f,2012,,,1,DJ Bravo,MS Dhoni,5,3,1,0,1,0,0,0,0,5,3,1,0
6480bba1587a54176a9badf4,2014,,,2,KV Sharma,Parvez Rasool,5,2,1,0,0,5,2,1,0,0,0,0,0
6480bba2e680f2464af841ae,2015,,,1,JP Duminy,Yuvraj Singh,5,10,0,0,1,3,3,0,0,2,7,0,0
6480bb9c2f07203e8e510386,2009/10,,,1,RS Bopara,Yuvraj Singh,5,5,1,0,1,0,0,0,0,4,5,1,0
6480bb9e95693a2c4c4531e8,2011,,,2,S Sriram,Y Venugopal Rao,5,9,0,0,1,4,7,0,0,1,2,0,0
6480bba2c3207713bd927ce5,2015,,,2,DA Miller,WP Saha,5,9,0,0,1,3,5,0,0,1,4,0,0
6480bb9552e25b3867e5c38a,2019,,,2,SK Raina,SR Watson,5,5,1,0,1,0,2,0,0,4,3,1,0
6480bb9a365c63af4b3de24c,2023,,,2,Kuldeep Yadav,P Dubey,5,10,0,0,1,4,8,0,0,1,2,0,0
6480bb99358a21ba3487db81,2023,,,1,HC Brook,RA Tripathi,5,6,0,0,1,3,4,0,0,2,2,0,0
6480bba0c63a6317296391b7,2013,,,2,AM Rahane,R Dravid,5,5,1,0,1,0,0,0,0,4,5,1,0
6480bb96c0ffb76dab723a2b,2019,,,2,AT Rayudu,DJ Bravo,5,2,0,0,0,1,1,0,0,0,1,0,0
6480bb9ade063258af41163b,2007/08,,,1,SC Ganguly,WP Saha,5,13,0,0,1,1,3,0,0,3,10,0,0
6480bb94aa9b082aa58a3822,2017,,,2,A Mishra,Mohammed Shami,5,9,0,0,1,2,5,0,0,2,4,0,0
6480bb94640655c49683aee1,2018,,,1,HH Pandya,KA Pollard,5,3,1,0,1,4,2,1,0,1,1,0,0
6480bba3ebbd8e4867dfa673,2016,,,1,J Yadav,P Negi,5,5,0,0,1,1,3,0,0,2,2,0,0
6480bba1587a54176a9badf4,2014,,,2,DA Warner,S Dhawan,5,2,1,0,1,4,2,1,0,0,0,0,0
6480bb9d362f72789dcdc5a7,2009/10,,,1,L Balaji,S Badrinath,5,12,0,0,1,3,8,0,0,2,4,0,0
6480bb9a365c63af4b3de24c,2023,,,2,DA Warner,MR Marsh,5,6,0,0,1,2,2,0,0,3,4,0,0
6480bba0c3cc8c51bc6c1c3a,2013,,,1,BJ Hodge,STR Binny,5,5,0,0,1,3,3,0,0,2,2,0,0
6480bb96d1b3bea0aa2127e4,2020/21,,,2,Kuldeep Yadav,Shivam Mavi,5,10,0,0,1,1,2,0,0,4,8,0,0
6480bb9d967f5a4cfbd8c74d,2011,,,2,B Lee,MK Tiwary,5,5,0,0,1,1,1,0,0,4,4,0,0
6480bba1d3b4ddc36050e3f3,2014,,,1,M Vohra,V Sehwag,5,7,0,0,1,2,4,0,0,2,3,0,0
6480bb9bed3e2a1a008f93a6,2007/08,,,2,AB Agarkar,Shoaib Akhtar,5,6,0,0,1,3,3,0,0,1,3,0,0
6480bb9623a26d3fbfe59f25,2020/21,,,2,DW Steyn,Navdeep Saini,5,6,1,0,1,0,1,0,0,5,5,1,0
6480bb9b62eb35d78fcd7df0,2007/08,,,2,GD McGrath,VY Mahesh,5,2,0,0,1,0,0,0,0,0,2,0,0
6480bb990b96e91d3fbf421b,2022,,,1,KD Karthik,Shahbaz Ahmed,5,3,1,0,1,0,1,0,0,4,2,1,0
6480bb9d105fba311a23a588,2011,,,1,RA Jadeja,RV Gomez,5,4,1,0,1,5,3,1,0,0,1,0,0
6480bb932f8447acd7840076,2017,,,2,AJ Finch,SK Raina,5,6,0,0,1,3,5,0,0,1,1,0,0
6480bb98b00f767943bb8415,2022,,,2,PP Shaw,SN Khan,5,4,1,0,1,4,1,1,0,1,3,0,0
6480bba2ebdcfb98389cee5a,2015,,,2,MS Dhoni,P Negi,5,4,1,0,1,5,3,1,0,0,1,0,0
6480bb979e8cc2484c1a8c7b,2020/21,,,1,SA Yadav,SS Tiwary,5,10,0,0,1,1,2,0,0,4,8,0,0
6480bb9c620c92d09ba1b6b9,2009,,,2,GC Smith,SA Asnodkar,5,7,1,0,1,1,3,0,0,4,4,1,0
6480bb9a6935abf34d88ca97,2007/08,,,2,MEK Hussey,MS Dhoni,5,5,0,0,1,3,2,0,0,2,3,0,0
6480bb96c95abb10156a6055,2020/21,,,1,JL Pattinson,RD Chahar,5,4,1,0,1,4,3,1,0,1,1,0,0
6480bb9fc524f8142f0b3461,2012,,,1,MJ Clarke,RV Uthappa,5,3,0,0,1,5,2,0,0,0,1,0,0
6480bb9d3ab782f83ce3e381,2011,,,2,MV Boucher,YK Pathan,5,2,1,0,0,0,0,0,0,4,2,1,0
6480bba31cc11024436836b5,2016,,,2,Imran Tahir,S Nadeem,5,8,1,0,1,5,7,1,0,0,1,0,0
6480bb96e76ccde6082d7564,2020/21,,,2,KL Rahul,P Simran Singh,5,8,0,0,1,1,1,0,0,4,7,0,0
6480bba04b49d2ff5f997e02,2013,,,1,AD Mathews,Yuvraj Singh,5,9,0,0,1,4,6,0,0,1,3,0,0
6480bb94d8aa9021808a4760,2017,,,2,G Gambhir,RV Uthappa,5,3,1,0,1,4,2,1,0,0,1,0,0
6480bb9d29051b8e40c07d52,2011,,,1,KA Pollard,SR Tendulkar,5,2,1,0,0,0,0,0,0,5,2,1,0
6480bb99433f6e11060ba714,2022,,,1,AR Patel,Kuldeep Yadav,5,3,0,0,0,2,1,0,0,2,2,0,0
6480bba0b5eabeb0a150b93f,2013,,,2,AG Murtaza,M Manhas,5,4,1,0,1,5,4,1,0,0,0,0,0
6480bb966c197bad273f91f1,2020/21,,,2,JC Archer,R Tewatia,5,4,1,0,1,4,1,1,0,1,3,0,0
6480bb974123cbc9756ceefa,2021,,,1,D Padikkal,GJ Maxwell,5,11,0,0,1,2,4,0,0,3,7,0,0
6480bb96acacf3be646d300a,2020/21,,,2,AR Patel,RR Pant,5,8,0,0,1,1,4,0,0,3,4,0,0
6480bb9bed3e2a1a008f93a6,2007/08,,,2,I Sharma,Shoaib Akhtar,5,5,1,0,1,4,5,1,0,0,0,0,0
6480bb9435048f20502ba1e1,2018,,,2,Ishan Kishan,SA Yadav,5,6,1,0,1,0,1,0,0,5,5,1,0
6480bb94457bfc7687322f80,2017,,,1,Mandeep Singh,S Badree,5,5,0,0,1,2,2,0,0,3,3,0,0
6480bb9ca668b7b36823fb21,2009,,,2,AM Nayar,AM Rahane,5,5,0,0,1,4,4,0,0,1,1,0,0
6480bb99fe078839da40e7ab,2023,,,2,DA Warner,PD Salt,5,5,1,0,1,0,2,0,0,5,3,1,0
6480bb94640655c49683aee1,2018,,,1,KA Pollard,SA Yadav,5,6,0,0,1,1,2,0,0,2,4,0,0
6480bb9ca5c1d511ad78e92d,2009,,,2,AB McDonald,KD Karthik,5,6,0,0,1,3,4,0,0,2,2,0,0
6480bb990942cd416cf5f447,2022,,,2,DJ Hooda,KL Rahul,5,8,1,0,1,4,3,1,0,0,5,0,0
6480bba1ff89cb428182daa6,2014,,,2,BB McCullum,DR Smith,5,4,1,0,1,0,0,0,0,4,4,1,0
6480bb9a81d7fd0ac0307b4d,2023,,,2,A Badoni,MP Stoinis,5,8,0,0,1,1,7,0,0,0,1,0,0
6480bba296f606ef91305124,2016,,,2,AD Russell,G Gambhir,5,7,0,0,1,2,5,0,0,3,2,0,0
6480bba0001885407e860a8d,2013,,,2,BMAJ Mendis,KM Jadhav,5,6,0,0,1,2,2,0,0,3,4,0,0
6480bb9c2f07203e8e510386,2009/10,,,1,MS Bisla,RS Bopara,5,8,0,0,1,2,6,0,0,0,2,0,0
6480bb9692a7f0d52bd43127,2019,,,1,AB de Villiers,AD Nath,5,9,0,0,1,2,2,0,0,3,7,0,0
6480bb96e8ba017befb2bc8a,2020/21,,,1,R Ashwin,SO Hetmyer,5,8,1,0,1,0,1,0,0,5,7,1,0
6480bb9737b1d7284b5297c1,2021,,,2,AB de Villiers,GJ Maxwell,5,10,0,0,1,3,5,0,0,2,5,0,0
6480bb94ebff9a116f68560b,2018,,,2,DJ Hooda,KS Williamson,5,9,0,0,1,3,6,0,0,2,3,0,0
6480bb9871b0ff7264721cbc,2022,,,2,B Kumar,S Gopal,5,5,1,0,0,5,3,1,0,0,2,0,0
6480bb9eb35365cccf73d55c,2011,,,1,S Rana,WD Parnell,5,4,0,0,1,3,3,0,0,1,1,0,0
6480bb9ddcbb8fbbad6614c8,2009/10,,,1,M Manhas,R Bhatia,5,10,0,0,1,3,5,0,0,1,5,0,0
6480bb95014388d3e8c62904,2019,,,2,AR Patel,R Tewatia,5,3,1,0,0,4,1,1,0,1,2,0,0
6480bb9873e53eace3a69dc7,2022,,,1,AS Joseph,R Tewatia,5,3,1,0,1,1,1,0,0,4,2,1,0
6480bba38056992b92414bab,2016,,,2,DJ Hooda,KS Williamson,5,4,0,0,1,2,2,0,0,3,2,0,0
6480bb9553f3fc8903579544,2018,,,2,AD Russell,N Rana,5,8,0,0,1,2,4,0,0,3,4,0,0
6480bb9a365c63af4b3de24c,2023,,,2,AR Patel,DA Warner,5,5,1,0,1,1,1,0,0,4,4,1,0
6480bba0295edd6084b9503b,2014,,,1,DA Warner,KL Rahul,5,11,0,0,1,3,5,0,0,2,6,0,0
6480bb9b52b93b56f5a16e52,2007/08,,,1,Mohammad Asif,VY Mahesh,5,13,0,0,1,2,3,0,0,3,10,0,0
6480bb947a7076697fc0b339,2017,,,2,DM Bravo,MK Pandey,5,3,1,0,0,5,3,1,0,0,0,0,0
6480bb957ae1619e0d648dec,2019,,,2,KL Rahul,Mandeep Singh,5,6,0,0,1,3,3,0,0,2,3,0,0
6480bb99b0fa4d217ed7f255,2023,,,1,I Sharma,Kuldeep Yadav,5,2,1,0,0,1,1,0,0,4,1,1,0
6480bb9e173228d1b18e376b,2012,,,1,LRPL Taylor,Y Nagar,5,8,0,0,1,3,5,0,0,2,3,0,0
6480bb94457bfc7687322f80,2017,,,2,BB McCullum,SK Raina,5,11,0,0,1,1,2,0,0,1,9,0,0
6480bb96c880c7df4e055f14,2020/21,,,2,JDS Neesham,SN Khan,5,7,0,0,1,3,3,0,0,1,4,0,0
6480bb9be88c31fc563da86f,2009,,,1,P Kumar,V Kohli,5,3,1,0,1,0,0,0,0,5,3,1,0
6480bb950ddd55d8aed7d015,2019,,,1,AM Rahane,JC Buttler,5,7,1,0,1,5,7,1,0,0,0,0,0
6480bb97b945155c90dccd3d,2021,,,1,N Rana,SP Narine,5,2,1,0,0,4,1,1,0,0,1,0,0
6480bb99433f6e11060ba714,2022,,,1,MR Marsh,R Powell,5,9,0,0,1,2,3,0,0,2,6,0,0
6480bb9bc74c35e494cec477,2007/08,,,2,RG Sharma,SB Bangar,5,8,0,0,1,2,4,0,0,3,4,0,0
6480bb95b84f125c6212267a,2019,,,2,C de Grandhomme,S Dube,5,7,1,0,1,0,1,0,0,5,6,1,0
6480bba048fb3d33ea0711e7,2013,,,2,GH Vihari,PA Patel,5,8,1,0,1,5,7,1,0,0,1,0,0
6480bba048fb3d33ea0711e7,2013,,,1,Harmeet Singh,LA Pomersbach,5,6,0,0,1,3,4,0,0,2,2,0,0
6480bb97ce981c1918dce924,2021,,,1,JJ Bumrah,TA Boult,5,2,1,0,0,5,2,1,0,0,0,0,0
6480bb99773871f8e2ddc4b1,2022,,,2,MA Agarwal,S Dhawan,5,8,0,0,1,1,4,0,0,3,4,0,0
6480bb9f218f37b46bef4afb,2013,,,2,AM Nayar,SPD Smith,5,4,0,0,0,2,2,0,0,2,2,0,0
6480bba0b07a395235841955,2013,,,2,DR Smith,KA Pollard,5,4,1,0,1,4,2,1,0,1,2,0,0
6480bb9c3b082d71291a593c,2009,,,1,LRPL Taylor,MV Boucher,5,5,1,0,1,0,0,0,0,5,5,1,0
6480bb9f54d17f50da495682,2012,,,2,DA Warner,V Sehwag,5,5,1,0,1,1,3,0,0,4,2,1,0
6480bb980ea7c3bcea4fdf9c,2022,,,2,R Dhawan,RD Chahar,5,4,1,0,1,0,0,0,0,4,4,1,0
6480bb9faf20f0bc714af2ea,2013,,,1,G Gambhir,MS Bisla,5,10,1,0,1,1,1,0,0,4,9,1,0
6480bb9516b0dbc1972e5c3c,2018,,,1,AD Russell,PP Chawla,5,2,1,0,0,5,2,1,0,0,0,0,0
6480bb9651b51fdcda05e4c8,2020/21,,,1,EJG Morgan,KD Karthik,5,3,1,0,1,5,2,1,0,0,1,0,0
6480bba29fb420d92aef1d2a,2015,,,2,DA Warner,S Dhawan,5,3,1,0,1,4,3,1,0,0,0,0,0
6480bb9a0a8baa96f94e8db9,2023,,,1,F du Plessis,GJ Maxwell,5,6,0,0,1,1,1,0,0,4,5,0,0
6480bb9a6e44b0c8da00ca72,2007/08,,,2,DS Kulkarni,MA Khote,5,12,1,0,1,0,9,0,0,5,3,1,0
6480bb96ec7d98e34055e8fc,2020/21,,,1,SPD Smith,TK Curran,5,8,0,0,1,2,3,0,0,2,5,0,0
6480bb994877788ec5b187ff,2023,,,2,SS Prabhudessai,WD Parnell,5,6,0,0,1,1,1,0,0,2,5,0,0
6480bb9d59f2ded94f736145,2011,,,1,DPMD Jayawardene,RA Jadeja,5,5,1,0,1,0,1,0,0,5,4,1,0
6480bba2aecb4103bab63c15,2016,,,2,PP Chawla,UT Yadav,5,4,0,0,1,3,3,0,0,1,1,0,0
6480bb99b4febfb641fddd39,2023,,,1,C Green,RG Sharma,5,6,1,0,1,5,4,1,0,0,2,0,0
6480bba0d3cbb27b257a9c1f,2013,,,2,AM Rahane,R Dravid,5,8,1,0,1,1,1,0,0,4,7,1,0
6480bb9d1f9a3cf1fa86e11c,2011,,,2,DL Vettori,S Aravind,5,5,0,0,0,1,2,0,0,2,3,0,0
6480bb9e30b7f3c09cfbdabb,2011,,,2,AL Menaria,PR Shah,5,5,1,0,1,0,0,0,0,5,5,1,0
6480bb9e38040b358f5a34d8,2012,,,1,KC Sangakkara,S Dhawan,5,6,1,0,1,4,5,1,0,1,1,0,0
6480bba07e219ed95b7b06df,2013,,,1,DA Warner,IK Pathan,5,2,1,0,0,1,1,0,0,4,1,1,0
6480bb9b72f6a46338302131,2009,,,2,JP Duminy,SS Tiwary,5,7,0,0,1,2,3,0,0,3,4,0,0
6480bb9d69cb9046a72d8fbe,2009/10,,,1,R Ashwin,SB Jakati,5,2,1,0,0,4,2,1,0,0,0,0,0
6480bb99f649ea7a6d79892f,2023,,,1,M Shahrukh Khan,S Dhawan,5,5,1,0,1,4,3,1,0,1,2,0,0
6480bb9940bd3bf36dd4897f,2023,,,1,A Manohar,HH Pandya,5,7,0,0,1,3,5,0,0,2,2,0,0
6480bb9bcc2f6123673672d0,2007/08,,,2,RV Uthappa,ST Jayasuriya,5,8,0,0,1,4,6,0,0,1,2,0,0
6480bba33dab752d79e587d2,2016,,,1,BB Sran,NV Ojha,5,5,1,0,1,0,0,0,0,5,5,1,0
6480bb976344f6d667dfd965,2021,,,1,SPD Smith,SS Iyer,5,8,0,0,1,3,3,0,0,1,5,0,0
6480bb9f7ff1377c4d13a645,2013,,,2,LRPL Taylor,RV Uthappa,5,6,1,0,1,4,5,1,0,0,1,0,0
6480bba1670ace74604a420f,2015,,,2,JA Morkel,MA Agarwal,5,3,1,0,1,1,1,0,0,4,2,1,0
6480bba1743abcb135a6a4c7,2015,,,2,AM Rahane,SV Samson,5,9,0,0,1,0,8,0,0,1,1,0,0
6480bba1c67d2c9c1279a4c8,2014,,,1,CH Gayle,PA Patel,5,7,0,0,1,1,2,0,0,3,5,0,0
6480bb9e9f1ef9ac02266570,2011,,,1,DB Ravi Teja,KC Sangakkara,5,5,0,0,1,4,4,0,0,1,1,0,0
6480bb9bc80883a975281815,2009,,,2,Kamran Khan,M Rawat,5,8,0,0,1,3,5,0,0,1,3,0,0
6480bb96c0ffb76dab723a2b,2019,,,1,AR Patel,RR Pant,5,8,0,0,1,3,6,0,0,2,2,0,0
6480bb9df57ec21d17310ad2,2011,,,2,B Chipli,S Dhawan,5,5,1,0,1,4,4,1,0,1,1,0,0
6480bba0120becd670aec59d,2013,,,1,AB Dinda,R Sharma,5,4,1,0,0,4,3,1,0,0,1,0,0
6480bb99b0fa4d217ed7f255,2023,,,1,A Nortje,RV Patel,5,6,0,0,1,2,2,0,0,3,4,0,0
6480bb956e3f7f62e4b24c01,2019,,,2,PP Shaw,SS Iyer,5,8,0,0,1,1,3,0,0,4,5,0,0
6480bb9fd4a1af6234c9e57c,2012,,,2,Azhar Mahmood,DJ Hussey,5,8,0,0,1,2,4,0,0,3,4,0,0
6480bb9a0474602f26069e45,2007/08,,,2,JA Morkel,MS Gony,5,8,0,0,1,5,6,0,0,0,2,0,0
6480bb94f46306dbde97aa5c,2017,,,2,CA Lynn,SP Narine,5,9,0,0,1,4,8,0,0,1,1,0,0
6480bb9dd89d4266d59a4592,2011,,,2,AM Nayar,PC Valthaty,5,11,0,0,1,1,4,0,0,3,7,0,0
6480bb9b0e32875998e9bfdc,2009,,,1,AB de Villiers,V Sehwag,5,3,1,0,1,1,1,0,0,4,2,1,0
6480bb96e8ba017befb2bc8a,2020/21,,,1,RR Pant,SO Hetmyer,5,3,1,0,1,4,2,1,0,1,1,0,0
6480bb945901306d3cb2b759,2018,,,2,AM Rahane,SV Samson,5,7,0,0,1,3,4,0,0,2,3,0,0
6480bb9692a7f0d52bd43127,2019,,,1,AB de Villiers,MM Ali,5,7,1,0,1,1,2,0,0,4,5,1,0
6480bba0c1c8569f19cc70f0,2013,,,2,MR Marsh,RV Uthappa,5,8,1,0,1,5,8,1,0,0,0,0,0
6480bba1c0aa361f3c6e454c,2015,,,1,CJ Anderson,LMP Simmons,5,13,1,0,1,4,7,1,0,0,6,0,0
6480bb9b2e179d359c1d446d,2009,,,2,AB de Villiers,G Gambhir,5,9,1,0,1,5,9,1,0,0,0,0,0
6480bba0fee4ae82492a666f,2013,,,2,MS Dhoni,SK Raina,5,3,0,0,1,4,3,0,0,0,0,0,0
6480bb9b69f8ace7659e486d,2009,,,1,JA Morkel,MS Dhoni,5,2,1,0,0,4,1,1,0,1,1,0,0
6480bb9a24adc8d916dfe2db,2023,,,2,AK Markram,Abhishek Sharma,5,5,1,0,1,0,1,0,0,4,4,1,0
6480bb9908b154f78b12b8fb,2023,,,1,JJ Roy,VR Iyer,5,4,0,0,1,1,2,0,0,2,2,0,0
6480bb9d716a89dbf5e486d0,2011,,,2,DA Warner,V Sehwag,5,3,1,0,1,1,1,0,0,4,2,1,0
6480bb9dfa7d0510ae3a7b40,2011,,,1,DA Warner,NV Ojha,5,7,0,0,1,3,3,0,0,2,4,0,0
6480bb993e61058e682e2ff4,2023,,,1,Shubman Gill,WP Saha,5,3,1,0,1,0,0,0,0,4,3,1,0
6480bb9f4bdcea2f81049fe9,2012,,,1,DPMD Jayawardene,V Sehwag,5,8,0,0,1,2,2,0,0,1,6,0,0
6480bb9873e53eace3a69dc7,2022,,,2,SP Narine,SS Iyer,5,10,1,0,1,5,5,1,0,0,5,0,0
6480bba18a289cc4b8d173a4,2014,,,1,Harbhajan Singh,S Gopal,4,5,0,0,1,1,2,0,0,3,3,0,0
6480bb9be7cbbb90a12dc916,2009,,,2,SR Tendulkar,Z Khan,4,5,0,0,1,2,2,0,0,2,3,0,0
6480bba1827557ebdfc70821,2015,,,1,GJ Maxwell,V Sehwag,4,3,1,0,1,0,1,0,0,4,2,1,0
6480bb99d2bd76016d47896d,2023,,,2,C Sakariya,Kuldeep Yadav,4,4,1,0,1,4,4,1,0,0,0,0,0
6480bb98e87e6f83b61088ea,2022,,,1,K Rabada,VG Arora,4,6,0,0,0,3,4,0,0,1,2,0,0
6480bb9809c62ba77e5df472,2021,,,1,GHS Garton,HV Patel,4,2,0,0,0,0,0,0,0,2,2,0,0
6480bb974086cbea889134af,2021,,,2,RR Pant,SO Hetmyer,4,1,1,0,0,4,1,1,0,0,0,0,0
6480bba1448ab5c40ac64696,2014,,,1,RN ten Doeschate,YK Pathan,4,1,1,0,0,0,0,0,0,4,1,1,0
6480bba18a2fe828fa106f6c,2014,,,1,KK Nair,SV Samson,4,7,0,0,1,2,2,0,0,2,5,0,0
6480bb9d182be5b0fbe5a4e2,2011,,,2,A Symonds,RG Sharma,4,8,0,0,1,2,3,0,0,2,5,0,0
6480bb9eb559e2934b31c47c,2012,,,1,F du Plessis,M Vijay,4,4,0,0,1,3,2,0,0,0,2,0,0
6480bb9fe3bc767415c60bfa,2012,,,2,JH Kallis,Shakib Al Hasan,4,6,0,0,1,3,3,0,0,1,3,0,0
6480bb94ee669473878c11c2,2017,,,2,S Aravind,TS Mills,4,4,1,0,1,4,3,1,0,0,1,0,0
6480bb980ea7c3bcea4fdf9c,2022,,,2,JM Bairstow,JM Sharma,4,7,0,0,1,1,2,0,0,2,5,0,0
6480bb93d5dc00a79edede9c,2017,,,1,HH Pandya,Harbhajan Singh,4,4,0,0,0,1,1,0,0,3,3,0,0
6480bb9cff4ec2f71cdf18d1,2009/10,,,2,K Goel,PP Chawla,4,4,0,0,1,0,2,0,0,4,2,0,0
6480bb9932735ca83d38f6e7,2022,,,2,AK Markram,N Pooran,4,4,0,0,1,1,1,0,0,2,3,0,0
6480bba0e52e9733fc6d9937,2013,,,2,M Vohra,SE Marsh,4,5,0,0,1,1,2,0,0,1,3,0,0
6480bb97a4220e27710e38de,2021,,,2,CV Varun,Harbhajan Singh,4,5,0,0,0,2,3,0,0,2,2,0,0
6480bb9deba74e341b44c765,2009/10,,,2,RJ Harris,Y Venugopal Rao,4,8,0,0,1,3,6,0,0,1,2,0,0
6480bba1d9f266a28a109f29,2015,,,2,AD Mathews,MK Tiwary,4,2,1,0,0,4,2,1,0,0,0,0,0
6480bba10e78f50f124b406a,2015,,,2,A Nehra,F du Plessis,4,2,0,0,0,0,1,0,0,3,1,0,0
6480bb9575ad32214d0f6ec0,2019,,,2,AJ Turner,AM Rahane,4,3,0,0,1,0,1,0,0,3,2,0,0
6480bb9edd901481f13ce9ba,2012,,,2,CH Gayle,V Kohli,4,4,1,0,1,0,0,0,0,4,4,1,0
6480bba03a099a1a2e9c3dc5,2013,,,1,DA Miller,PP Chawla,4,1,1,0,0,4,1,1,0,0,0,0,0
6480bba065b341458c934986,2013,,,2,G Gambhir,MS Bisla,4,2,1,0,1,0,0,0,0,4,2,1,0
6480bb9b724406459cd357c9,2007/08,,,2,J Arunkumar,V Kohli,4,13,0,0,1,1,3,0,0,2,10,0,0
6480bb968211e65fcbffa192,2019,,,1,P Negi,UT Yadav,4,2,1,0,1,4,2,1,0,0,0,0,0
6480bb954714437843ab3647,2019,,,2,Abhishek Sharma,DJ Hooda,4,5,0,0,1,1,1,0,0,3,4,0,0
6480bb94009d0662ee94f07b,2018,,,2,MK Pandey,S Dhawan,4,5,0,0,1,1,1,0,0,1,4,0,0
6480bb942fc9529eb2869c17,2018,,,1,AB de Villiers,CJ Anderson,4,10,0,0,1,2,3,0,0,2,7,0,0
6480bba35038a60ea566794a,2016,,,1,DS Kulkarni,RA Jadeja,4,3,0,0,0,3,2,0,0,1,1,0,0
6480bba0eb5a345386bdc825,2013,,,2,R Dravid,SV Samson,4,6,0,0,1,4,4,0,0,0,2,0,0
6480bb97372fc5d5ef4c436a,2021,,,2,S Dube,SV Samson,4,3,1,0,1,0,0,0,0,4,3,1,0
6480bb94738952e740c68749,2018,,,2,MK Tiwary,R Ashwin,4,7,0,0,1,1,3,0,0,3,4,0,0
6480bb9b69f8ace7659e486d,2009,,,1,ML Hayden,PA Patel,4,7,0,0,1,1,2,0,0,3,5,0,0
6480bb95f37ebb69ffb216e0,2019,,,1,CA Lynn,N Rana,4,5,0,0,1,3,4,0,0,1,1,0,0
6480bb9ee779ef1e445d0506,2012,,,1,Harbhajan Singh,PP Ojha,4,5,1,0,1,4,4,1,0,0,1,0,0
6480bb9cd6fe6fad0d6efbd9,2009/10,,,1,AA Jhunjhunwala,GC Smith,4,14,0,0,1,1,9,0,0,2,5,0,0
6480bb9c5d0fccb6a3a6d37d,2009,,,2,AS Raut,LA Carseldine,4,5,0,0,1,1,2,0,0,3,3,0,0
6480bb9b62eb35d78fcd7df0,2007/08,,,1,Iqbal Abdulla,WP Saha,4,5,0,0,0,1,2,0,0,3,3,0,0
6480bb9558c0acb502a3b1a9,2019,,,2,Avesh Khan,K Rabada,4,4,1,0,1,4,3,1,0,0,1,0,0
6480bb972a7d4e1071ea662e,2021,,,1,Ishan Kishan,KH Pandya,4,10,0,0,1,3,5,0,0,1,5,0,0
6480bb9c0dec1a788da66d33,2009/10,,,2,JA Morkel,KB Arun Karthik,4,4,0,0,1,3,3,0,0,1,1,0,0
6480bba0c63a6317296391b7,2013,,,2,AM Rahane,SV Samson,4,6,1,0,1,0,2,0,0,4,4,1,0
6480bb9cd0eb4289b2222e37,2009/10,,,2,DR Martyn,MJ Lumb,4,8,0,0,1,1,3,0,0,2,5,0,0
6480bb9f36ad55c3c7fd6548,2012,,,1,RP Singh,SL Malinga,4,7,0,0,1,3,4,0,0,1,3,0,0
6480bb9a1032ce724214f6dd,2007/08,,,1,DJ Thornely,ST Jayasuriya,4,2,1,0,1,0,0,0,0,4,2,1,0
6480bb99e909d98c8193bac5,2023,,,2,Abdul Samad,MA Agarwal,4,9,0,0,1,2,6,0,0,2,3,0,0
6480bb9f02801d2090cdba0d,2012,,,1,MJ Clarke,SC Ganguly,4,9,0,0,1,2,5,0,0,2,4,0,0
6480bb9e173228d1b18e376b,2012,,,1,AB Agarkar,IK Pathan,4,1,1,0,0,0,0,0,0,4,1,1,0
6480bb9be7cbbb90a12dc916,2009,,,2,PR Shah,SR Tendulkar,4,1,1,0,0,0,0,0,0,4,1,1,0
6480bba0b5eabeb0a150b93f,2013,,,2,SPD Smith,Yuvraj Singh,4,2,1,0,1,0,0,0,0,4,2,1,0
6480bb9538916411f52016bf,2019,,,1,PP Chawla,Y Prithvi Raj,4,4,1,0,1,4,3,1,0,0,1,0,0
6480bb9ddcbb8fbbad6614c8,2009/10,,,1,DA Warner,V Sehwag,4,7,1,0,1,4,6,1,0,0,1,0,0
6480bb9a51ee1ef33a5b2dbb,2007/08,,,2,DB Das,DJ Hussey,4,6,1,0,1,4,6,1,0,0,0,0,0
6480bb99fa79383bdc7df827,2022,,,2,HV Patel,Shahbaz Ahmed,4,5,0,0,1,0,1,0,0,4,4,0,0
6480bb9d91920239b62f48ad,2009/10,,,1,Pankaj Singh,R Vinay Kumar,4,4,0,0,1,1,2,0,0,2,2,0,0
6480bb9d0f6794fbf429449b,2011,,,1,B Lee,R Bhatia,4,4,0,0,1,1,3,0,0,1,1,0,0
6480bba1ebb63d1bd8c60b9d,2014,,,2,Imran Tahir,S Nadeem,4,4,1,0,1,4,4,1,0,0,0,0,0
6480bb9f79be50f1621abcc6,2012,,,1,Azhar Mahmood,SE Marsh,4,6,0,0,1,1,3,0,0,1,3,0,0
6480bba0da054e3d917f71fb,2013,,,1,JP Faulkner,R Dravid,4,3,0,0,1,1,2,0,0,3,1,0,0
6480bb9d69cb9046a72d8fbe,2009/10,,,2,HH Gibbs,TL Suman,4,4,1,0,1,0,0,0,0,4,4,1,0
6480bb994aafcf67cd092a7d,2023,,,1,A Nortje,Kuldeep Yadav,4,2,1,0,0,4,2,1,0,0,0,0,0
6480bb9d6ea22feab98beb5b,2011,,,1,JA Morkel,MEK Hussey,4,1,1,0,0,0,0,0,0,4,1,1,0
6480bb9d0f6794fbf429449b,2011,,,1,MK Tiwary,R Bhatia,4,6,0,0,1,2,4,0,0,1,2,0,0
6480bba090c88df75eba18e6,2014,,,1,KK Nair,SV Samson,4,7,0,0,1,1,1,0,0,2,6,0,0
6480bba0b2a9d600114a43d7,2013,,,2,GJ Maxwell,Harbhajan Singh,4,3,1,0,0,0,0,0,0,4,3,1,0
6480bb96e76ccde6082d7564,2020/21,,,2,CJ Jordan,GJ Maxwell,4,1,1,0,0,0,0,0,0,4,1,1,0
6480bb9ee4565d108b29626f,2012,,,2,DB Das,LR Shukla,4,1,1,0,0,4,1,1,0,0,0,0,0
6480bb9e38040b358f5a34d8,2012,,,2,DA Warner,V Sehwag,4,2,1,0,1,0,0,0,0,4,2,1,0
6480bba000b91f6c5cf57fdb,2013,,,2,BJ Hodge,STR Binny,4,3,1,0,1,0,0,0,0,4,3,1,0
6480bb9619eaed447b2a05d4,2020/21,,,1,CH Morris,Gurkeerat Singh,4,3,1,0,1,4,2,1,0,0,1,0,0
6480bb975ea60ce128803d60,2021,,,2,RA Tripathi,SP Narine,4,3,1,0,1,0,0,0,0,4,3,1,0
6480bb97b945155c90dccd3d,2021,,,2,MS Dhoni,SK Raina,4,3,0,0,1,1,2,0,0,2,1,0,0
6480bb9e4bb50b724830b249,2011,,,1,JH Kallis,SP Goswami,4,10,0,0,1,1,7,0,0,1,3,0,0
6480bb99c6aa5989a16174d1,2023,,,1,DJ Willey,KD Karthik,4,2,1,0,1,0,0,0,0,4,2,1,0
6480bb98af25209ef756aa2c,2021,,,2,KA Pollard,SA Yadav,4,6,0,0,1,2,3,0,0,2,3,0,0
6480bb97951f1bc43b462c46,2021,,,2,SV Samson,YBK Jaiswal,4,5,1,0,1,4,4,1,0,0,1,0,0
6480bba0a9f68a29bda72302,2013,,,1,G Gambhir,YK Pathan,4,4,1,0,1,4,4,1,0,0,0,0,0
6480bb99358a21ba3487db81,2023,,,1,AU Rashid,Abdul Samad,4,3,1,0,1,4,3,1,0,0,0,0,0
6480bb99bb362e3714226928,2022,,,2,JO Holder,MP Stoinis,4,4,0,0,1,1,2,0,0,2,2,0,0
6480bb9836d24b9817a35f7d,2022,,,2,MS Wade,Shubman Gill,4,3,0,0,1,0,0,0,0,0,3,0,0
6480bb99b0fa4d217ed7f255,2023,,,1,Aman Hakim Khan,MK Pandey,4,2,1,0,1,4,2,1,0,0,0,0,0
6480bb9651b51fdcda05e4c8,2020/21,,,2,Kartik Tyagi,S Gopal,4,6,0,0,1,2,3,0,0,2,3,0,0
6480bb9623a26d3fbfe59f25,2020/21,,,2,AB de Villiers,Washington Sundar,4,3,1,0,1,4,2,1,0,0,1,0,0
6480bba0c3cc8c51bc6c1c3a,2013,,,2,R Rampaul,SS Tiwary,4,5,0,0,1,3,4,0,0,1,1,0,0
6480bb9eae43aed76989151b,2011,,,1,A Mithun,AB de Villiers,4,1,1,0,0,0,0,0,0,4,1,1,0
6480bb9ce93a7b4315d8fa30,2009,,,1,WPUJC Vaas,Y Venugopal Rao,4,5,0,0,1,4,3,0,0,0,2,0,0
6480bb9d1ed71a4f47892d00,2009/10,,,2,SK Trivedi,SK Warne,4,2,1,0,1,4,2,1,0,0,0,0,0
6480bb9b1fc007965b68d4d9,2009,,,1,HH Gibbs,Y Venugopal Rao,4,4,0,0,1,2,2,0,0,2,2,0,0
6480bb9c54a72690027ba3d4,2009/10,,,2,SR Tendulkar,SS Tiwary,4,4,0,0,1,2,1,0,0,2,3,0,0
6480bb9ae4498012aa089436,2023,,,2,JJ Roy,Rahmanullah Gurbaz,4,6,0,0,1,2,2,0,0,1,4,0,0
6480bb94c008939d7976abfe,2018,,,2,CH Morris,V Shankar,4,4,0,0,1,0,1,0,0,3,3,0,0
6480bba03b6f98689b851317,2013,,,2,Azhar Mahmood,Gurkeerat Singh,4,10,0,0,1,2,7,0,0,2,3,0,0
6480bba141bcb000fa6fe2a4,2015,,,2,RG Sharma,UBT Chand,4,11,1,0,1,0,5,0,0,4,6,1,0
6480bb9c37b72d7a51019794,2009/10,,,2,M Morkel,SK Warne,4,6,1,0,1,4,4,1,0,0,2,0,0
6480bb97b97c36ac8be3582f,2021,,,1,AB de Villiers,GJ Maxwell,4,9,0,0,1,1,5,0,0,3,4,0,0
6480bba1e64915b9e7c849ca,2014,,,1,KD Karthik,MK Tiwary,4,2,1,0,1,0,1,0,0,4,1,1,0
6480bba120182b9ca0b70004,2014,,,1,CM Gautam,Z Khan,4,5,0,0,0,0,3,0,0,1,2,0,0
6480bb9d79d603cc45fc9b3c,2011,,,2,P Kumar,PP Chawla,4,5,0,0,0,2,3,0,0,2,2,0,0
6480bb945901306d3cb2b759,2018,,,2,K Gowtham,STR Binny,4,5,0,0,1,1,2,0,0,3,3,0,0
6480bba287d112bccc55ccd2,2015,,,1,DA Miller,GJ Maxwell,4,2,1,0,1,0,0,0,0,4,2,1,0
6480bb9f7258f976eb8fe943,2012,,,2,JA Morkel,RA Jadeja,4,2,1,0,1,0,0,0,0,4,2,1,0
6480bb95c701f5c8388f7f88,2018,,,1,AR Patel,AS Rajpoot,4,7,0,0,1,2,2,0,0,1,5,0,0
6480bba2d313234709068efb,2015,,,1,Harbhajan Singh,LMP Simmons,4,5,0,0,1,3,3,0,0,1,2,0,0
6480bb9f7bae5ad85c4473ba,2012,,,2,JA Morkel,MS Dhoni,4,4,0,0,1,3,2,0,0,1,2,0,0
6480bb9deba74e341b44c765,2009/10,,,2,AC Gilchrist,MD Mishra,4,4,1,0,1,4,4,1,0,0,0,0,0
6480bb9a40966b9b90fcdf2e,2023,,,2,RK Singh,SN Thakur,4,1,1,0,0,4,1,1,0,0,0,0,0
6480bba1b8e3071cc513602a,2014,,,2,A Mishra,IK Pathan,4,2,0,0,1,0,2,0,0,0,0,0,0
6480bb9dfb2e8e8c2002df86,2011,,,1,A Mishra,DW Steyn,4,2,1,0,1,0,0,0,0,4,2,1,0
6480bb9d80e97e178e5f68de,2011,,,2,Iqbal Abdulla,R Bhatia,4,4,0,0,0,3,3,0,0,0,1,0,0
6480bb9e88141830a7a309b5,2011,,,2,G Gambhir,SP Goswami,4,7,1,0,1,4,5,1,0,0,2,0,0
6480bb9c9f9d5376b4227724,2009/10,,,2,A Symonds,RG Sharma,4,7,0,0,1,1,1,0,0,2,6,0,0
6480bb9763013a01eae041f2,2020/21,,,2,Abhishek Sharma,Rashid Khan,4,3,0,0,1,0,2,0,0,1,1,0,0
6480bb9fc524f8142f0b3461,2012,,,2,AM Rahane,R Dravid,4,9,1,0,1,0,3,0,0,4,6,1,0
6480bb9f4780a208e13bfb3d,2013,,,1,CH Gayle,V Kohli,4,6,0,0,1,2,2,0,0,1,4,0,0
6480bba120182b9ca0b70004,2014,,,1,CM Gautam,KA Pollard,4,3,1,0,1,4,2,1,0,0,1,0,0
6480bb96ec01f8fb3504bc36,2020/21,,,1,JC Buttler,SV Samson,4,3,1,0,1,0,1,0,0,4,2,1,0
6480bb97d5e3b0911408f222,2020/21,,,1,MM Ali,V Kohli,4,4,0,0,1,1,2,0,0,3,2,0,0
6480bb998454ba791a8fdbf8,2023,,,2,RG Sharma,TH David,4,5,1,0,1,4,5,1,0,0,0,0,0
6480bb9f0f959bc6104820c3,2013,,,1,AD Russell,DA Warner,4,3,0,0,1,3,2,0,0,0,1,0,0
6480bba0b46cf5430edef3f5,2014,,,2,G Gambhir,JH Kallis,4,10,0,0,1,0,8,0,0,3,2,0,0
6480bb9b77a0ff5cb3d0e3e0,2009,,,1,JA Morkel,MS Dhoni,4,3,1,0,1,4,2,1,0,0,1,0,0
6480bb96ed06a5693a66b9f0,2020/21,,,1,JC Archer,R Tewatia,4,4,0,0,1,2,3,0,0,1,1,0,0
6480bb9a1e358307d26cd50d,2023,,,2,RG Sharma,SA Yadav,4,3,1,0,1,0,2,0,0,4,1,1,0
6480bba1abec4894f2f69a35,2014,,,2,AN Ahmed,Yuvraj Singh,4,1,1,0,0,4,1,1,0,0,0,0,0
6480bb9ae4498012aa089436,2023,,,1,MM Ali,S Dube,4,5,0,0,1,1,2,0,0,3,3,0,0
6480bb9d4e112d675b2925df,2009/10,,,2,PD Collingwood,V Sehwag,4,6,0,0,1,2,3,0,0,2,3,0,0
6480bb9f3ca20834ecc7607a,2012,,,1,DB Das,YK Pathan,4,1,1,0,0,4,1,1,0,0,0,0,0
6480bb9f0f1f6c03d8e2f039,2013,,,2,A Ashish Reddy,DW Steyn,4,1,1,0,0,0,0,0,0,4,1,1,0
6480bb9b7b8617115de9683b,2007/08,,,1,AC Gilchrist,SB Styris,4,7,0,0,1,3,4,0,0,1,3,0,0
6480bba000b91f6c5cf57fdb,2013,,,1,DW Steyn,NLTC Perera,4,3,0,0,1,0,1,0,0,3,2,0,0
6480bb9f218f37b46bef4afb,2013,,,1,AC Gilchrist,Mandeep Singh,4,3,1,0,1,4,3,1,0,0,0,0,0
6480bb948211fe47e65f2e77,2018,,,2,RG Sharma,SA Yadav,4,8,0,0,1,2,6,0,0,2,2,0,0
6480bba065b341458c934986,2013,,,1,DPMD Jayawardene,UBT Chand,4,3,1,0,1,0,1,0,0,4,2,1,0
6480bb98634dba60191637ad,2021,,,2,Abdul Samad,WP Saha,4,4,0,0,1,1,2,0,0,1,2,0,0
6480bb9996eb97dd08b62f78,2023,,,2,Atharva Taide,P Simran Singh,4,2,1,0,1,4,2,1,0,0,0,0,0
6480bb95b98d000799e11963,2018,,,1,C de Grandhomme,MM Ali,4,2,1,0,1,0,0,0,0,4,2,1,0
6480bb9574ca455ec008e942,2018,,,1,KS Williamson,WP Saha,4,4,0,0,1,3,3,0,0,1,1,0,0
6480bb98e87e6f83b61088ea,2022,,,2,MM Ali,RV Uthappa,4,2,1,0,1,0,0,0,0,4,2,1,0
6480bb9b6ded6d116cfe02ee,2009,,,1,BAW Mendis,I Sharma,4,2,1,0,1,0,1,0,0,4,1,1,0
6480bba0120becd670aec59d,2013,,,1,RV Uthappa,SPD Smith,4,4,1,0,1,0,0,0,0,4,4,1,0
6480bb9ddfb0f2f6f8e813e5,2011,,,2,DA Warner,V Sehwag,4,7,0,0,1,3,7,0,0,0,0,0,0
6480bb9b77a0ff5cb3d0e3e0,2009,,,2,KD Karthik,R Bhatia,4,4,1,0,1,4,2,1,0,0,2,0,0
6480bb95cf9d446747bd74fe,2019,,,2,DJ Bravo,MS Dhoni,4,3,1,0,0,4,3,1,0,0,0,0,0
6480bb99f33a7dd80eb0a544,2023,,,2,Arshdeep Singh,M Shahrukh Khan,4,7,0,0,1,2,2,0,0,2,5,0,0
6480bb9f6f311344dac147cc,2012,,,2,M Manhas,SPD Smith,4,6,0,0,1,1,3,0,0,3,3,0,0
6480bb9f777b7b1e89543a6e,2013,,,2,RT Ponting,SR Tendulkar,4,4,0,0,1,1,1,0,0,1,3,0,0
6480bb98291bb8b3f3e8145d,2022,,,2,AD Russell,SP Narine,4,2,1,0,1,0,0,0,0,4,2,1,0
6480bb9a7d91d721555835e5,2007/08,,,1,M Rawat,Sohail Tanvir,4,3,0,0,0,1,1,0,0,2,2,0,0
6480bb99b4febfb641fddd39,2023,,,1,RG Sharma,SA Yadav,4,11,0,0,1,0,6,0,0,3,5,0,0
6480bba2965d1d15aa6f723e,2016,,,2,BB McCullum,SK Raina,4,4,0,0,1,2,2,0,0,2,2,0,0
6480bb9a8053274c083224d9,2023,,,1,T Stubbs,TH David,4,6,0,0,1,1,2,0,0,2,4,0,0
6480bba1f2392e6761d39d66,2014,,,1,F du Plessis,SK Raina,4,3,0,0,1,1,2,0,0,1,1,0,0
6480bb957e6d387fe3a6b26e,2018,,,1,JJ Roy,PP Shaw,4,6,0,0,1,2,2,0,0,2,4,0,0
6480bb97746881ab34c38bf8,2020/21,,,2,KA Pollard,KH Pandya,4,1,1,0,0,4,1,1,0,0,0,0,0
6480bb9edd901481f13ce9ba,2012,,,2,CH Gayle,MA Agarwal,4,8,0,0,1,2,5,0,0,1,3,0,0
6480bba26ca6ec72ba377236,2016,,,1,A Ashish Reddy,MC Henriques,4,5,0,0,0,2,3,0,0,2,2,0,0
6480bb963d224b9be17f2c75,2019,,,1,Shakib Al Hasan,V Shankar,4,5,0,0,1,3,3,0,0,1,2,0,0
6480bba286cca051953c976a,2015,,,2,Anureet Singh,Karanveer Singh,4,9,0,0,1,2,5,0,0,2,4,0,0
6480bba154ce29a67e4752df,2015,,,2,Harbhajan Singh,RG Sharma,4,2,1,0,1,0,0,0,0,4,2,1,0
6480bba069c0322e91e50958,2013,,,1,DJG Sammy,NLTC Perera,4,14,0,0,1,2,8,0,0,2,6,0,0
6480bb966c9efd5bf35d10b9,2019,,,2,SPD Smith,SV Samson,4,7,0,0,1,1,3,0,0,3,4,0,0
6480bb96edb3270eba0af1d4,2020/21,,,2,DL Chahar,RA Jadeja,4,2,1,0,1,0,0,0,0,4,2,1,0
6480bb9e1a26096ce68e9ca3,2012,,,1,BJ Hodge,R Dravid,4,8,0,0,1,1,2,0,0,2,6,0,0
6480bba234aac105851964b1,2015,,,1,MS Dhoni,RA Jadeja,4,4,0,0,1,4,4,0,0,0,0,0,0
6480bb9ec0a4e3f137edb047,2011,,,2,M Vijay,SK Raina,4,3,1,0,1,4,3,1,0,0,0,0,0
6480bba0a4e7c61a5656729e,2014,,,2,MA Starc,Yuvraj Singh,4,7,0,0,1,3,3,0,0,1,4,0,0
6480bb9eeeaf037e5e41ab86,2012,,,2,Mandeep Singh,PP Chawla,4,2,1,0,1,4,2,1,0,0,0,0,0
6480bb9574ca455ec008e942,2018,,,1,Rashid Khan,YK Pathan,4,2,1,0,1,4,1,1,0,0,1,0,0
6480bb9e8dfd9ba30b93cbd8,2012,,,1,DT Christian,MS Gony,4,8,0,0,1,1,2,0,0,3,6,0,0
6480bb9d91920239b62f48ad,2009/10,,,2,JP Duminy,R McLaren,4,6,0,0,1,2,3,0,0,2,3,0,0
6480bb9f1faffe780b407e67,2013,,,1,LRPL Taylor,RV Uthappa,4,8,0,0,1,4,4,0,0,0,4,0,0
6480bb945f95e767a8a9cc10,2017,,,1,AM Rahane,RA Tripathi,4,4,1,0,1,4,4,1,0,0,0,0,0
6480bb95960e393c939ab44c,2018,,,2,KH Pandya,RG Sharma,4,3,1,0,1,4,3,1,0,0,0,0,0
6480bba11eff9b230a172302,2014,,,1,RV Uthappa,Shakib Al Hasan,4,3,0,0,1,0,1,0,0,3,2,0,0
6480bba2fc84811f520b04cf,2016,,,1,AR Patel,MG Johnson,4,2,0,0,0,4,2,0,0,0,0,0,0
6480bb9c9f9d5376b4227724,2009/10,,,1,DJ Hussey,WP Saha,4,2,1,0,1,4,2,1,0,0,0,0,0
6480bb9f3700dfaa08e18c43,2012,,,2,DJ Bravo,MS Dhoni,4,16,0,0,1,3,9,0,0,1,7,0,0
6480bba090c88df75eba18e6,2014,,,2,V Kohli,Yuvraj Singh,4,8,0,0,1,1,1,0,0,3,7,0,0
6480bb9fe489b0d429e97599,2012,,,1,AUK Pathan,TM Dilshan,4,4,0,0,1,4,4,0,0,0,0,0,0
6480bb96a467817b9b68ca94,2020/21,,,1,MS Dhoni,SR Watson,4,6,0,0,1,3,4,0,0,1,2,0,0
6480bb9498a98d52f9285b52,2017,,,2,DT Christian,MS Dhoni,4,2,1,0,1,4,2,1,0,0,0,0,0
6480bb9a7f7a862ba0b2c59e,2007/08,,,1,PA Patel,SP Fleming,4,6,1,0,1,4,6,1,0,0,0,0,0
6480bba24f6e6e2c212c7469,2016,,,2,KK Nair,SV Samson,4,4,1,0,1,0,3,0,0,4,1,1,0
6480bb999424dd02cf40772a,2022,,,1,F du Plessis,V Kohli,4,5,0,0,1,0,1,0,0,3,4,0,0
6480bb9c442caaabe9eb2275,2009,,,1,G Gambhir,TM Dilshan,4,5,0,0,1,2,3,0,0,2,2,0,0
6480bb9eb559e2934b31c47c,2012,,,1,RA Jadeja,S Badrinath,4,6,0,0,1,2,3,0,0,2,3,0,0
6480bba1b8e3071cc513602a,2014,,,1,R Bhatia,SPD Smith,4,12,0,0,1,1,4,0,0,2,8,0,0
6480bb9b52b93b56f5a16e52,2007/08,,,1,MK Tiwary,TM Dilshan,4,6,1,0,1,0,2,0,0,4,4,1,0
6480bb9ef18c54e7aafdd223,2012,,,1,DB Das,R Bhatia,4,3,0,0,0,1,1,0,0,3,2,0,0
6480bb9ea1e127d68e288e04,2011,,,2,BJ Hodge,KM Jadhav,4,3,0,0,0,2,2,0,0,1,1,0,0
6480bba1568e0f3990191600,2014,,,1,JA Morkel,PA Patel,4,2,0,0,0,1,1,0,0,2,1,0,0
6480bb98de3641699db2c5a1,2021,,,1,AT Rayudu,RA Jadeja,4,5,0,0,0,2,3,0,0,1,2,0,0
6480bb95f214d4f82ab97ee5,2018,,,1,BA Stokes,JD Unadkat,4,5,0,0,1,2,3,0,0,2,2,0,0
6480bb9abfe839459b1a28f6,2007/08,,,2,KC Sangakkara,SE Marsh,4,5,0,0,1,3,4,0,0,1,1,0,0
6480bb9fd26b695cee9d8761,2013,,,2,R Dravid,STR Binny,4,6,0,0,1,2,2,0,0,1,4,0,0
6480bba0d2cdb40c68c4739c,2013,,,2,AP Tare,KD Karthik,4,3,1,0,1,0,1,0,0,4,2,1,0
6480bb98de3641699db2c5a1,2021,,,2,K Rabada,SO Hetmyer,4,1,1,0,0,4,1,1,0,0,0,0,0
6480bb973d98bfd2d4a5f108,2020/21,,,2,EJG Morgan,Shubman Gill,4,9,0,0,1,1,6,0,0,3,3,0,0
6480bb95014388d3e8c62904,2019,,,1,AD Nath,P Negi,4,2,1,0,1,4,2,1,0,0,0,0,0
6480bba097818bcc0db9555d,2014,,,1,AR Patel,MG Johnson,4,4,0,0,1,0,0,0,0,4,4,0,0
6480bba3b818a7cff6fe4f89,2016,,,1,BCJ Cutting,Yuvraj Singh,4,2,1,0,1,0,1,0,0,4,1,1,0
6480bb9b3a5e1af467fb027b,2009,,,1,DW Steyn,R Dravid,4,5,1,0,1,0,3,0,0,4,2,1,0
6480bb97b97c36ac8be3582f,2021,,,1,DT Christian,GJ Maxwell,4,5,0,0,1,1,2,0,0,3,3,0,0
6480bb9b5d0191a0a2611916,2009,,,2,AD Mascarenhas,YK Pathan,4,2,1,0,1,4,2,1,0,0,0,0,0
6480bba1b8e3071cc513602a,2014,,,2,MC Henriques,NV Ojha,4,6,0,0,1,3,3,0,0,1,3,0,0
6480bb9dbefe5e2cceb23e01,2011,,,1,AT Rayudu,SR Tendulkar,4,9,0,0,1,3,7,0,0,1,2,0,0
6480bb9a0a8baa96f94e8db9,2023,,,1,KV Sharma,PWH de Silva,4,4,0,0,1,2,2,0,0,2,2,0,0
6480bb9516b0dbc1972e5c3c,2018,,,1,CA Lynn,SP Narine,4,2,1,0,1,0,0,0,0,4,2,1,0
6480bb939c56810fd88e895b,2017,,,2,AB de Villiers,KM Jadhav,4,9,0,0,1,3,5,0,0,1,4,0,0
6480bb956e3f7f62e4b24c01,2019,,,1,AM Rahane,R Parag,4,3,1,0,1,0,0,0,0,4,3,1,0
6480bba0eb5a345386bdc825,2013,,,1,DR Smith,KA Pollard,4,4,0,0,1,0,1,0,0,4,3,0,0
6480bb95b84f125c6212267a,2019,,,2,Mohammed Siraj,YS Chahal,4,8,0,0,1,3,5,0,0,1,3,0,0
6480bb9ea49fe0f895bf242a,2012,,,1,AT Rayudu,JEC Franklin,4,6,0,0,1,1,3,0,0,2,3,0,0
6480bb952f20835ddd6e533f,2019,,,1,CH Gayle,KL Rahul,4,4,1,0,1,0,0,0,0,4,4,1,0
6480bba287d112bccc55ccd2,2015,,,1,AR Patel,R Dhawan,4,3,0,0,0,3,2,0,0,1,1,0,0
6480bb9e30b7f3c09cfbdabb,2011,,,2,AL Menaria,SK Warne,4,11,0,0,1,2,2,0,0,2,9,0,0
6480bb9ea75f51e7a33e90ed,2012,,,1,JA Morkel,KMDN Kulasekara,4,2,1,0,1,0,1,0,0,4,1,1,0
6480bb99af95c6c90c4c3924,2023,,,2,B Kumar,M Markande,4,3,0,0,1,0,1,0,0,2,2,0,0
6480bb9f58a3e7ea877fc9dc,2012,,,1,A Ashish Reddy,AA Jhunjhunwala,4,5,0,0,1,3,3,0,0,1,2,0,0
6480bba264ad6b873d0d07d8,2016,,,1,DJ Bravo,KD Karthik,4,1,1,0,0,4,1,1,0,0,0,0,0
6480bb9b62eb35d78fcd7df0,2007/08,,,2,A Mishra,VY Mahesh,4,8,0,0,1,1,4,0,0,3,4,0,0
6480bba18e95c84faca0bdb6,2015,,,2,AM Rahane,STR Binny,4,4,0,0,1,2,2,0,0,1,2,0,0
6480bb9e2c96ab2b87d9466a,2011,,,1,AC Blizzard,AT Rayudu,4,10,0,0,1,3,5,0,0,1,5,0,0
6480bb9f3700dfaa08e18c43,2012,,,1,AC Gilchrist,N Saini,4,9,0,0,1,3,5,0,0,1,4,0,0
6480bb9c6f1c8ea3dc73226f,2009/10,,,2,KA Pollard,R Sathish,4,3,1,0,1,4,3,1,0,0,0,0,0
6480bba071a7a0cbb02d505a,2013,,,1,DA Warner,J Botha,4,5,0,0,1,3,3,0,0,1,2,0,0
6480bba00be5cdbaf6648462,2013,,,2,RA Jadeja,S Badrinath,4,2,1,0,1,4,2,1,0,0,0,0,0
6480bb9bc8bcea920f081be8,2009,,,1,B Akhil,Pankaj Singh,4,3,0,0,0,2,2,0,0,1,1,0,0
6480bb98d8f59b81335f4a3d,2021,,,1,GJ Maxwell,HV Patel,4,6,0,0,1,2,4,0,0,2,2,0,0
6480bb9d59f2ded94f736145,2011,,,1,DPMD Jayawardene,KM Jadhav,4,8,1,0,1,4,6,1,0,0,2,0,0
6480bb9746dfc5c467942a84,2021,,,1,RD Gaikwad,SK Raina,4,6,1,0,1,0,0,0,0,4,6,1,0
6480bb9f02801d2090cdba0d,2012,,,2,AT Rayudu,KD Karthik,4,8,0,0,1,1,3,0,0,3,5,0,0
6480bb9c1e676472f4841aa9,2009/10,,,1,MK Pandey,RV Uthappa,4,10,0,0,1,2,7,0,0,0,3,0,0
6480bb9553f3fc8903579544,2018,,,2,CA Lynn,SP Narine,4,2,1,0,1,0,0,0,0,4,2,1,0
6480bb9b9dd7fe8c5cbdbab0,2009,,,1,JA Morkel,Joginder Sharma,4,3,0,0,1,0,0,0,0,4,3,0,0
6480bb9404b444be6724e41e,2017,,,2,DT Christian,MK Tiwary,4,5,0,0,1,3,3,0,0,1,2,0,0
6480bb97668d35800fa74139,2021,,,1,M Ashwin,Mohammed Shami,4,6,0,0,1,2,4,0,0,2,2,0,0
6480bb9c0dec1a788da66d33,2009/10,,,2,MS Dhoni,SK Raina,4,6,0,0,1,3,4,0,0,1,2,0,0
6480bb9b283b30d0503656f7,2007/08,,,2,HH Gibbs,RG Sharma,4,13,0,0,1,1,8,0,0,3,5,0,0
6480bb9ae4498012aa089436,2023,,,1,MS Dhoni,S Dube,4,3,0,0,0,2,3,0,0,0,0,0,0
6480bb9fa3a890f94f179477,2013,,,1,P Awana,P Kumar,4,9,0,0,1,1,5,0,0,3,4,0,0
6480bb9fd9db46138a9bb209,2013,,,1,M Vijay,MEK Hussey,4,13,0,0,1,2,5,0,0,1,8,0,0
6480bb96f1eadf803ffc292c,2020/21,,,2,MK Lomror,YBK Jaiswal,4,5,0,0,1,1,2,0,0,3,3,0,0
6480bb9b9d7aa6d8e47576d7,2007/08,,,2,SK Warne,YK Pathan,4,4,0,0,1,1,2,0,0,2,2,0,0
6480bb9439fcd1191cf17a90,2017,,,2,GJ Maxwell,MP Stoinis,4,2,1,0,1,4,2,1,0,0,0,0,0
6480bb958c7b985a2b586a02,2018,,,1,KV Sharma,MS Dhoni,4,1,1,0,0,0,0,0,0,4,1,1,0
6480bb973d98bfd2d4a5f108,2020/21,,,2,PJ Cummins,RA Tripathi,4,6,0,0,1,1,3,0,0,3,3,0,0
6480bba0a4e7c61a5656729e,2014,,,2,AB Dinda,VR Aaron,4,6,0,0,0,2,5,0,0,1,1,0,0
6480bb94aad1a08ca4276b4e,2018,,,1,KL Rahul,Yuvraj Singh,4,4,1,0,1,0,0,0,0,4,4,1,0
6480bb9940bd3bf36dd4897f,2023,,,2,KL Rahul,N Pooran,4,14,0,0,1,3,7,0,0,1,7,0,0
6480bb98b8bb5b0d2c2f0848,2022,,,2,MS Dhoni,RA Jadeja,4,5,0,0,1,2,2,0,0,0,3,0,0
6480bb9836af59f8283f4081,2022,,,1,R Parag,SO Hetmyer,4,7,0,0,1,3,3,0,0,1,4,0,0
6480bba0a3e806f41a4dab41,2013,,,2,R Rampaul,R Vinay Kumar,4,7,0,0,1,0,3,0,0,4,4,0,0
6480bb9a577cde04d3672225,2023,,,2,DP Conway,S Dube,4,3,0,0,1,2,2,0,0,1,1,0,0
6480bb971c9e4a3ef11759f3,2021,,,1,M Shahrukh Khan,N Pooran,4,7,0,0,1,3,5,0,0,1,2,0,0
6480bba3d3dc891a3092643e,2016,,,2,DA Miller,F Behardien,4,2,1,0,1,4,2,1,0,0,0,0,0
6480bb98f01e4672b988c112,2022,,,1,D Padikkal,HE van der Dussen,4,4,1,0,1,0,1,0,0,4,3,1,0
6480bb9384cbae8edee3707f,2017,,,1,KA Pollard,RG Sharma,4,5,0,0,1,1,2,0,0,3,3,0,0
6480bba097818bcc0db9555d,2014,,,2,A Mishra,DW Steyn,4,6,0,0,1,2,3,0,0,2,3,0,0
6480bb9bbb0ec0266749f518,2007/08,,,2,SB Styris,VVS Laxman,4,5,0,0,1,2,2,0,0,1,3,0,0
6480bb97aabcd4374e076d04,2021,,,2,F du Plessis,SK Raina,4,5,0,0,1,1,2,0,0,2,3,0,0
6480bb9c9e328ac30bcaf6b0,2009/10,,,2,AT Rayudu,SS Tiwary,4,5,0,0,1,3,4,0,0,1,1,0,0
6480bb976344f6d667dfd965,2021,,,2,LH Ferguson,N Rana,4,2,1,0,0,0,0,0,0,4,2,1,0
6480bba3041017fe2c0593f2,2016,,,1,AJ Finch,SK Raina,4,3,1,0,1,4,3,1,0,0,0,0,0
6480bb9d66dc7da0d45e453c,2011,,,2,AC Gilchrist,KD Karthik,4,11,0,0,1,1,6,0,0,3,5,0,0
6480bba1af51ddc81185931d,2014,,,1,MA Starc,S Rana,4,4,0,0,0,2,2,0,0,1,2,0,0
6480bba2db1e2def1b597ed3,2015,,,2,M Vohra,WP Saha,4,11,0,0,1,1,6,0,0,3,5,0,0
6480bb9d03ce4b87b32b91f5,2009/10,,,2,DE Bollinger,SB Jakati,4,3,0,0,0,2,3,0,0,0,0,0,0
6480bb9a24adc8d916dfe2db,2023,,,2,Abdul Samad,H Klaasen,4,3,1,0,1,4,3,1,0,0,0,0,0
6480bb96c40b697b63d08717,2019,,,2,KMA Paul,TA Boult,4,1,1,0,0,4,1,1,0,0,0,0,0
6480bb9c9e328ac30bcaf6b0,2009/10,,,2,KA Pollard,R Sathish,4,6,0,0,1,2,4,0,0,2,2,0,0
6480bb9f7bae5ad85c4473ba,2012,,,2,RA Jadeja,S Badrinath,4,5,0,0,1,3,4,0,0,1,1,0,0
6480bb9f6f311344dac147cc,2012,,,2,B Kumar,M Kartik,4,2,1,0,0,4,2,1,0,0,0,0,0
6480bb9eb559e2934b31c47c,2012,,,1,R Ashwin,RA Jadeja,4,6,0,0,1,3,5,0,0,1,1,0,0
6480bba0d2cdb40c68c4739c,2013,,,2,AP Tare,DR Smith,4,4,1,0,1,0,0,0,0,4,4,1,0
6480bb9b46b4360184dc19f3,2007/08,,,2,A Chopra,Salman Butt,4,4,1,0,1,0,0,0,0,4,4,1,0
6480bb96c3293977af83acbf,2019,,,1,MK Lomror,S Gopal,4,6,1,0,1,4,2,1,0,0,4,0,0
6480bb9b4b74852492343291,2007/08,,,1,Misbah-ul-Haq,P Kumar,4,7,0,0,1,2,2,0,0,2,5,0,0
6480bba07b5396a7b65684d3,2013,,,1,KA Pollard,KD Karthik,4,4,1,0,1,4,4,1,0,0,0,0,0
6480bba16e510ff78ef635a1,2014,,,2,BJ Hodge,KK Cooper,4,1,1,0,0,4,1,1,0,0,0,0,0
6480bb95ff5da0069bc5274e,2018,,,2,BB Sran,MM Sharma,4,3,1,0,0,0,0,0,0,4,3,1,0
6480bba069d61566bb63ac2b,2014,,,1,AB de Villiers,JA Morkel,4,6,0,0,1,1,3,0,0,3,3,0,0
6480bb9ca668b7b36823fb21,2009,,,2,Harbhajan Singh,SL Malinga,4,3,0,0,1,1,3,0,0,0,0,0,0
6480bba32e54551792a9e915,2016,,,2,KH Pandya,N Rana,4,3,1,0,1,4,3,1,0,0,0,0,0
6480bb95f37ebb69ffb216e0,2019,,,1,KD Karthik,N Rana,4,2,1,0,1,4,1,1,0,0,1,0,0
6480bb9d0f6794fbf429449b,2011,,,2,BJ Hodge,PA Patel,4,11,0,0,1,2,8,0,0,2,3,0,0
6480bba1d21281c7385d5ce4,2014,,,2,MG Johnson,Shivam Sharma,4,2,1,0,1,0,0,0,0,4,2,1,0
6480bb971c9e4a3ef11759f3,2021,,,2,RA Tripathi,Shubman Gill,4,7,1,0,1,0,2,0,0,4,5,1,0
6480bb9e156723e64d6bd26b,2012,,,1,CL White,DB Ravi Teja,4,2,1,0,1,0,0,0,0,4,2,1,0
6480bb9db6a011b38afed5dc,2011,,,2,R Vinay Kumar,RV Gomez,4,5,0,0,1,1,1,0,0,3,4,0,0
6480bb99864a94e086c8395e,2022,,,2,DR Sams,TH David,4,5,0,0,1,1,3,0,0,2,2,0,0
6480bba0eb5a345386bdc825,2013,,,2,BJ Hodge,KK Cooper,4,2,1,0,1,0,0,0,0,4,2,1,0
6480bb9d6919e7181371271f,2011,,,2,KD Karthik,PC Valthaty,4,8,1,0,1,0,4,0,0,4,4,1,0
6480bb971c9e4a3ef11759f3,2021,,,1,DJ Hooda,MA Agarwal,4,7,0,0,1,1,4,0,0,2,3,0,0
6480bb9b09e6c98206422ae5,2009,,,1,BJ Hodge,SC Ganguly,4,6,0,0,1,3,3,0,0,1,3,0,0
6480bb97aad3147696268239,2021,,,2,KH Pandya,Q de Kock,4,6,0,0,1,2,3,0,0,2,3,0,0
6480bb9baccf501985a56d64,2007/08,,,1,GC Smith,M Kaif,4,11,0,0,1,1,6,0,0,1,5,0,0
6480bb95a09b947e0837a38a,2019,,,2,AS Joseph,RD Chahar,4,4,0,0,0,3,3,0,0,1,1,0,0
6480bb96a467817b9b68ca94,2020/21,,,2,JM Bairstow,MK Pandey,4,3,1,0,1,0,0,0,0,4,3,1,0
6480bb96e834e1c16b33f325,2020/21,,,2,JC Archer,TK Curran,4,1,1,0,0,0,0,0,0,4,1,1,0
6480bb931e6d2b03141b586d,2017,,,1,KK Nair,RR Pant,4,10,0,0,1,1,6,0,0,3,4,0,0
6480bba2fbc243afec641844,2015,,,1,GJ Maxwell,M Vohra,4,6,1,0,1,4,5,1,0,0,1,0,0
6480bb95f37ebb69ffb216e0,2019,,,2,CA Ingram,PP Shaw,4,4,0,0,1,1,1,0,0,2,3,0,0
6480bb9774a44376e3b5eb6f,2021,,,1,EJG Morgan,N Rana,4,7,0,0,1,2,2,0,0,2,5,0,0
6480bba2563745309ee2bdfb,2016,,,1,DR Smith,KD Karthik,4,9,0,0,1,1,6,0,0,2,3,0,0
6480bb9a6e44b0c8da00ca72,2007/08,,,2,RV Uthappa,SS Tiwary,4,3,1,0,1,0,1,0,0,4,2,1,0
6480bb9dc8b09381d0f01a9d,2011,,,1,JA Morkel,MEK Hussey,4,4,1,0,1,0,2,0,0,4,2,1,0
6480bba286cca051953c976a,2015,,,2,M Vijay,V Sehwag,4,5,0,0,1,2,3,0,0,1,2,0,0
6480bb973e3a3dbbb7ae3707,2020/21,,,2,MA Agarwal,N Pooran,4,3,1,0,1,0,0,0,0,4,3,1,0
6480bb9e5ab10d1241d6509d,2012,,,2,B Kumar,M Manhas,4,1,1,0,0,0,0,0,0,4,1,1,0
6480bb960d5042aa46b7776b,2020/21,,,1,DS Kulkarni,JL Pattinson,4,3,0,0,0,3,2,0,0,1,1,0,0
6480bb980ea7c3bcea4fdf9c,2022,,,1,A Badoni,MP Stoinis,4,4,0,0,1,4,4,0,0,0,0,0,0
6480bb96e61ac20a6e10582e,2019,,,2,Q de Kock,RG Sharma,4,2,1,0,1,0,0,0,0,4,2,1,0
6480bb9c6f1c8ea3dc73226f,2009/10,,,1,DP Nannes,S Ladda,4,18,0,0,1,3,11,0,0,0,7,0,0
6480bb9a77f349a0fd8d96d6,2023,,,1,LS Livingstone,SM Curran,4,6,0,0,1,3,5,0,0,1,1,0,0
6480bb9d362f72789dcdc5a7,2009/10,,,2,TM Dilshan,V Sehwag,4,4,0,0,1,1,1,0,0,3,3,0,0
6480bba07b5396a7b65684d3,2013,,,2,EJG Morgan,JH Kallis,4,8,0,0,1,3,4,0,0,1,4,0,0
6480bb9a7f7a862ba0b2c59e,2007/08,,,1,JA Morkel,MS Dhoni,4,8,0,0,1,3,4,0,0,1,4,0,0
6480bb9eda28fb340ed37b49,2012,,,1,Ankit Sharma,JP Duminy,4,5,0,0,1,1,2,0,0,3,3,0,0
6480bb94c5d20726ee59d3d6,2017,,,2,G Gambhir,MK Pandey,4,5,0,0,1,2,3,0,0,2,2,0,0
6480bb947b065b9dc0256f0d,2018,,,2,BB McCullum,Q de Kock,4,4,1,0,1,4,4,1,0,0,0,0,0
6480bb9498a98d52f9285b52,2017,,,1,DA Warner,KS Williamson,4,2,1,0,1,0,0,0,0,4,2,1,0
6480bb99c26e725b7b6f1637,2023,,,2,D Padikkal,JC Buttler,4,5,0,0,1,2,2,0,0,2,3,0,0
6480bb953aab41e7ed166b9d,2019,,,2,Q de Kock,SA Yadav,4,10,0,0,1,1,4,0,0,2,6,0,0
6480bba09d6b23c8722fd208,2013,,,2,AT Rayudu,PP Ojha,4,2,1,0,1,4,2,1,0,0,0,0,0
6480bb95f2e3c32afe233820,2018,,,2,MM Ali,Mandeep Singh,4,6,1,0,1,4,4,1,0,0,2,0,0
6480bb9d79d603cc45fc9b3c,2011,,,2,KD Karthik,SE Marsh,4,6,0,0,1,1,2,0,0,2,4,0,0
6480bb9e21655ee16a96b2c3,2012,,,1,S Aravind,Z Khan,4,3,1,0,1,4,1,1,0,0,2,0,0
6480bb9a6e44b0c8da00ca72,2007/08,,,1,B Lee,KC Sangakkara,4,5,0,0,1,0,2,0,0,3,3,0,0
6480bb9c454e9eefca545bde,2009/10,,,1,DPMD Jayawardene,J Theron,4,7,0,0,1,2,3,0,0,2,4,0,0
6480bb9c963968000dfd00d1,2009/10,,,2,DPMD Jayawardene,IK Pathan,4,9,0,0,1,3,3,0,0,1,6,0,0
6480bb9ab34d149420eae546,2023,,,2,JJ Roy,Rahmanullah Gurbaz,4,9,0,0,1,0,2,0,0,3,7,0,0
6480bb94f1c027945eeb8b10,2017,,,2,LMP Simmons,PA Patel,4,10,0,0,1,1,5,0,0,2,5,0,0
6480bb9be88c31fc563da86f,2009,,,1,MV Boucher,V Kohli,4,7,0,0,1,2,4,0,0,2,3,0,0
6480bb948a69b3d86293b12b,2017,,,2,KK Nair,RR Pant,4,2,1,0,1,0,0,0,0,4,2,1,0
6480bba21bbf76a62abea528,2016,,,1,Ankit Sharma,R Bhatia,4,4,0,0,1,0,1,0,0,4,3,0,0
6480bb96e18d7a1b3e62552d,2019,,,1,Rashid Khan,V Shankar,4,3,0,0,1,0,1,0,0,4,2,0,0
6480bba1d3b4ddc36050e3f3,2014,,,2,M Morkel,PP Chawla,4,1,1,0,0,0,0,0,0,4,1,1,0
6480bb948211fe47e65f2e77,2018,,,2,HH Pandya,SA Yadav,4,10,0,0,1,2,7,0,0,2,3,0,0
6480bb973e451a92813d78cc,2020/21,,,1,Abhishek Sharma,Mohammad Nabi,4,4,0,0,0,2,3,0,0,0,1,0,0
6480bb9d3c4dfa9f054aa47f,2011,,,2,AG Paunikar,FY Fazal,4,6,0,0,1,3,5,0,0,1,1,0,0
6480bb966539f85263cb6429,2019,,,2,PP Shaw,S Dhawan,4,5,1,0,1,4,5,1,0,0,0,0,0
6480bba388682c5ca10ff37a,2016,,,1,SR Watson,Sachin Baby,4,6,0,0,1,3,4,0,0,1,2,0,0
6480bb9d867c041656e9a75f,2009/10,,,1,KD Karthik,PD Collingwood,4,6,0,0,1,1,2,0,0,3,4,0,0
6480bb9fcb2b412c0ebd4afa,2013,,,1,PA Patel,PA Reddy,4,7,0,0,1,2,4,0,0,2,3,0,0
6480bb98e87e6f83b61088ea,2022,,,1,MA Agarwal,S Dhawan,4,2,1,0,1,4,2,1,0,0,0,0,0
6480bba11c977a5d11c1aa38,2015,,,1,KV Sharma,P Kumar,4,4,0,0,1,3,3,0,0,1,1,0,0
6480bb9c13fa57328b17e4e2,2009/10,,,1,AB de Villiers,KD Karthik,4,5,0,0,1,2,3,0,0,2,2,0,0
6480bba1b8e3071cc513602a,2014,,,1,SR Watson,STR Binny,4,4,1,0,1,4,3,1,0,0,1,0,0
6480bb9affabe4960a987464,2007/08,,,1,R Dravid,W Jaffer,4,7,0,0,1,2,3,0,0,1,4,0,0
6480bb95cf9d446747bd74fe,2019,,,1,AR Patel,S Dhawan,4,4,0,0,1,1,1,0,0,3,3,0,0
6480bb9e21655ee16a96b2c3,2012,,,1,M Kaif,R Vinay Kumar,4,6,0,0,1,2,3,0,0,2,3,0,0
6480bb98373b1ea5035ab3da,2021,,,2,SP Narine,Shubman Gill,4,3,0,0,1,2,2,0,0,1,1,0,0
6480bba0f1ebf9ff255e1c91,2013,,,2,GH Vihari,NLTC Perera,4,6,1,0,1,0,2,0,0,4,4,1,0
6480bb9b1fc007965b68d4d9,2009,,,2,SR Tendulkar,ST Jayasuriya,4,10,0,0,1,2,2,0,0,1,8,0,0
6480bb954714437843ab3647,2019,,,2,B Kumar,Sandeep Sharma,4,4,0,0,1,1,3,0,0,1,1,0,0
6480bb94f1c027945eeb8b10,2017,,,2,Harbhajan Singh,KV Sharma,4,4,0,0,1,1,3,0,0,0,1,0,0
6480bb9d5d93b08a19c16313,2009/10,,,2,AD Mathews,WP Saha,4,7,0,0,1,3,5,0,0,1,2,0,0
6480bb976344f6d667dfd965,2021,,,2,N Rana,TG Southee,4,7,0,0,1,1,2,0,0,3,5,0,0
6480bba063bacaa2dfabf6fd,2014,,,2,KP Pietersen,M Vijay,4,6,1,0,1,0,4,0,0,4,2,1,0
6480bb9d362f72789dcdc5a7,2009/10,,,1,M Vijay,MS Dhoni,4,5,1,0,1,4,3,1,0,0,2,0,0
6480bba0a4e7c61a5656729e,2014,,,2,PA Patel,V Kohli,4,2,1,0,1,0,0,0,0,4,2,1,0
6480bba0ad06ad631cf7665f,2014,,,1,BW Hilfenhaus,M Manhas,4,1,1,0,0,0,0,0,0,4,1,1,0
6480bba1b85900d7d83de308,2014,,,2,M Vohra,V Sehwag,4,2,1,0,1,0,0,0,0,4,2,1,0
6480bb99f816e64203e3c687,2023,,,2,AS Roy,Rahmanullah Gurbaz,4,5,1,0,1,4,5,1,0,0,0,0,0
6480bb9b724406459cd357c9,2007/08,,,2,A Kumble,Z Khan,4,1,0,0,0,0,1,0,0,0,0,0,0
6480bb97aad3147696268239,2021,,,1,F du Plessis,RD Gaikwad,4,4,1,0,1,0,0,0,0,4,4,1,0
6480bb9a51ee1ef33a5b2dbb,2007/08,,,1,IK Pathan,K Goel,4,8,0,0,1,1,4,0,0,2,4,0,0
6480bb94bf9a1728b1b12f4d,2018,,,1,MK Pandey,YK Pathan,4,5,0,0,1,2,2,0,0,2,3,0,0
6480bb984a8abbb79a69e6ce,2022,,,2,Abhishek Sharma,RA Tripathi,4,9,0,0,1,0,6,0,0,0,3,0,0
6480bb94738952e740c68749,2018,,,2,AJ Tye,R Ashwin,4,2,1,0,1,4,2,1,0,0,0,0,0
6480bb9af85f41b4de44ca19,2023,,,1,AT Rayudu,DP Conway,4,2,1,0,1,4,1,1,0,0,1,0,0
6480bb9c50838010977c168c,2009,,,2,KC Sangakkara,Yuvraj Singh,4,9,0,0,1,2,3,0,0,2,6,0,0
6480bb9bf2869505c9393b7d,2009,,,2,BJ Hodge,SC Ganguly,4,10,0,0,1,2,5,0,0,0,5,0,0
6480bba2679194b06d4834db,2016,,,1,DA Warner,S Dhawan,4,5,0,0,1,1,1,0,0,2,4,0,0
6480bb9e34659755628e7471,2012,,,1,JD Ryder,MN Samuels,4,5,0,0,1,1,2,0,0,1,3,0,0
6480bb958f77e7d3929d28e3,2018,,,1,DA Miller,KK Nair,4,6,0,0,1,1,3,0,0,2,3,0,0
6480bb9e19dd5297ba8ca5f7,2011,,,1,MK Pandey,SC Ganguly,4,11,1,0,1,4,6,1,0,0,5,0,0
6480bb9f955d5c84cde78f58,2012,,,2,AD Mathews,M Kartik,4,6,0,0,1,1,2,0,0,3,4,0,0
6480bba163bd0c619365a16b,2015,,,2,AT Rayudu,Harbhajan Singh,4,2,1,0,1,4,2,1,0,0,0,0,0
6480bba0f1ebf9ff255e1c91,2013,,,2,KC Sangakkara,S Dhawan,4,5,1,0,1,4,4,1,0,0,1,0,0
6480bb983ad1bab18d1d8774,2022,,,2,KD Karthik,PWH de Silva,4,3,1,0,1,0,0,0,0,4,3,1,0
6480bb958f737f809dfb65e1,2019,,,2,DA Warner,V Shankar,4,7,0,0,1,3,5,0,0,1,2,0,0
6480bb954817ed0a4ba25bc2,2018,,,2,KL Rahul,MP Stoinis,4,4,0,0,1,3,2,0,0,1,2,0,0
6480bb94738952e740c68749,2018,,,1,Mohammad Nabi,YK Pathan,4,2,1,0,1,4,2,1,0,0,0,0,0
6480bba03ef1ed797291b091,2013,,,1,AT Rayudu,RG Sharma,4,8,0,0,1,2,5,0,0,2,3,0,0
6480bb9bdde9db92f880e40d,2007/08,,,1,A Chopra,SC Ganguly,4,5,0,0,1,2,3,0,0,2,2,0,0
6480bb9a51ee1ef33a5b2dbb,2007/08,,,1,DPMD Jayawardene,K Goel,4,4,1,0,1,0,1,0,0,4,3,1,0
6480bb9b2a5f2fd5053534dc,2007/08,,,1,PR Shah,RV Uthappa,4,5,0,0,1,1,2,0,0,2,3,0,0
6480bba0295edd6084b9503b,2014,,,2,AM Nayar,AM Rahane,4,3,1,0,1,4,3,1,0,0,0,0,0
6480bb94cf431881ac3e9cbf,2018,,,1,CH Morris,R Tewatia,4,2,1,0,0,0,0,0,0,4,2,1,0
6480bb93894ff5c944493650,2017,,,1,DR Smith,SK Raina,4,1,1,0,0,0,0,0,0,4,1,1,0
6480bb99c26e725b7b6f1637,2023,,,1,KH Pandya,N Pooran,4,2,1,0,1,4,2,1,0,0,0,0,0
6480bba07fa24b891b818984,2013,,,1,AC Gilchrist,Azhar Mahmood,4,4,1,0,1,4,2,1,0,0,2,0,0
6480bb9808d6857eeb335d94,2022,,,1,AJ Finch,VR Iyer,4,9,0,0,1,3,7,0,0,0,2,0,0
6480bb973d98bfd2d4a5f108,2020/21,,,2,CV Varun,M Prasidh Krishna,4,6,0,0,0,2,3,0,0,2,3,0,0
6480bb99b0fa4d217ed7f255,2023,,,2,AK Markram,Abhishek Sharma,4,6,0,0,1,2,3,0,0,2,3,0,0
6480bb9b283b30d0503656f7,2007/08,,,1,MK Tiwary,S Dhawan,4,1,1,0,0,4,1,1,0,0,0,0,0
6480bb947b065b9dc0256f0d,2018,,,1,DJM Short,SV Samson,4,7,0,0,1,1,3,0,0,2,4,0,0
6480bba2f3ed8323f852acfa,2016,,,2,AR Patel,R Dhawan,4,4,0,0,0,1,2,0,0,3,2,0,0
6480bb9bc74c35e494cec477,2007/08,,,2,RP Singh,Y Venugopal Rao,4,4,0,0,1,2,3,0,0,1,1,0,0
6480bb96c10dfe3d8c259db3,2020/21,,,1,I Udana,Washington Sundar,4,2,1,0,1,4,2,1,0,0,0,0,0
6480bb93f866249511c76dbc,2017,,,2,LH Ferguson,RD Chahar,4,3,0,0,0,1,1,0,0,3,2,0,0
6480bb96fed7a7ee65076e4a,2020/21,,,2,DA Warner,JM Bairstow,4,4,1,0,1,4,4,1,0,0,0,0,0
6480bba0a3e806f41a4dab41,2013,,,2,M Kartik,R Vinay Kumar,4,6,0,0,1,0,1,0,0,3,5,0,0
6480bba1e64915b9e7c849ca,2014,,,1,KD Karthik,KM Jadhav,4,2,1,0,1,4,1,1,0,0,1,0,0
6480bb9e05381e16815803e9,2011,,,1,RJ Harris,SD Chitnis,4,4,1,0,1,4,4,1,0,0,0,0,0
6480bb9b166300b6298fc71a,2009,,,1,DPMD Jayawardene,KC Sangakkara,4,6,0,0,1,2,3,0,0,1,3,0,0
6480bb9c757dbd7f92b1130a,2009/10,,,2,SR Tendulkar,SS Tiwary,4,3,1,0,1,0,0,0,0,4,3,1,0
6480bba048fb3d33ea0711e7,2013,,,1,LA Pomersbach,P Kumar,4,5,0,0,1,2,2,0,0,1,3,0,0
6480bb945f95e767a8a9cc10,2017,,,1,RA Tripathi,SPD Smith,4,2,1,0,1,0,0,0,0,4,2,1,0
6480bb9ef18c54e7aafdd223,2012,,,2,Bipul Sharma,PP Chawla,4,6,0,0,1,1,2,0,0,3,4,0,0
6480bb99f33a7dd80eb0a544,2023,,,2,K Rabada,M Shahrukh Khan,4,4,0,0,1,0,1,0,0,3,3,0,0
6480bba13b673297bce003e2,2014,,,2,AB de Villiers,S Rana,4,4,0,0,1,3,3,0,0,1,1,0,0
6480bb9940bd3bf36dd4897f,2023,,,1,Shubman Gill,WP Saha,4,8,0,0,1,0,2,0,0,4,6,0,0
6480bb97af05ebd5c4f575c4,2021,,,2,B Kumar,V Shankar,4,5,0,0,1,0,0,0,0,4,5,0,0
6480bb9698a1d9136a13faf6,2020/21,,,1,CH Gayle,Mandeep Singh,4,7,0,0,1,1,3,0,0,3,4,0,0
6480bb99cbb648c5c0ecb205,2023,,,1,N Rana,Rahmanullah Gurbaz,4,3,1,0,1,4,3,1,0,0,0,0,0
6480bb990942cd416cf5f447,2022,,,2,DJ Hooda,MP Stoinis,4,3,0,0,1,1,1,0,0,2,2,0,0
6480bb99409885bcc7b67109,2023,,,2,AM Rahane,S Dube,4,6,0,0,1,1,2,0,0,2,4,0,0
6480bb9822eeb0c1c117f221,2021,,,2,RD Gaikwad,SN Thakur,4,3,0,0,1,3,2,0,0,0,1,0,0
6480bba1017a98eead1ec861,2015,,,1,JP Faulkner,KK Nair,4,4,0,0,1,1,3,0,0,1,1,0,0
6480bba1af9481df8b4f9f0f,2015,,,1,AD Russell,PP Chawla,4,1,1,0,0,4,1,1,0,0,0,0,0
6480bb9516b0dbc1972e5c3c,2018,,,2,H Klaasen,STR Binny,4,7,0,0,1,4,4,0,0,0,3,0,0
6480bba37e4fcb8af147f79b,2016,,,2,Q de Kock,SS Iyer,4,13,0,0,1,2,8,0,0,2,5,0,0
6480bb9e565ef5f11c5c8f55,2011,,,2,CH Gayle,SS Tiwary,4,9,0,0,1,0,7,0,0,1,2,0,0
6480bba273adb498d96b27a9,2016,,,1,Mohammed Shami,RR Pant,4,4,0,0,1,0,1,0,0,3,3,0,0
6480bb977453ebef15f59e25,2021,,,2,MP Stoinis,RR Pant,4,3,1,0,1,0,0,0,0,4,3,1,0
6480bba2f05e90a9005771d2,2015,,,1,EJG Morgan,KV Sharma,4,2,1,0,1,0,0,0,0,4,2,1,0
6480bb9dc8b09381d0f01a9d,2011,,,2,JE Taylor,NL McCullum,4,2,0,0,1,2,1,0,0,1,1,0,0
6480bb93c1cc671d66c471ba,2017,,,2,CA Lynn,RV Uthappa,4,3,1,0,1,0,0,0,0,4,3,1,0
6480bb96ebf33df82879ad4c,2020/21,,,2,F du Plessis,SR Watson,4,15,0,0,1,2,9,0,0,1,6,0,0
6480bb967c50ceac62ba0719,2020/21,,,1,PP Shaw,S Dhawan,4,3,1,0,1,4,3,1,0,0,0,0,0
6480bba0ddcc30675d83403c,2013,,,2,Q de Kock,S Dhawan,4,3,1,0,1,4,3,1,0,0,0,0,0
6480bb961ee814aee7b674ac,2020/21,,,1,SO Hetmyer,SS Iyer,4,3,1,0,1,4,3,1,0,0,0,0,0
6480bb99f47261f111a6cc1a,2023,,,2,Ishan Kishan,RG Sharma,4,12,0,0,1,1,4,0,0,2,8,0,0
6480bba0cdc200ad3ab8fbf5,2014,,,1,BB McCullum,SK Raina,4,8,0,0,1,3,4,0,0,1,4,0,0
6480bb9c8cbb5dec60b7d50a,2009/10,,,2,RG Sharma,Y Venugopal Rao,4,6,0,0,1,1,1,0,0,2,5,0,0
6480bb9fe7d0f611ba6ad229,2012,,,1,R Sharma,SPD Smith,4,4,0,0,1,0,2,0,0,3,2,0,0
6480bb97aed297ca9686c94a,2021,,,1,CH Gayle,DJ Hooda,4,9,0,0,1,0,2,0,0,3,7,0,0
6480bb9c50838010977c168c,2009,,,1,R Ashwin,T Thushara,4,2,1,0,1,4,2,1,0,0,0,0,0
6480bb9e05571c1a4c163ef1,2012,,,2,BJ Hodge,OA Shah,4,7,0,0,1,3,5,0,0,1,2,0,0
6480bba0587190387a754733,2013,,,1,IK Pathan,UT Yadav,4,1,1,0,0,0,0,0,0,4,1,1,0
6480bb971ffe5345804e7f32,2020/21,,,1,AR Patel,AT Carey,4,4,0,0,1,3,2,0,0,1,2,0,0
6480bb9c266a85f1960d87e9,2009,,,1,A Nehra,PJ Sangwan,4,3,0,0,0,1,1,0,0,3,2,0,0
6480bb966539f85263cb6429,2019,,,1,F du Plessis,SR Watson,4,20,0,0,1,4,11,0,0,0,9,0,0
6480bb94dfad571ef76493a9,2017,,,1,CJ Anderson,MN Samuels,4,7,1,0,1,4,5,1,0,0,2,0,0
6480bb9da3dc1406b000cc98,2011,,,2,MS Wade,Y Venugopal Rao,4,8,0,0,1,3,4,0,0,1,4,0,0
6480bb9fe7d0f611ba6ad229,2012,,,1,MD Mishra,MJ Clarke,4,4,1,0,1,4,4,1,0,0,0,0,0
6480bb94aad1a08ca4276b4e,2018,,,2,CR Woakes,Mandeep Singh,4,3,0,0,1,1,1,0,0,3,2,0,0
6480bb99b3179a9346d8883c,2022,,,1,D Padikkal,HE van der Dussen,4,4,0,0,1,1,2,0,0,3,2,0,0
6480bb9c8c6c106c6ffbeae4,2009/10,,,1,EJG Morgan,RV Uthappa,4,8,0,0,1,2,4,0,0,2,4,0,0
6480bb95014388d3e8c62904,2019,,,1,Mohammed Siraj,TG Southee,4,7,0,0,1,1,5,0,0,2,2,0,0
6480bb9404b444be6724e41e,2017,,,1,A Mishra,Mohammed Shami,4,6,0,0,1,1,2,0,0,2,4,0,0
6480bb9ce7891d47a7fe9c12,2009/10,,,2,Bipul Sharma,IK Pathan,4,4,0,0,0,1,1,0,0,3,3,0,0
6480bb9df46e9f48932124df,2009/10,,,2,AB McDonald,KD Karthik,4,7,0,0,1,2,4,0,0,2,3,0,0
6480bba071a7a0cbb02d505a,2013,,,1,DPMD Jayawardene,V Sehwag,4,4,1,0,1,4,4,1,0,0,0,0,0
6480bba2965d1d15aa6f723e,2016,,,1,JP Duminy,KK Nair,4,2,1,0,1,0,0,0,0,4,2,1,0
6480bb97aad3147696268239,2021,,,1,F du Plessis,SK Raina,4,6,0,0,1,2,3,0,0,2,3,0,0
6480bb95fa6394e733c532a9,2018,,,1,Rashid Khan,Shakib Al Hasan,4,3,1,0,1,0,0,0,0,4,3,1,0
6480bb9a8cf29e28434bb1d5,2023,,,1,A Nortje,RV Patel,4,8,0,0,1,3,6,0,0,1,2,0,0
6480bb9a4de9fe3e7319ce39,2007/08,,,1,R Vinay Kumar,Z Khan,4,5,0,0,0,1,1,0,0,2,4,0,0
6480bba0b46cf5430edef3f5,2014,,,2,Shakib Al Hasan,YK Pathan,4,4,0,0,1,1,2,0,0,2,2,0,0
6480bb978c66ea3d9c85132d,2020/21,,,2,S Nadeem,Sandeep Sharma,4,7,0,0,0,2,3,0,0,2,4,0,0
6480bba1105add9a994c58a7,2014,,,1,KM Jadhav,R Shukla,4,6,0,0,1,2,3,0,0,2,3,0,0
6480bb97aa725a640d0f8e2f,2021,,,1,LS Livingstone,R Tewatia,4,5,0,0,1,2,2,0,0,2,3,0,0
6480bba2b341a081c069198d,2015,,,2,Ankit Sharma,DJ Hooda,4,5,0,0,1,1,1,0,0,3,4,0,0
6480bb9d40fc01528c7b7270,2009/10,,,1,NV Ojha,SR Watson,4,4,1,0,1,0,2,0,0,4,2,1,0
6480bba0001885407e860a8d,2013,,,2,IK Pathan,S Nadeem,4,7,0,0,1,4,4,0,0,0,3,0,0
6480bba1827557ebdfc70821,2015,,,2,PP Chawla,YK Pathan,4,1,1,0,0,4,1,1,0,0,0,0,0
6480bb9d69cb9046a72d8fbe,2009/10,,,1,S Badrinath,SK Raina,4,10,0,0,1,1,6,0,0,2,4,0,0
6480bb9692a7f0d52bd43127,2019,,,2,DA Miller,KL Rahul,4,6,0,0,1,2,3,0,0,2,3,0,0
6480bb99b35dc0981e512451,2022,,,1,R Ashwin,R Parag,4,5,0,0,1,2,3,0,0,2,2,0,0
6480bb971ffe5345804e7f32,2020/21,,,1,AR Patel,R Ashwin,4,2,1,0,1,4,2,1,0,0,0,0,0
6480bb9b69f8ace7659e486d,2009,,,1,JDP Oram,SK Raina,4,10,0,0,1,2,6,0,0,1,4,0,0
6480bba2eea6f31945e4c5e2,2016,,,1,SA Yadav,YK Pathan,4,1,1,0,0,4,1,1,0,0,0,0,0
6480bba1105add9a994c58a7,2014,,,1,JP Duminy,LR Shukla,4,4,1,0,1,0,0,0,0,4,4,1,0
6480bb9aa64355ce98da1141,2007/08,,,1,DT Patil,R Dravid,4,2,1,0,1,4,1,1,0,0,1,0,0
6480bb98960cf9374ee9420d,2022,,,2,RG Sharma,SA Yadav,4,7,0,0,1,2,5,0,0,2,2,0,0
6480bb945460b25d997060fb,2018,,,2,G Gambhir,JJ Roy,4,5,0,0,1,2,2,0,0,1,3,0,0
6480bba01893b0faadb9c761,2013,,,2,AB de Villiers,SS Tiwary,4,2,0,0,1,0,1,0,0,1,1,0,0
6480bb995f3db9699a1f794d,2022,,,1,MJ Santner,Simarjeet Singh,4,5,0,0,0,1,2,0,0,3,3,0,0
6480bb97af05ebd5c4f575c4,2021,,,2,DA Warner,MK Pandey,4,10,0,0,1,1,3,0,0,2,7,0,0
6480bb9c454e9eefca545bde,2009/10,,,2,AA Jhunjhunwala,AC Voges,4,1,1,0,0,0,0,0,0,4,1,1,0
6480bb9e6d7f7f691dde322d,2012,,,2,IR Jaggi,S Dhawan,4,11,0,0,1,2,7,0,0,2,4,0,0
6480bb993e44f97eccb361fe,2023,,,1,A Badoni,K Gowtham,4,5,0,0,1,1,3,0,0,1,2,0,0
6480bb96267b63eb2c6747b0,2019,,,2,MP Stoinis,Washington Sundar,4,4,0,0,1,2,2,0,0,1,2,0,0
6480bb9cf1471ad233c7b0af,2009,,,2,J Botha,YK Pathan,3,7,0,0,1,2,2,0,0,1,5,0,0
6480bb96e18d7a1b3e62552d,2019,,,1,DA Warner,Mohammad Nabi,3,3,0,0,1,0,1,0,0,3,2,0,0
6480bb984a44a355b856fd1a,2022,,,1,Anuj Rawat,GJ Maxwell,3,3,0,0,1,0,1,0,0,1,2,0,0
6480bb9b95eac8df5d0180b0,2007/08,,,2,JR Hopes,SE Marsh,3,7,0,0,1,1,2,0,0,2,5,0,0
6480bb9c5ec0713155cad138,2009/10,,,1,A Symonds,HH Gibbs,3,7,0,0,1,1,2,0,0,2,5,0,0
6480bb9ded279701c84af803,2011,,,1,S Anirudha,S Badrinath,3,2,0,0,0,3,2,0,0,0,0,0,0
6480bb9ca181f55cb21526f5,2009/10,,,1,AT Rayudu,SR Tendulkar,3,4,0,0,1,3,4,0,0,0,0,0,0
6480bb9f146f5849bb759148,2013,,,2,AD Mathews,LRPL Taylor,3,3,0,0,1,0,0,0,0,3,3,0,0
6480bb9cf1471ad233c7b0af,2009,,,1,AB de Villiers,V Sehwag,3,4,0,0,1,3,3,0,0,0,1,0,0
6480bb94351a8b10e20d14d9,2017,,,2,AJ Finch,KD Karthik,3,3,0,0,1,2,2,0,0,1,1,0,0
6480bb9c8c6c106c6ffbeae4,2009/10,,,1,MV Boucher,V Kohli,3,5,0,0,1,2,3,0,0,1,2,0,0
6480bb9cff4ec2f71cdf18d1,2009/10,,,2,SE Marsh,Yuvraj Singh,3,4,0,0,1,1,1,0,0,2,3,0,0
6480bba01a3f8444c7a33ba6,2014,,,2,MS Dhoni,RA Jadeja,3,6,0,0,1,2,3,0,0,1,3,0,0
6480bba0d2cdb40c68c4739c,2013,,,1,M Vijay,MS Dhoni,3,5,0,0,1,2,4,0,0,1,1,0,0
6480bba0e883438915efc1e6,2013,,,1,RV Uthappa,Yuvraj Singh,3,2,0,0,1,1,2,0,0,0,0,0,0
6480bb99bb362e3714226928,2022,,,2,Avesh Khan,Mohsin Khan,3,4,0,0,0,1,2,0,0,1,2,0,0
6480bba0295edd6084b9503b,2014,,,1,DJG Sammy,Y Venugopal Rao,3,3,0,0,1,0,1,0,0,2,2,0,0
6480bb943565d22d24ec0ae8,2017,,,2,G Gambhir,RV Uthappa,3,7,0,0,1,3,7,0,0,0,0,0,0
6480bba2b341a081c069198d,2015,,,2,CH Morris,DJ Hooda,3,7,0,0,1,0,3,0,0,3,4,0,0
6480bba177ab201442a0e3c8,2015,,,1,AN Ahmed,HV Patel,3,2,0,0,1,0,0,0,0,2,2,0,0
6480bb9a3ffea6235f54cc1e,2023,,,1,RK Singh,SP Narine,3,7,0,0,1,2,5,0,0,1,2,0,0
6480bba000b91f6c5cf57fdb,2013,,,2,BJ Hodge,KK Cooper,3,4,0,0,1,1,2,0,0,2,2,0,0
6480bb9873e53eace3a69dc7,2022,,,2,TG Southee,UT Yadav,3,4,0,0,0,1,1,0,0,2,3,0,0
6480bb995193664eda3e9e10,2022,,,1,N Rana,RK Singh,3,3,0,0,1,0,1,0,0,3,2,0,0
6480bb94ca96a1c1f17d1294,2017,,,2,Sachin Baby,V Kohli,3,6,0,0,1,2,4,0,0,1,2,0,0
6480bb954714437843ab3647,2019,,,1,AR Patel,K Rabada,3,3,0,0,0,1,1,0,0,2,2,0,0
6480bb9a81d7fd0ac0307b4d,2023,,,2,DJ Hooda,K Gowtham,3,4,0,0,1,1,1,0,0,2,3,0,0
6480bb9dbefe5e2cceb23e01,2011,,,2,MS Dhoni,S Badrinath,3,6,0,0,1,3,6,0,0,0,0,0,0
6480bb989bf19eb260a04f0e,2022,,,2,Abhishek Sharma,KS Williamson,3,10,0,0,1,3,10,0,0,0,0,0,0
6480bb9384cbae8edee3707f,2017,,,1,HH Pandya,MJ McClenaghan,3,3,0,0,1,2,2,0,0,1,1,0,0
6480bb9d8f5769d3a514fd88,2009/10,,,1,A Kumble,LRPL Taylor,3,3,0,0,0,1,2,0,0,1,1,0,0
6480bba2a01f4062fc561247,2016,,,1,P Sahu,SE Marsh,3,3,0,0,1,1,1,0,0,2,2,0,0
6480bb971c9e4a3ef11759f3,2021,,,1,CJ Jordan,Ravi Bishnoi,3,5,0,0,1,1,1,0,0,1,4,0,0
6480bba29f384ce360fa8131,2016,,,2,IK Pathan,R Ashwin,3,4,0,0,1,2,2,0,0,1,2,0,0
6480bb96686655f09172741d,2020/21,,,2,I Udana,S Dube,3,7,0,0,1,1,2,0,0,1,5,0,0
6480bb97dee20878b0c4246c,2021,,,2,D Padikkal,V Kohli,3,5,0,0,1,0,1,0,0,3,4,0,0
6480bb9d61e9b86b0f0aae49,2009/10,,,2,A Kumble,R Vinay Kumar,3,7,0,0,1,2,4,0,0,0,3,0,0
6480bb9772f78629131db057,2021,,,1,F du Plessis,RV Uthappa,3,7,0,0,1,1,1,0,0,2,6,0,0
6480bba2f36e449a59f4a812,2015,,,1,MA Agarwal,Yuvraj Singh,3,6,0,0,1,1,1,0,0,2,5,0,0
6480bb996c5ae75a32d978e8,2022,,,1,MJ Santner,N Jagadeesan,3,3,0,0,0,1,1,0,0,2,2,0,0
6480bba287d112bccc55ccd2,2015,,,2,Mandeep Singh,SN Khan,3,5,0,0,1,1,3,0,0,2,2,0,0
6480bb987c720def5fbaf218,2022,,,1,LS Livingstone,S Dhawan,3,4,0,0,1,2,3,0,0,1,1,0,0
6480bb9f70156528a31bb270,2013,,,1,CH Gayle,MA Agarwal,3,8,0,0,1,1,3,0,0,1,5,0,0
6480bb9e9162dceff15dc334,2011,,,2,DJ Hussey,SE Marsh,3,5,0,0,1,2,2,0,0,0,3,0,0
6480bb961570df6942a00888,2019,,,2,F du Plessis,SR Watson,3,15,0,0,1,1,7,0,0,2,8,0,0
6480bb9b2a5f2fd5053534dc,2007/08,,,1,A Nehra,CRD Fernando,3,2,0,0,1,0,1,0,0,2,1,0,0
6480bb984a8abbb79a69e6ce,2022,,,1,NM Coulter-Nile,R Parag,3,4,0,0,1,1,2,0,0,1,2,0,0
6480bb9442c4889bcbb4a784,2017,,,1,SA Yadav,UT Yadav,3,3,0,0,0,1,1,0,0,2,2,0,0
6480bb9f210b6e50fb2072ae,2013,,,2,MK Tiwary,R Bhatia,3,4,0,0,1,1,3,0,0,1,1,0,0
6480bb942efd740a6ffc47df,2017,,,1,KH Pandya,RG Sharma,3,3,0,0,1,2,2,0,0,1,1,0,0
6480bb9a8053274c083224d9,2023,,,1,JC Archer,T Stubbs,3,3,0,0,1,3,2,0,0,0,1,0,0
6480bba3fc9599eca1b87a77,2016,,,2,AJ Finch,DJ Bravo,3,5,0,0,1,2,3,0,0,1,2,0,0
6480bb9e80233e83b9d1be1f,2012,,,1,RE Levi,RG Sharma,3,8,0,0,1,1,3,0,0,2,5,0,0
6480bb9f0f1f6c03d8e2f039,2013,,,2,BB Samantray,NLTC Perera,3,8,0,0,1,1,4,0,0,2,4,0,0
6480bb9aa030c8ebcbcc19c9,2007/08,,,1,AM Rahane,ST Jayasuriya,3,9,0,0,1,0,7,0,0,3,2,0,0
6480bb9dc8b09381d0f01a9d,2011,,,2,AC Thomas,M Kartik,3,4,0,0,0,1,2,0,0,1,2,0,0
6480bba1de7febd9f1f0138e,2014,,,2,JP Faulkner,STR Binny,3,5,0,0,1,1,4,0,0,2,1,0,0
6480bb95a65bb0f3394a62b5,2018,,,2,AT Rayudu,SK Raina,3,4,0,0,1,1,1,0,0,2,3,0,0
6480bb9cc5312f3d7cfb650e,2009/10,,,1,MS Bisla,SE Marsh,3,10,0,0,1,1,1,0,0,2,9,0,0
6480bb9480627b50308b7903,2017,,,2,Harbhajan Singh,KH Pandya,3,4,0,0,1,0,1,0,0,3,3,0,0
6480bb9b69f8ace7659e486d,2009,,,2,M Rawat,SK Warne,3,3,0,0,1,1,1,0,0,1,2,0,0
6480bb9a1032ce724214f6dd,2007/08,,,1,AM Nayar,DJ Bravo,3,8,0,0,1,2,6,0,0,1,2,0,0
6480bb9f8d3b0a3d1e28a4b7,2013,,,2,GH Vihari,KV Sharma,3,5,0,0,1,1,2,0,0,2,3,0,0
6480bb9d0f6794fbf429449b,2011,,,1,G Gambhir,MS Bisla,3,5,0,0,1,3,5,0,0,0,0,0,0
6480bb984a44a355b856fd1a,2022,,,1,JR Hazlewood,Mohammed Siraj,3,5,0,0,1,1,1,0,0,2,4,0,0
6480bb9fcb2b412c0ebd4afa,2013,,,2,JD Unadkat,M Kartik,3,3,0,0,0,1,1,0,0,2,2,0,0
6480bb9e1d754facf4fad618,2012,,,2,AD Mathews,B Kumar,3,5,0,0,1,2,3,0,0,1,2,0,0
6480bba069d61566bb63ac2b,2014,,,1,JA Morkel,MA Starc,3,2,0,0,0,3,2,0,0,0,0,0,0
6480bb9558c0acb502a3b1a9,2019,,,1,Mandeep Singh,Mohammed Shami,3,3,0,0,1,3,2,0,0,0,1,0,0
6480bb9e80233e83b9d1be1f,2012,,,1,MM Patel,PP Ojha,3,9,0,0,1,1,5,0,0,2,4,0,0
6480bba265483f7db002ec7c,2015,,,1,M Vijay,SE Marsh,3,5,0,0,1,0,1,0,0,1,4,0,0
6480bba0dcd1149b9b0b501f,2013,,,1,RV Uthappa,Yuvraj Singh,3,5,0,0,1,2,3,0,0,1,2,0,0
6480bb9737b1d7284b5297c1,2021,,,2,AB de Villiers,Shahbaz Ahmed,3,5,0,0,1,1,3,0,0,1,2,0,0
6480bb966f48b8ee03e6dff5,2020/21,,,1,AT Rayudu,F du Plessis,3,5,0,0,1,2,3,0,0,1,2,0,0
6480bb9c9e328ac30bcaf6b0,2009/10,,,2,DJ Bravo,SS Tiwary,3,4,0,0,1,2,3,0,0,1,1,0,0
6480bb9c121ee402b7b2eda6,2009,,,2,A Symonds,RG Sharma,3,6,0,0,1,2,3,0,0,1,3,0,0
6480bba1dd2f8125fc8b203f,2014,,,2,MG Johnson,WP Saha,3,3,0,0,0,0,1,0,0,3,2,0,0
6480bb966539f85263cb6429,2019,,,2,CA Ingram,SS Iyer,3,8,0,0,1,1,5,0,0,2,3,0,0
6480bb9f03dd3a09740f0bd0,2013,,,2,Mohammed Shami,SP Narine,3,5,0,0,1,1,3,0,0,2,2,0,0
6480bba0eb5a345386bdc825,2013,,,1,DR Smith,RG Sharma,3,10,0,0,1,1,2,0,0,2,8,0,0
6480bb9c44492d9e5fc4bb60,2009/10,,,2,JH Kallis,V Kohli,3,7,0,0,1,1,2,0,0,2,5,0,0
6480bb977f55a1c473670850,2021,,,1,DA Miller,S Gopal,3,6,0,0,1,3,5,0,0,0,1,0,0
6480bba33dab752d79e587d2,2016,,,1,A Nehra,BB Sran,3,2,0,0,0,1,1,0,0,1,1,0,0
6480bb9e1d754facf4fad618,2012,,,1,MS Dhoni,SK Raina,3,4,0,0,1,3,2,0,0,0,2,0,0
6480bb9a1a3e8cef5633f4e6,2023,,,1,GD Phillips,H Klaasen,3,6,0,0,1,1,4,0,0,1,2,0,0
6480bb9aef150645306cc170,2023,,,2,MK Pandey,MR Marsh,3,7,0,0,1,1,3,0,0,2,4,0,0
6480bba1f5d65d6146678a7f,2015,,,2,RN ten Doeschate,YK Pathan,3,2,0,0,0,3,2,0,0,0,0,0,0
6480bb9894cc2d00f057a1f1,2021,,,2,EJG Morgan,RA Tripathi,3,6,0,0,1,0,3,0,0,3,3,0,0
6480bb96c95abb10156a6055,2020/21,,,1,HH Pandya,KA Pollard,3,4,0,0,1,1,2,0,0,2,2,0,0
6480bb9e2c96ab2b87d9466a,2011,,,2,DA Warner,V Sehwag,3,5,0,0,1,1,2,0,0,2,3,0,0
6480bba0120becd670aec59d,2013,,,1,AB Dinda,BAW Mendis,3,4,0,0,1,2,2,0,0,1,2,0,0
6480bb9db6a011b38afed5dc,2011,,,1,MD Mishra,WD Parnell,3,6,0,0,1,1,1,0,0,1,5,0,0
6480bb93c1cc671d66c471ba,2017,,,1,N Rana,RG Sharma,3,8,0,0,1,1,2,0,0,2,6,0,0
6480bb9f4780a208e13bfb3d,2013,,,2,DH Yagnik,JP Faulkner,3,7,0,0,1,0,0,0,0,3,7,0,0
6480bb9c8f3ef1685cdf4017,2009,,,1,AB de Villiers,TM Dilshan,3,3,0,0,1,1,1,0,0,1,2,0,0
6480bb953b102c650968cba2,2019,,,1,Navdeep Saini,PA Patel,3,4,0,0,1,2,3,0,0,1,1,0,0
6480bb9e156723e64d6bd26b,2012,,,2,RE Levi,RG Sharma,3,13,0,0,1,1,7,0,0,2,6,0,0
6480bb9b4b74852492343291,2007/08,,,1,CL White,Misbah-ul-Haq,3,5,0,0,1,1,2,0,0,2,3,0,0
6480bb98de3641699db2c5a1,2021,,,1,AT Rayudu,RV Uthappa,3,5,0,0,1,2,3,0,0,1,2,0,0
6480bb9e05381e16815803e9,2011,,,1,P Kumar,SJ Srivastava,3,5,0,0,0,2,4,0,0,1,1,0,0
6480bb9e80233e83b9d1be1f,2012,,,1,Harbhajan Singh,KD Karthik,3,5,0,0,1,2,3,0,0,1,2,0,0
6480bba373508e4f3f4be6c0,2016,,,1,G Gambhir,MK Pandey,3,2,0,0,1,0,1,0,0,3,1,0,0
6480bb9f58a3e7ea877fc9dc,2012,,,2,Mandeep Singh,N Saini,3,5,0,0,1,1,1,0,0,2,4,0,0
6480bb9940bd3bf36dd4897f,2023,,,1,DA Miller,R Tewatia,3,4,0,0,1,1,2,0,0,2,2,0,0
6480bb9d61e9b86b0f0aae49,2009/10,,,2,RV Uthappa,V Kohli,3,4,0,0,1,0,0,0,0,3,4,0,0
6480bb9ee779ef1e445d0506,2012,,,1,JEC Franklin,RG Sharma,3,5,0,0,1,1,2,0,0,0,3,0,0
6480bba18a2fe828fa106f6c,2014,,,1,KK Nair,STR Binny,3,12,0,0,1,1,2,0,0,2,10,0,0
6480bb94c008939d7976abfe,2018,,,1,K Gowtham,RA Tripathi,3,1,0,0,0,2,1,0,0,0,0,0,0
6480bb9f70156528a31bb270,2013,,,1,CH Gayle,TM Dilshan,3,14,0,0,1,3,6,0,0,0,8,0,0
6480bb9a6e44b0c8da00ca72,2007/08,,,2,AM Nayar,SM Pollock,3,5,0,0,1,2,3,0,0,1,2,0,0
6480bb9692a7f0d52bd43127,2019,,,2,M Ashwin,Mandeep Singh,3,3,0,0,0,1,2,0,0,2,1,0,0
6480bb9ed74d222a3da56dfa,2012,,,2,RN ten Doeschate,Shakib Al Hasan,3,3,0,0,1,2,2,0,0,1,1,0,0
6480bb96d1b3bea0aa2127e4,2020/21,,,1,HH Pandya,KA Pollard,3,4,0,0,1,2,3,0,0,1,1,0,0
6480bb9f146f5849bb759148,2013,,,2,LRPL Taylor,MK Pandey,3,9,0,0,1,2,3,0,0,1,6,0,0
6480bba11eff9b230a172302,2014,,,1,G Gambhir,SA Yadav,3,4,0,0,1,1,2,0,0,1,2,0,0
6480bb99f649ea7a6d79892f,2023,,,1,Harpreet Brar,S Dhawan,3,4,0,0,1,1,2,0,0,2,2,0,0
6480bb9c9e328ac30bcaf6b0,2009/10,,,2,R McLaren,R Sathish,3,4,0,0,1,1,1,0,0,2,3,0,0
6480bb984a8abbb79a69e6ce,2022,,,2,Abhishek Sharma,KS Williamson,3,10,0,0,1,1,3,0,0,2,7,0,0
6480bb96b56e8d513b451da1,2020/21,,,1,RA Tripathi,Shubman Gill,3,9,0,0,1,1,5,0,0,1,4,0,0
6480bba2f36e449a59f4a812,2015,,,1,DJ Muthuswami,Imran Tahir,3,5,0,0,1,1,3,0,0,2,2,0,0
6480bba3412663673a969a24,2016,,,2,GJ Bailey,R Bhatia,3,4,0,0,1,0,2,0,0,2,2,0,0
6480bb9df46e9f48932124df,2009/10,,,2,KD Karthik,V Sehwag,3,5,0,0,1,2,3,0,0,1,2,0,0
6480bb9cdf6c63fec90a42df,2009/10,,,1,LR Shukla,SE Bond,3,5,0,0,1,1,4,0,0,1,1,0,0
6480bb9e41b781523bd5aafe,2012,,,1,B Lee,R Bhatia,3,4,0,0,1,2,2,0,0,1,2,0,0
6480bb9a9dc58f49d783faa9,2023,,,2,Dhruv Jurel,SO Hetmyer,3,9,0,0,1,1,7,0,0,2,2,0,0
6480bb961ee814aee7b674ac,2020/21,,,1,A Nortje,K Rabada,3,1,0,0,0,3,1,0,0,0,0,0,0
6480bb973d64aa91e60b4088,2021,,,2,DA Miller,S Dube,3,5,0,0,1,2,2,0,0,1,3,0,0
6480bb971ffe5345804e7f32,2020/21,,,2,BA Stokes,SPD Smith,3,6,0,0,1,2,2,0,0,1,4,0,0
6480bb9a3ffea6235f54cc1e,2023,,,1,AS Roy,VG Arora,3,3,0,0,0,1,2,0,0,2,1,0,0
6480bb9399a527d39bc17dad,2017,,,1,BB McCullum,KD Karthik,3,8,0,0,1,2,4,0,0,1,4,0,0
6480bb9a8cf29e28434bb1d5,2023,,,2,HH Pandya,Rashid Khan,3,2,0,0,0,0,0,0,0,3,2,0,0
6480bb96267b63eb2c6747b0,2019,,,2,Gurkeerat Singh,S Dube,3,4,0,0,1,3,3,0,0,0,1,0,0
6480bb9aa37f3b44678752d9,2023,,,2,Noor Ahmad,Rashid Khan,3,7,0,0,1,1,3,0,0,2,4,0,0
6480bba0f858e6c12b25d8c3,2014,,,1,PP Chawla,SA Yadav,3,4,0,0,1,0,2,0,0,2,2,0,0
6480bba097818bcc0db9555d,2014,,,2,A Mishra,B Kumar,3,5,0,0,1,2,2,0,0,1,3,0,0
6480bba090c88df75eba18e6,2014,,,1,AM Nayar,STR Binny,3,1,0,0,0,3,1,0,0,0,0,0,0
6480bb99315aee6cd9d56504,2023,,,2,JD Unadkat,Ravi Bishnoi,3,3,0,0,1,0,1,0,0,3,2,0,0
6480bb9c4934a2adde9d76ce,2009/10,,,2,AD Mathews,CH Gayle,3,4,0,0,1,3,3,0,0,0,1,0,0
6480bba1e64915b9e7c849ca,2014,,,1,MK Tiwary,WD Parnell,3,3,0,0,1,1,1,0,0,2,2,0,0
6480bb96ee2a21f0d9b9f37f,2020/21,,,2,KL Nagarkoti,Shivam Mavi,3,4,0,0,0,1,1,0,0,1,3,0,0
6480bb976344f6d667dfd965,2021,,,1,AR Patel,RR Pant,3,6,0,0,1,0,5,0,0,1,1,0,0
6480bb9e56c724ba25b94666,2011,,,1,Bipul Sharma,KD Karthik,3,4,0,0,1,2,1,0,0,1,3,0,0
6480bb98cbaaf700d226941a,2022,,,1,Navdeep Saini,R Parag,3,3,0,0,1,2,2,0,0,1,1,0,0
6480bb971ffe5345804e7f32,2020/21,,,2,JC Archer,R Tewatia,3,7,0,0,1,1,4,0,0,2,3,0,0
6480bba2256bfaaf14c57ead,2015,,,2,PP Chawla,Shakib Al Hasan,3,4,0,0,1,0,1,0,0,2,3,0,0
6480bb97cca23939859c422e,2021,,,1,SO Hetmyer,SPD Smith,3,4,0,0,1,1,2,0,0,2,2,0,0
6480bba1dd2f8125fc8b203f,2014,,,1,CJ Anderson,KA Pollard,3,7,0,0,1,2,4,0,0,1,3,0,0
6480bba21bbf76a62abea528,2016,,,1,Ankit Sharma,I Sharma,3,2,0,0,0,3,2,0,0,0,0,0,0
6480bb961ee814aee7b674ac,2020/21,,,1,PP Shaw,SO Hetmyer,3,11,0,0,1,0,1,0,0,3,10,0,0
6480bb9e502d7987de08e5d5,2012,,,1,MN Samuels,SPD Smith,3,5,0,0,1,1,2,0,0,2,3,0,0
6480bb9a1032ce724214f6dd,2007/08,,,2,G Gambhir,V Sehwag,3,11,0,0,1,1,9,0,0,2,2,0,0
6480bb9c266a85f1960d87e9,2009,,,1,KD Karthik,MF Maharoof,3,8,0,0,1,0,0,0,0,3,8,0,0
6480bb97a4220e27710e38de,2021,,,1,D Padikkal,RM Patidar,3,4,0,0,1,2,2,0,0,1,2,0,0
6480bba20130c44ed20c9bcf,2016,,,2,AJ Finch,DJ Bravo,3,7,0,0,1,0,1,0,0,2,6,0,0
6480bb9dbefe5e2cceb23e01,2011,,,1,A Symonds,KA Pollard,3,4,0,0,0,1,2,0,0,0,2,0,0
6480bb98af25209ef756aa2c,2021,,,1,DT Christian,KA Jamieson,3,4,0,0,0,1,2,0,0,2,2,0,0
6480bb94009d0662ee94f07b,2018,,,1,PJ Sangwan,SA Yadav,3,7,0,0,1,0,3,0,0,2,4,0,0
6480bb9f23c17ccb47aa9e58,2013,,,2,M Vohra,Mandeep Singh,3,4,0,0,1,2,2,0,0,1,2,0,0
6480bb9c21492b9a562c6f46,2009/10,,,1,AC Voges,SK Warne,3,5,0,0,1,1,3,0,0,1,2,0,0
6480bb9c71030f4c6f018f55,2009,,,2,B Lee,PP Chawla,3,3,0,0,0,0,2,0,0,1,1,0,0
6480bb9dbefe5e2cceb23e01,2011,,,2,S Badrinath,S Randiv,3,5,0,0,1,1,1,0,0,2,4,0,0
6480bb94738952e740c68749,2018,,,2,BB Sran,R Ashwin,3,6,0,0,1,2,5,0,0,1,1,0,0
6480bb99c26e725b7b6f1637,2023,,,2,R Ashwin,R Parag,3,2,0,0,0,3,2,0,0,0,0,0,0
6480bb9f210b6e50fb2072ae,2013,,,2,G Gambhir,MS Bisla,3,6,0,0,1,1,1,0,0,1,5,0,0
6480bba2e3610f863b52b887,2016,,,1,MC Henriques,S Dhawan,3,6,0,0,1,1,4,0,0,1,2,0,0
6480bb9c442caaabe9eb2275,2009,,,2,AM Nayar,PR Shah,3,10,0,0,1,2,6,0,0,1,4,0,0
6480bb9929c7e430acd1ef18,2022,,,2,R Powell,SN Thakur,3,4,0,0,1,1,2,0,0,2,2,0,0
6480bb9f0f959bc6104820c3,2013,,,2,AL Menaria,KK Cooper,3,3,0,0,1,1,1,0,0,2,2,0,0
6480bb9f8d3b0a3d1e28a4b7,2013,,,2,DB Ravi Teja,KC Sangakkara,3,4,0,0,1,1,2,0,0,1,2,0,0
6480bb9435048f20502ba1e1,2018,,,2,BCJ Cutting,HH Pandya,3,4,0,0,1,2,1,0,0,1,3,0,0
6480bb9561509a2f4f139254,2019,,,2,LS Livingstone,SPD Smith,3,5,0,0,1,1,2,0,0,2,3,0,0
6480bb93182304739a535742,2017,,,1,BA Stokes,F du Plessis,3,5,0,0,1,1,1,0,0,2,4,0,0
6480bb9619eaed447b2a05d4,2020/21,,,1,D Padikkal,S Dube,3,7,0,0,1,1,1,0,0,2,6,0,0
6480bb98adf21699eaa67796,2022,,,1,MK Lomror,V Kohli,3,5,0,0,1,1,1,0,0,1,4,0,0
6480bb9a36f2ab9a44baa0f8,2023,,,1,D Padikkal,R Ashwin,3,7,0,0,1,1,1,0,0,2,6,0,0
6480bb9d05f8e769574069fa,2009/10,,,2,CA Pujara,WP Saha,3,6,0,0,1,2,3,0,0,1,3,0,0
6480bba26bb69626041c4ba1,2015,,,1,AB de Villiers,V Kohli,3,5,0,0,1,2,4,0,0,1,1,0,0
6480bb9a1e358307d26cd50d,2023,,,2,CJ Jordan,PP Chawla,3,4,0,0,1,1,3,0,0,0,1,0,0
6480bba265483f7db002ec7c,2015,,,1,MG Johnson,Sandeep Sharma,3,3,0,0,0,2,2,0,0,1,1,0,0
6480bb973da000031d26fbba,2021,,,1,CH Gayle,KL Rahul,3,6,0,0,1,1,4,0,0,2,2,0,0
6480bb9f00ef088221497043,2013,,,1,EJG Morgan,YK Pathan,3,9,0,0,1,2,7,0,0,1,2,0,0
6480bb975156c246a0ee40b1,2021,,,1,EJG Morgan,N Rana,3,7,0,0,1,2,2,0,0,1,5,0,0
6480bb97dee20878b0c4246c,2021,,,2,KS Bharat,V Kohli,3,8,0,0,1,0,4,0,0,1,4,0,0
6480bb9ed74d222a3da56dfa,2012,,,2,B Lee,LR Shukla,3,6,0,0,1,1,2,0,0,2,4,0,0
6480bb9ab34d149420eae546,2023,,,1,K Gowtham,Ravi Bishnoi,3,2,0,0,1,0,0,0,0,2,2,0,0
6480bb96f8379d02d3435ceb,2020/21,,,1,PJ Cummins,Shivam Mavi,3,3,0,0,1,3,2,0,0,0,1,0,0
6480bb9f955d5c84cde78f58,2012,,,2,JD Ryder,SC Ganguly,3,5,0,0,1,1,2,0,0,2,3,0,0
6480bb9d6919e7181371271f,2011,,,2,PC Valthaty,SE Marsh,3,4,0,0,1,2,2,0,0,0,2,0,0
6480bba1670ace74604a420f,2015,,,1,DJ Bravo,MS Dhoni,3,8,0,0,1,1,3,0,0,2,5,0,0
6480bb9fc524f8142f0b3461,2012,,,1,SPD Smith,WD Parnell,3,4,0,0,0,1,2,0,0,2,2,0,0
6480bba120182b9ca0b70004,2014,,,1,Harbhajan Singh,KA Pollard,3,6,0,0,1,1,3,0,0,1,3,0,0
6480bb9d7aa8d2c4c947d164,2009/10,,,1,JH Kallis,RV Uthappa,3,6,0,0,1,1,1,0,0,2,5,0,0
6480bba18a289cc4b8d173a4,2014,,,1,PP Ojha,S Gopal,3,4,0,0,1,2,2,0,0,1,2,0,0
6480bb964a4d5a1709db428e,2020/21,,,1,KA Pollard,Q de Kock,3,6,0,0,1,1,3,0,0,2,3,0,0
6480bba0001885407e860a8d,2013,,,2,IK Pathan,J Botha,3,11,0,0,1,2,4,0,0,1,7,0,0
6480bba31cc11024436836b5,2016,,,2,S Nadeem,Z Khan,3,7,0,0,1,1,3,0,0,2,4,0,0
6480bba21bbf76a62abea528,2016,,,2,SN Khan,SR Watson,3,2,0,0,0,2,1,0,0,1,1,0,0
6480bb98a95cb1650c81c926,2022,,,1,R Parag,SO Hetmyer,3,7,0,0,1,0,0,0,0,3,7,0,0
6480bba33dab752d79e587d2,2016,,,2,Q de Kock,SV Samson,3,3,0,0,1,0,1,0,0,3,2,0,0
6480bb94aa9b082aa58a3822,2017,,,2,A Mishra,K Rabada,3,8,0,0,1,2,4,0,0,0,4,0,0
6480bb9c2f07203e8e510386,2009/10,,,1,PP Chawla,RR Powar,3,7,0,0,1,0,0,0,0,3,7,0,0
6480bb9e28b7a946a6921fa6,2011,,,1,AB de Villiers,V Kohli,3,4,0,0,1,2,2,0,0,1,2,0,0
6480bb9f87652064dab6c573,2013,,,2,SMSM Senanayake,YK Pathan,3,2,0,0,1,0,0,0,0,0,2,0,0
6480bb97ce981c1918dce924,2021,,,2,Abdul Samad,MK Pandey,3,4,0,0,1,2,3,0,0,1,1,0,0
6480bb97fcc6fccd233157f9,2021,,,1,PP Shaw,SS Iyer,3,6,0,0,1,0,1,0,0,2,5,0,0
6480bba1448ab5c40ac64696,2014,,,2,AP Tare,KA Pollard,3,4,0,0,0,2,3,0,0,1,1,0,0
6480bba0b2a9d600114a43d7,2013,,,1,B Kumar,Parvez Rasool,3,3,0,0,1,2,2,0,0,1,1,0,0
6480bb93d5dc00a79edede9c,2017,,,2,A Nehra,B Kumar,3,2,0,0,0,0,0,0,0,3,2,0,0
6480bb9fc9e4047271240a59,2012,,,1,G Gambhir,MS Bisla,3,6,0,0,1,2,4,0,0,1,2,0,0
6480bb95385ebb9bda58a643,2019,,,2,A Mishra,I Sharma,3,2,0,0,0,3,2,0,0,0,0,0,0
6480bb957ae1619e0d648dec,2019,,,2,DA Miller,KL Rahul,3,5,0,0,1,1,3,0,0,2,2,0,0
6480bb98b00f767943bb8415,2022,,,2,AR Patel,Lalit Yadav,3,8,0,0,1,1,4,0,0,2,4,0,0
6480bb9993e6e474a4e37366,2023,,,1,Arshad Khan,Tilak Varma,3,5,0,0,1,2,4,0,0,1,1,0,0
6480bb9f3700dfaa08e18c43,2012,,,2,MEK Hussey,SK Raina,3,9,0,0,1,2,6,0,0,1,3,0,0
6480bb9d4e112d675b2925df,2009/10,,,2,DL Vettori,KD Karthik,3,4,0,0,1,2,2,0,0,1,2,0,0
6480bb9d59f2ded94f736145,2011,,,2,B Chipli,S Dhawan,3,8,0,0,1,0,1,0,0,3,7,0,0
6480bb9e05381e16815803e9,2011,,,2,CJ Ferguson,MR Marsh,3,8,0,0,0,1,2,0,0,2,6,0,0
6480bb94605dacb25c83dc35,2018,,,1,AJ Tye,BB Sran,3,5,0,0,1,2,4,0,0,0,1,0,0
6480bb958e752648ab95362b,2019,,,1,AD Russell,Shubman Gill,3,9,0,0,1,0,6,0,0,3,3,0,0
6480bb982fc21d541267f7b9,2022,,,1,AT Rayudu,RA Jadeja,3,5,0,0,1,1,2,0,0,2,3,0,0
6480bba0b07a395235841955,2013,,,1,DJG Sammy,S Dhawan,3,4,0,0,0,1,1,0,0,1,3,0,0
6480bb99315aee6cd9d56504,2023,,,2,JD Unadkat,MA Wood,3,4,0,0,1,2,2,0,0,1,2,0,0
6480bba0a3e806f41a4dab41,2013,,,2,JD Unadkat,R Vinay Kumar,3,2,0,0,0,1,1,0,0,2,1,0,0
6480bb9c17dcdfd5b06984f0,2009/10,,,2,M Kartik,WP Saha,3,5,0,0,1,1,2,0,0,2,3,0,0
6480bb9c07d77f83fb139c41,2009,,,1,A Symonds,RG Sharma,3,8,0,0,1,2,4,0,0,1,4,0,0
6480bb9929c7e430acd1ef18,2022,,,2,R Powell,RR Pant,3,10,0,0,1,2,7,0,0,1,3,0,0
6480bba0bc196f7168b3d989,2013,,,2,DA Miller,R Sathish,3,3,0,0,1,3,2,0,0,0,1,0,0
6480bb99ecbdaaf953b8eee5,2023,,,2,DJ Hooda,KL Rahul,3,9,0,0,1,2,6,0,0,1,3,0,0
6480bb9558c0acb502a3b1a9,2019,,,2,CA Ingram,GH Vihari,3,5,0,0,1,1,3,0,0,2,2,0,0
6480bb95ea40317152ed9ca5,2018,,,2,MS Dhoni,SW Billings,3,8,0,0,1,2,3,0,0,1,5,0,0
6480bb9af968df9497d2b9c4,2007/08,,,1,Mohammad Hafeez,RT Ponting,3,7,0,0,1,2,4,0,0,1,3,0,0
6480bb9bee2e48d9c41b1e23,2009,,,2,RP Singh,TL Suman,3,7,0,0,1,2,6,0,0,0,1,0,0
6480bb98bd3ca4df44cf9d8f,2022,,,2,Lalit Yadav,RR Pant,3,5,0,0,1,1,4,0,0,1,1,0,0
6480bba107ba9f7f041862c1,2014,,,2,AD Russell,YK Pathan,3,8,0,0,1,1,5,0,0,2,3,0,0
6480bb9fd4a1af6234c9e57c,2012,,,1,AUK Pathan,SS Tiwary,3,3,0,0,0,1,2,0,0,1,1,0,0
6480bb9fa236b26050f19633,2012,,,1,BJ Hodge,R Dravid,3,4,0,0,1,1,2,0,0,2,2,0,0
6480bb9ca21b98f1be8254e2,2009/10,,,2,R Dravid,R Vinay Kumar,3,3,0,0,1,0,0,0,0,3,3,0,0
6480bb9692a7f0d52bd43127,2019,,,2,Mandeep Singh,N Pooran,3,5,0,0,1,2,3,0,0,1,2,0,0
6480bb9baa08d0494c0b8dc3,2007/08,,,2,JH Kallis,V Kohli,3,6,0,0,1,1,3,0,0,1,3,0,0
6480bb9d59f2ded94f736145,2011,,,2,S Dhawan,S Sohal,3,6,0,0,1,1,2,0,0,1,4,0,0
6480bb98373b1ea5035ab3da,2021,,,2,EJG Morgan,RA Tripathi,3,4,0,0,1,1,1,0,0,2,3,0,0
6480bb9a0a8baa96f94e8db9,2023,,,1,KD Karthik,PWH de Silva,3,5,0,0,1,1,1,0,0,2,4,0,0
6480bb9c3b082d71291a593c,2009,,,1,B Akhil,LRPL Taylor,3,4,0,0,1,0,2,0,0,3,2,0,0
6480bb9f895e5780080c8059,2012,,,1,PP Chawla,RJ Harris,3,3,0,0,1,0,1,0,0,3,2,0,0
6480bba265483f7db002ec7c,2015,,,1,MG Johnson,R Dhawan,3,5,0,0,1,1,2,0,0,1,3,0,0
6480bb9f6f311344dac147cc,2012,,,2,AD Mathews,WD Parnell,3,5,0,0,1,2,3,0,0,1,2,0,0
6480bb95430629e254bbc4fd,2018,,,2,KD Karthik,N Rana,3,6,0,0,1,1,1,0,0,2,5,0,0
6480bb98f01e4672b988c112,2022,,,1,HE van der Dussen,SO Hetmyer,3,4,0,0,1,0,1,0,0,3,3,0,0
6480bb968211e65fcbffa192,2019,,,1,H Klaasen,P Negi,3,4,0,0,1,1,3,0,0,0,1,0,0
6480bb9f58a3e7ea877fc9dc,2012,,,1,KC Sangakkara,PA Reddy,3,4,0,0,1,3,4,0,0,0,0,0,0
6480bba1603d86b7d278a366,2015,,,1,RV Uthappa,SA Yadav,3,5,0,0,1,1,2,0,0,2,3,0,0
6480bba069c0322e91e50958,2013,,,1,CL White,GH Vihari,3,5,0,0,1,2,4,0,0,1,1,0,0
6480bb94aa9b082aa58a3822,2017,,,2,KK Nair,RR Pant,3,7,0,0,1,1,3,0,0,2,4,0,0
6480bb9c89e2e8ecb04f94cb,2009/10,,,2,DP Nannes,UT Yadav,3,4,0,0,0,1,2,0,0,2,2,0,0
6480bb958f77e7d3929d28e3,2018,,,1,AS Rajpoot,MM Sharma,3,5,0,0,1,2,4,0,0,1,1,0,0
6480bb9c1e676472f4841aa9,2009/10,,,2,M Vijay,S Badrinath,3,6,0,0,1,1,3,0,0,2,3,0,0
6480bb9371e90dbd44ee19a3,2017,,,2,AR Patel,Sandeep Sharma,3,5,0,0,1,1,3,0,0,2,2,0,0
6480bb9ef8d4c23c6e5be4c7,2011,,,2,P Parameswaran,RR Powar,3,2,0,0,0,1,1,0,0,2,1,0,0
6480bb9a8ac627a1ebf8dacf,2007/08,,,1,B Akhil,DW Steyn,3,4,0,0,1,1,2,0,0,1,2,0,0
6480bb973d64aa91e60b4088,2021,,,2,R Parag,R Tewatia,3,8,0,0,1,2,5,0,0,1,3,0,0
6480bb9adb5d9ca80cb1c6a0,2023,,,2,AK Markram,GD Phillips,3,3,0,0,1,0,1,0,0,3,2,0,0
6480bb985efffbcafdef9f19,2021,,,1,C Sakariya,CH Morris,3,4,0,0,1,2,2,0,0,1,2,0,0
6480bb99695e001cdaca81e0,2022,,,2,DR Sams,Tilak Varma,3,6,0,0,1,1,4,0,0,1,2,0,0
6480bb965aa0867bce4e79b3,2019,,,1,AT Rayudu,MS Dhoni,3,4,0,0,1,1,2,0,0,2,2,0,0
6480bb9b6ded6d116cfe02ee,2009,,,2,AM Nayar,JP Duminy,3,3,0,0,1,3,3,0,0,0,0,0,0
6480bba0a9f68a29bda72302,2013,,,1,DB Das,SMSM Senanayake,3,2,0,0,0,1,1,0,0,2,1,0,0
6480bba286cca051953c976a,2015,,,2,MG Johnson,WP Saha,3,4,0,0,1,1,2,0,0,2,2,0,0
6480bba0120becd670aec59d,2013,,,1,B Kumar,BAW Mendis,3,5,0,0,1,2,3,0,0,1,2,0,0
6480bb965aa0867bce4e79b3,2019,,,1,DJ Bravo,MS Dhoni,3,2,0,0,0,1,1,0,0,2,1,0,0
6480bb9e6d7f7f691dde322d,2012,,,2,CL White,S Dhawan,3,5,0,0,1,0,1,0,0,2,4,0,0
6480bb96c40b697b63d08717,2019,,,2,PP Shaw,RR Pant,3,4,0,0,1,1,2,0,0,2,2,0,0
6480bba2b341a081c069198d,2015,,,1,Mandeep Singh,SN Khan,3,3,0,0,0,1,2,0,0,1,1,0,0
6480bb9f68a0a232d83c338c,2012,,,1,TM Dilshan,V Kohli,3,2,0,0,1,0,1,0,0,3,1,0,0
6480bb94834e2b780c4782b5,2017,,,2,HH Pandya,KH Pandya,3,2,0,0,0,1,1,0,0,0,1,0,0
6480bb948211fe47e65f2e77,2018,,,1,S Kaul,YK Pathan,3,10,0,0,1,2,9,0,0,1,1,0,0
6480bb9d03ce4b87b32b91f5,2009/10,,,1,MD Mishra,TL Suman,3,3,0,0,1,0,1,0,0,3,2,0,0
6480bba0e883438915efc1e6,2013,,,1,AB Dinda,B Kumar,3,3,0,0,0,2,2,0,0,1,1,0,0
6480bb9fd4a1af6234c9e57c,2012,,,2,AM Nayar,DJ Hussey,3,6,0,0,1,2,3,0,0,1,3,0,0
6480bb9e80233e83b9d1be1f,2012,,,1,KD Karthik,RG Sharma,3,6,0,0,1,2,2,0,0,1,4,0,0
6480bb94f27c8167d1685878,2017,,,2,JP Faulkner,RA Jadeja,3,4,0,0,1,1,3,0,0,1,1,0,0
6480bb99c26e725b7b6f1637,2023,,,1,A Badoni,KR Mayers,3,6,0,0,1,1,4,0,0,0,2,0,0
6480bba3041017fe2c0593f2,2016,,,1,KD Karthik,SK Raina,3,12,0,0,1,2,3,0,0,1,9,0,0
6480bb990942cd416cf5f447,2022,,,2,DJ Hooda,Mohsin Khan,3,6,0,0,1,2,3,0,0,1,3,0,0
6480bb9a0474602f26069e45,2007/08,,,2,JA Morkel,Joginder Sharma,3,3,0,0,1,3,2,0,0,0,1,0,0
6480bb95ea40317152ed9ca5,2018,,,1,GJ Maxwell,RR Pant,3,3,0,0,1,1,1,0,0,2,2,0,0
6480bb9b0e32875998e9bfdc,2009,,,2,GC Smith,PC Valthaty,3,11,0,0,1,2,6,0,0,1,5,0,0
6480bba2bae80e615447f251,2015,,,1,MS Dhoni,SK Raina,3,5,0,0,1,1,3,0,0,2,2,0,0
6480bb985efffbcafdef9f19,2021,,,1,MK Lomror,R Tewatia,3,4,0,0,1,1,2,0,0,1,2,0,0
6480bba3041017fe2c0593f2,2016,,,2,AB de Villiers,SR Watson,3,8,0,0,1,2,2,0,0,1,6,0,0
6480bb9ba9d43057d652a5fe,2009,,,2,SS Tiwary,Z Khan,3,2,0,0,0,3,2,0,0,0,0,0,0
6480bb9822eeb0c1c117f221,2021,,,1,PP Shaw,RR Pant,3,4,0,0,1,1,2,0,0,2,2,0,0
6480bb9c12e6c723b248799b,2009,,,1,P Kumar,RV Uthappa,3,5,0,0,1,2,3,0,0,1,2,0,0
6480bb9bc74c35e494cec477,2007/08,,,2,RG Sharma,Shahid Afridi,3,5,0,0,1,2,2,0,0,1,3,0,0
6480bb9af85f41b4de44ca19,2023,,,1,DP Conway,S Dube,3,6,0,0,1,2,3,0,0,1,3,0,0
6480bb98291bb8b3f3e8145d,2022,,,1,DA Warner,Lalit Yadav,3,6,0,0,1,2,2,0,0,1,4,0,0
6480bb9384cbae8edee3707f,2017,,,2,K Rabada,KK Nair,3,6,0,0,1,2,4,0,0,0,2,0,0
6480bb9404b444be6724e41e,2017,,,1,KK Nair,SV Samson,3,6,0,0,1,1,2,0,0,2,4,0,0
6480bb956b439141409fd739,2018,,,1,DJM Short,JC Buttler,3,3,0,0,1,2,2,0,0,1,1,0,0
6480bb99bbae76f3f761d060,2023,,,1,AM Rahane,MS Dhoni,3,3,0,0,0,0,0,0,0,2,3,0,0
6480bb9480627b50308b7903,2017,,,2,KH Pandya,SL Malinga,3,3,0,0,1,3,2,0,0,0,1,0,0
6480bb94adb227976b33d30b,2018,,,2,AD Russell,PP Chawla,3,11,0,0,1,1,8,0,0,2,3,0,0
6480bb9a6e44b0c8da00ca72,2007/08,,,1,KC Sangakkara,S Sohal,3,6,0,0,1,3,2,0,0,0,4,0,0
6480bb9c89e2e8ecb04f94cb,2009/10,,,1,TL Suman,WPUJC Vaas,3,3,0,0,0,0,1,0,0,3,2,0,0
6480bba23ed328dbb847b4e7,2016,,,2,MK Pandey,YK Pathan,3,7,0,0,1,1,3,0,0,1,4,0,0
6480bb9a7d91d721555835e5,2007/08,,,2,AB Dinda,I Sharma,3,4,0,0,1,1,3,0,0,1,1,0,0
6480bba0295edd6084b9503b,2014,,,2,BJ Hodge,STR Binny,3,10,0,0,1,1,8,0,0,2,2,0,0
6480bba278153a5979e31ec9,2016,,,2,JP Faulkner,P Kumar,3,2,0,0,0,3,2,0,0,0,0,0,0
6480bb961ee814aee7b674ac,2020/21,,,2,KK Nair,MA Agarwal,3,4,0,0,1,1,3,0,0,2,1,0,0
6480bb96c880c7df4e055f14,2020/21,,,2,K Gowtham,Ravi Bishnoi,3,8,0,0,1,2,3,0,0,1,5,0,0
6480bb97f2f0fabec8f94d86,2020/21,,,2,MS Dhoni,RD Gaikwad,3,6,0,0,1,1,4,0,0,2,2,0,0
6480bb99fe078839da40e7ab,2023,,,1,AD Russell,UT Yadav,3,5,0,0,1,0,0,0,0,3,5,0,0
6480bb94704f6dfeb7f4d270,2017,,,1,AR Patel,Swapnil Singh,3,3,0,0,1,1,1,0,0,2,2,0,0
6480bba0da054e3d917f71fb,2013,,,2,M Vijay,SK Raina,3,4,0,0,1,2,2,0,0,1,2,0,0
6480bb96fb897a6ff486ffe4,2020/21,,,1,AT Rayudu,MS Dhoni,3,10,0,0,1,1,5,0,0,2,5,0,0
6480bb9be88c31fc563da86f,2009,,,2,K Goel,SM Katich,3,7,0,0,1,1,4,0,0,2,3,0,0
6480bb95ea40317152ed9ca5,2018,,,2,DL Chahar,RA Jadeja,3,4,0,0,0,1,2,0,0,2,2,0,0
6480bba2e3610f863b52b887,2016,,,1,A Nehra,S Dhawan,3,2,0,0,0,0,0,0,0,3,2,0,0
6480bba0e52e9733fc6d9937,2013,,,2,DA Miller,Gurkeerat Singh,3,5,0,0,1,1,1,0,0,2,4,0,0
6480bb9d967f5a4cfbd8c74d,2011,,,2,L Balaji,MK Tiwary,3,1,0,0,0,3,1,0,0,0,0,0,0
6480bb9ec90f99c5ea40b014,2012,,,2,AL Menaria,R Dravid,3,10,0,0,1,1,6,0,0,2,4,0,0
6480bb94cfe5aeb50e36aef3,2017,,,1,AJ Finch,RA Jadeja,3,4,0,0,1,2,3,0,0,1,1,0,0
6480bb9834c7569d5fa64353,2022,,,1,Shubman Gill,V Shankar,3,9,0,0,1,1,2,0,0,2,7,0,0
6480bba3412663673a969a24,2016,,,1,AB de Villiers,V Kohli,3,5,0,0,1,1,3,0,0,2,2,0,0
6480bb9fe31a789bcb52d583,2012,,,1,Harpreet Singh,WD Parnell,3,5,0,0,1,1,2,0,0,2,3,0,0
6480bb9ded279701c84af803,2011,,,2,A Mishra,I Sharma,3,4,0,0,1,2,3,0,0,1,1,0,0
6480bb962831291a868490e7,2020/21,,,2,R Ashwin,TU Deshpande,3,6,0,0,1,2,3,0,0,1,3,0,0
6480bb94c5d20726ee59d3d6,2017,,,2,MK Pandey,YK Pathan,3,6,0,0,0,2,1,0,0,0,5,0,0
6480bb93d9581d69657887c3,2017,,,2,A Mishra,Z Khan,3,3,0,0,0,2,2,0,0,1,1,0,0
6480bb9ee779ef1e445d0506,2012,,,2,B Kumar,SPD Smith,3,6,0,0,1,2,4,0,0,1,2,0,0
6480bb965f597c872396f67c,2020/21,,,2,Mandeep Singh,N Pooran,3,4,0,0,0,1,1,0,0,2,3,0,0
6480bb95945c5e5dc4d8c7d6,2019,,,1,KA Pollard,KH Pandya,3,3,0,0,1,1,2,0,0,1,1,0,0
6480bb9993e6e474a4e37366,2023,,,1,C Green,SA Yadav,3,4,0,0,1,2,2,0,0,1,2,0,0
6480bb9ee0795047740de5a7,2011,,,1,DH Yagnik,J Botha,3,7,0,0,1,3,7,0,0,0,0,0,0
6480bb958f77e7d3929d28e3,2018,,,2,AT Rayudu,F du Plessis,3,8,0,0,1,1,3,0,0,2,5,0,0
6480bb9dd10e35e6145534dc,2011,,,1,B Chipli,DT Christian,3,5,0,0,1,1,2,0,0,2,3,0,0
6480bb9d9f4551d7ec79c951,2009/10,,,1,SE Marsh,Yuvraj Singh,3,7,0,0,1,2,3,0,0,1,4,0,0
6480bb995f3db9699a1f794d,2022,,,1,MM Ali,N Jagadeesan,3,7,0,0,1,2,3,0,0,1,4,0,0
6480bb9bca2c11520f5b3b9e,2007/08,,,2,KC Sangakkara,SE Marsh,3,5,0,0,1,3,4,0,0,0,1,0,0
6480bb95fbd4f1b7f3d8dfc0,2019,,,1,CH Gayle,SM Curran,3,5,0,0,1,2,2,0,0,1,3,0,0
6480bb96c40b697b63d08717,2019,,,2,A Mishra,KMA Paul,3,5,0,0,1,1,2,0,0,1,3,0,0
6480bb9b2de4e62ee60b7e5c,2009,,,1,P Kumar,R Vinay Kumar,3,3,0,0,1,3,3,0,0,0,0,0,0
6480bb991a76403912eef285,2023,,,2,D Padikkal,SO Hetmyer,3,5,0,0,1,0,1,0,0,3,4,0,0
6480bb94aa9b082aa58a3822,2017,,,2,CH Morris,CJ Anderson,3,6,0,0,1,2,5,0,0,1,1,0,0
6480bb9d1ed71a4f47892d00,2009/10,,,2,AJ Finch,AS Raut,3,5,0,0,1,2,4,0,0,1,1,0,0
6480bba2557febf92f9f79ab,2015,,,2,PP Chawla,RN ten Doeschate,3,4,0,0,1,0,2,0,0,2,2,0,0
6480bb945460b25d997060fb,2018,,,2,CH Morris,V Shankar,3,4,0,0,1,2,3,0,0,1,1,0,0
6480bba287d112bccc55ccd2,2015,,,1,AR Patel,Gurkeerat Singh,3,4,0,0,1,1,1,0,0,2,3,0,0
6480bba133267f04941acf7d,2014,,,1,DW Steyn,IK Pathan,3,3,0,0,1,1,2,0,0,1,1,0,0
6480bb9836af59f8283f4081,2022,,,1,SO Hetmyer,TA Boult,3,5,0,0,0,1,4,0,0,1,1,0,0
6480bb9c89e2e8ecb04f94cb,2009/10,,,1,AC Gilchrist,MD Mishra,3,5,0,0,1,0,1,0,0,1,4,0,0
6480bb9f79be50f1621abcc6,2012,,,1,AM Nayar,RJ Harris,3,5,0,0,1,0,0,0,0,3,5,0,0
6480bb99bb362e3714226928,2022,,,1,JDS Neesham,R Ashwin,3,3,0,0,1,1,1,0,0,1,2,0,0
6480bb97b945155c90dccd3d,2021,,,2,RA Jadeja,SN Thakur,3,4,0,0,1,0,2,0,0,3,2,0,0
6480bb94cb5adf24f5ad15c3,2017,,,2,AM Rahane,SPD Smith,3,5,0,0,1,2,3,0,0,1,2,0,0
6480bb9b50f9e801edc13d5a,2007/08,,,1,R Dravid,SP Goswami,3,7,0,0,1,1,3,0,0,2,4,0,0
6480bb9dec749d630afd07d1,2011,,,1,JP Duminy,S Dhawan,3,5,0,0,1,2,2,0,0,1,3,0,0
6480bb9618b5973b98c0ba18,2019,,,2,C de Grandhomme,Gurkeerat Singh,3,4,0,0,1,2,3,0,0,0,1,0,0
6480bb9c71030f4c6f018f55,2009,,,2,LA Pomersbach,SM Katich,3,5,0,0,1,1,2,0,0,1,3,0,0
6480bb9a43249ece8e841e56,2023,,,1,F du Plessis,KD Karthik,3,3,0,0,1,1,2,0,0,1,1,0,0
6480bba0f401cc6b6bc6ed10,2013,,,1,AM Rahane,DH Yagnik,3,6,0,0,1,3,2,0,0,0,4,0,0
6480bb96b7b695186bbb6a3e,2019,,,2,AT Rayudu,SR Watson,3,7,0,0,1,1,4,0,0,2,3,0,0
6480bba163bd0c619365a16b,2015,,,1,JP Duminy,KM Jadhav,3,3,0,0,0,2,2,0,0,1,1,0,0
6480bb9e2c96ab2b87d9466a,2011,,,2,NV Ojha,Y Venugopal Rao,3,4,0,0,1,1,2,0,0,1,2,0,0
6480bb95e25835586d412978,2018,,,1,AR Patel,MP Stoinis,3,5,0,0,1,0,2,0,0,2,3,0,0
6480bb97e5be965d3c00760e,2021,,,1,KA Jamieson,Sachin Baby,3,11,0,0,1,2,6,0,0,1,5,0,0
6480bb9fcb2b412c0ebd4afa,2013,,,1,A Mishra,GH Vihari,3,2,0,0,1,0,0,0,0,3,2,0,0
6480bb9623a26d3fbfe59f25,2020/21,,,2,DW Steyn,YS Chahal,3,4,0,0,1,1,1,0,0,1,3,0,0
6480bba326249b668a4713d6,2016,,,1,SA Yadav,Shakib Al Hasan,3,14,0,0,1,2,9,0,0,0,5,0,0
6480bb9b09e6c98206422ae5,2009,,,2,RA Jadeja,YK Pathan,3,5,0,0,1,2,3,0,0,1,2,0,0
6480bb9f6b144f2a6d105b32,2013,,,2,RT Ponting,SR Tendulkar,3,5,0,0,1,3,4,0,0,0,1,0,0
6480bba2563745309ee2bdfb,2016,,,2,Gurkeerat Singh,M Vijay,3,5,0,0,1,0,3,0,0,3,2,0,0
6480bb9e692eaa193a417426,2012,,,1,AB de Villiers,SS Tiwary,3,5,0,0,1,2,2,0,0,1,3,0,0
6480bba0295edd6084b9503b,2014,,,1,DW Steyn,Y Venugopal Rao,3,2,0,0,0,0,0,0,0,2,2,0,0
6480bb9d4e112d675b2925df,2009/10,,,2,KD Karthik,MF Maharoof,3,4,0,0,1,1,1,0,0,2,3,0,0
6480bb9df57ec21d17310ad2,2011,,,2,DB Ravi Teja,DW Steyn,3,3,0,0,1,1,2,0,0,2,1,0,0
6480bba2b7be71a15b2bb3de,2015,,,2,R Ashwin,RA Jadeja,3,5,0,0,1,2,4,0,0,1,1,0,0
6480bb9aded509be64de3bfb,2007/08,,,2,DJ Hussey,SC Ganguly,3,9,0,0,1,0,2,0,0,2,7,0,0
6480bb9c44492d9e5fc4bb60,2009/10,,,1,CA Pujara,OA Shah,3,6,0,0,0,1,1,0,0,2,5,0,0
6480bb95c8ecc2185a67f4fd,2019,,,2,MK Pandey,V Shankar,3,5,0,0,1,1,3,0,0,1,2,0,0
6480bba1603d86b7d278a366,2015,,,2,DJ Bravo,MS Dhoni,3,6,0,0,1,1,2,0,0,1,4,0,0
6480bba326249b668a4713d6,2016,,,2,AJ Finch,RA Jadeja,3,7,0,0,1,0,0,0,0,3,7,0,0
6480bb99695e001cdaca81e0,2022,,,1,RD Gaikwad,RV Uthappa,3,6,0,0,1,0,0,0,0,1,6,0,0
6480bba2a215721aadf7a90a,2015,,,1,BB McCullum,SK Raina,3,6,0,0,1,0,0,0,0,3,6,0,0
6480bb9ba9d43057d652a5fe,2009,,,2,S Dhawan,SR Tendulkar,3,8,0,0,1,1,2,0,0,1,6,0,0
6480bba30373b229e0090b67,2016,,,2,AB de Villiers,SR Watson,3,5,0,0,1,2,2,0,0,1,3,0,0
6480bba1017a98eead1ec861,2015,,,2,M Vijay,V Sehwag,3,12,0,0,1,2,8,0,0,1,4,0,0
6480bba0a4e7c61a5656729e,2014,,,1,GJ Bailey,V Sehwag,3,4,0,0,1,1,2,0,0,2,2,0,0
6480bb9822eeb0c1c117f221,2021,,,2,F du Plessis,RD Gaikwad,3,4,0,0,1,1,2,0,0,2,2,0,0
6480bb9fa236b26050f19633,2012,,,1,OA Shah,R Dravid,3,5,0,0,1,1,3,0,0,2,2,0,0
6480bb95ea40317152ed9ca5,2018,,,1,Abhishek Sharma,V Shankar,3,5,0,0,1,2,4,0,0,1,1,0,0
6480bb9d79d603cc45fc9b3c,2011,,,2,Bipul Sharma,SE Marsh,3,4,0,0,1,1,2,0,0,2,2,0,0
6480bba141bcb000fa6fe2a4,2015,,,2,J Suchith,S Gopal,3,2,0,0,0,0,1,0,0,1,1,0,0
6480bba141bcb000fa6fe2a4,2015,,,2,PA Patel,UBT Chand,3,7,0,0,1,2,4,0,0,1,3,0,0
6480bb97cca23939859c422e,2021,,,1,PP Shaw,RR Pant,3,7,0,0,1,2,3,0,0,1,4,0,0
6480bb9fd9db46138a9bb209,2013,,,2,AB de Villiers,R Rampaul,3,5,0,0,1,1,1,0,0,0,4,0,0
6480bb9e9f1ef9ac02266570,2011,,,2,RV Uthappa,SC Ganguly,3,5,0,0,1,1,3,0,0,2,2,0,0
6480bb990b96e91d3fbf421b,2022,,,1,JR Hazlewood,Shahbaz Ahmed,3,5,0,0,0,1,2,0,0,2,3,0,0
6480bb9b4fc6889967a3cd54,2007/08,,,2,RR Raje,YV Takawale,3,4,0,0,0,1,2,0,0,2,2,0,0
6480bb9d5cca30c933d4baf4,2011,,,1,AM Nayar,SE Marsh,3,5,0,0,1,1,3,0,0,2,2,0,0
6480bb9faf20f0bc714af2ea,2013,,,2,A Nehra,S Nadeem,3,5,0,0,1,0,1,0,0,3,4,0,0
6480bba08cc4182f0127f2e2,2013,,,1,KA Pollard,KD Karthik,3,9,0,0,1,1,3,0,0,2,6,0,0
6480bb9be88c31fc563da86f,2009,,,1,A Kumble,P Kumar,3,6,0,0,1,1,3,0,0,1,3,0,0
6480bba0d3cbb27b257a9c1f,2013,,,1,DJ Hussey,SE Marsh,3,6,0,0,1,1,3,0,0,2,3,0,0
6480bb9c12f907c7b81b11a9,2009,,,2,RA Jadeja,YK Pathan,3,9,0,0,1,1,2,0,0,1,7,0,0
6480bb9d22388e966342dba8,2009/10,,,1,ML Hayden,SK Raina,3,8,0,0,1,1,6,0,0,2,2,0,0
6480bb967d799ced7fe5d8e9,2020/21,,,1,DJ Hooda,N Pooran,3,4,0,0,1,0,2,0,0,2,2,0,0
6480bba19701e99975ce7c59,2015,,,1,CH Morris,PV Tambe,3,5,0,0,0,1,1,0,0,2,4,0,0
6480bba0c9e6d590ed35eb56,2014,,,2,PP Ojha,SL Malinga,3,5,0,0,1,1,4,0,0,1,1,0,0
6480bb972a7d4e1071ea662e,2021,,,1,Ishan Kishan,KA Pollard,3,7,0,0,1,1,2,0,0,2,5,0,0
6480bb99b0fa4d217ed7f255,2023,,,1,MK Pandey,RV Patel,3,3,0,0,1,1,1,0,0,2,2,0,0
6480bb9f03dd3a09740f0bd0,2013,,,2,EJG Morgan,G Gambhir,3,4,0,0,1,1,1,0,0,2,3,0,0
6480bba10e78f50f124b406a,2015,,,2,F du Plessis,RA Jadeja,3,7,0,0,1,2,4,0,0,1,3,0,0
6480bb97aa725a640d0f8e2f,2021,,,1,C Sakariya,Kartik Tyagi,3,3,0,0,1,2,2,0,0,1,1,0,0
6480bb9f7258f976eb8fe943,2012,,,2,MEK Hussey,MS Dhoni,3,5,0,0,1,0,1,0,0,2,4,0,0
6480bb99f33a7dd80eb0a544,2023,,,2,P Simran Singh,S Dhawan,3,5,0,0,1,1,3,0,0,1,2,0,0
6480bb9dfb2e8e8c2002df86,2011,,,1,A Mishra,I Sharma,3,3,0,0,0,2,2,0,0,1,1,0,0
6480bba0f858e6c12b25d8c3,2014,,,1,RV Uthappa,SA Yadav,3,3,0,0,1,0,1,0,0,3,2,0,0
6480bb95e435367dc64d9844,2019,,,1,HH Pandya,Q de Kock,3,4,0,0,1,0,0,0,0,3,4,0,0
6480bba0fee4ae82492a666f,2013,,,1,I Sharma,KV Sharma,3,1,0,0,0,0,0,0,0,2,1,0,0
6480bba000b91f6c5cf57fdb,2013,,,1,PA Patel,S Dhawan,3,7,0,0,1,2,6,0,0,1,1,0,0
6480bb9ec0a4e3f137edb047,2011,,,2,M Vijay,MEK Hussey,3,6,0,0,1,1,2,0,0,0,4,0,0
6480bba1f5d65d6146678a7f,2015,,,1,MA Agarwal,SS Iyer,3,8,0,0,1,1,8,0,0,0,0,0,0
6480bba3e9fa951efcfc8bfb,2016,,,1,HM Amla,MP Stoinis,3,8,0,0,1,1,5,0,0,2,3,0,0
6480bb9f02801d2090cdba0d,2012,,,1,SC Ganguly,SPD Smith,3,9,0,0,1,1,3,0,0,2,6,0,0
6480bb958e752648ab95362b,2019,,,1,AD Russell,M Prasidh Krishna,3,5,0,0,1,2,3,0,0,0,2,0,0
6480bb9c89f35f11aae1f2d0,2009/10,,,2,AA Jhunjhunwala,AC Voges,3,3,0,0,1,0,1,0,0,2,2,0,0
6480bba09d1874eb9ded0204,2013,,,2,CM Gautam,DPMD Jayawardene,3,6,0,0,1,2,3,0,0,1,3,0,0
6480bba1ebb63d1bd8c60b9d,2014,,,1,GJ Maxwell,M Vohra,3,6,0,0,1,0,3,0,0,2,3,0,0
6480bb931ee18ac840f40603,2017,,,1,HM Amla,MP Stoinis,3,5,0,0,1,1,2,0,0,1,3,0,0
6480bb9b2ca4a7b325526f1f,2009,,,2,LA Carseldine,SK Warne,3,4,0,0,1,1,2,0,0,2,2,0,0
6480bba2557febf92f9f79ab,2015,,,1,F du Plessis,SK Raina,3,5,0,0,1,2,3,0,0,0,2,0,0
6480bba0da054e3d917f71fb,2013,,,2,M Vijay,MS Dhoni,3,4,0,0,1,1,1,0,0,2,3,0,0
6480bb9d22388e966342dba8,2009/10,,,2,CRD Fernando,SL Malinga,3,3,0,0,0,2,2,0,0,1,1,0,0
6480bba18a289cc4b8d173a4,2014,,,2,KD Karthik,MK Tiwary,2,5,0,0,1,1,3,0,0,1,2,0,0
6480bb962a1612c936d161ba,2019,,,2,DL Chahar,MJ Santner,2,3,0,0,1,0,2,0,0,1,1,0,0
6480bb9dc8b09381d0f01a9d,2011,,,1,MEK Hussey,SK Raina,2,4,0,0,1,0,0,0,0,2,4,0,0
6480bb9a7d91d721555835e5,2007/08,,,1,SK Warne,Sohail Tanvir,2,2,0,0,1,1,1,0,0,1,1,0,0
6480bb9873e53eace3a69dc7,2022,,,1,R Tewatia,Rashid Khan,2,3,0,0,1,1,1,0,0,0,2,0,0
6480bba2ab35be3ffcfa932a,2016,,,2,MC Henriques,NV Ojha,2,5,0,0,1,1,1,0,0,0,4,0,0
6480bba20130c44ed20c9bcf,2016,,,1,KH Pandya,MJ McClenaghan,2,1,0,0,0,2,1,0,0,0,0,0,0
6480bb9a365c63af4b3de24c,2023,,,2,Aman Hakim Khan,MK Pandey,2,6,0,0,1,1,3,0,0,0,3,0,0
6480bb9d1ed71a4f47892d00,2009/10,,,2,Kamran Khan,SK Warne,2,1,0,0,0,0,0,0,0,2,1,0,0
6480bb9baccf501985a56d64,2007/08,,,2,KD Karthik,TM Dilshan,2,4,0,0,1,1,3,0,0,1,1,0,0
6480bb98f98edd45b1ccb406,2022,,,1,KL Rahul,Q de Kock,2,5,0,0,1,0,0,0,0,2,5,0,0
6480bb9ddcbb8fbbad6614c8,2009/10,,,2,AB Barath,Yuvraj Singh,2,5,0,0,0,2,5,0,0,0,0,0,0
6480bb967d799ced7fe5d8e9,2020/21,,,2,JM Bairstow,MK Pandey,2,6,0,0,1,0,2,0,0,2,4,0,0
6480bb9c58b62383739c022e,2009,,,2,J Botha,NV Ojha,2,3,0,0,1,1,1,0,0,1,2,0,0
6480bb9ca668b7b36823fb21,2009,,,2,SR Tendulkar,ST Jayasuriya,2,1,0,0,1,0,0,0,0,0,1,0,0
6480bb9ef7c6084992b7cdf8,2012,,,1,NV Ojha,V Sehwag,2,5,0,0,1,1,4,0,0,1,1,0,0
6480bb96f1eadf803ffc292c,2020/21,,,2,Kartik Tyagi,VR Aaron,2,3,0,0,1,1,1,0,0,1,2,0,0
6480bb9fc3369c6f5a549d05,2013,,,1,KM Jadhav,S Nadeem,2,5,0,0,1,0,1,0,0,2,4,0,0
6480bba210201df0f7975000,2016,,,2,AB de Villiers,SR Watson,2,4,0,0,1,1,3,0,0,1,1,0,0
6480bb9836d24b9817a35f7d,2022,,,1,KH Pandya,PVD Chameera,2,2,0,0,0,1,1,0,0,1,1,0,0
6480bb976344f6d667dfd965,2021,,,1,K Rabada,RR Pant,2,1,0,0,1,0,0,0,0,1,1,0,0
6480bb98634dba60191637ad,2021,,,2,DA Warner,WP Saha,2,3,0,0,1,2,3,0,0,0,0,0,0
6480bb9d93cca4d1a7635fba,2011,,,1,AUK Pathan,TM Dilshan,2,4,0,0,1,0,2,0,0,2,2,0,0
6480bb94704f6dfeb7f4d270,2017,,,1,MJ Guptill,SE Marsh,2,6,0,0,1,1,3,0,0,1,3,0,0
6480bb95b84f125c6212267a,2019,,,2,AB de Villiers,V Kohli,2,3,0,0,1,1,2,0,0,1,1,0,0
6480bb9c37b72d7a51019794,2009/10,,,1,RG Sharma,RJ Harris,2,3,0,0,1,1,1,0,0,1,2,0,0
6480bb98af25209ef756aa2c,2021,,,2,Ishan Kishan,SA Yadav,2,3,0,0,1,1,2,0,0,1,1,0,0
6480bb9f23c17ccb47aa9e58,2013,,,2,DJ Hussey,M Vohra,2,9,0,0,1,1,5,0,0,1,4,0,0
6480bb95b1f28cf5bcf5e167,2018,,,1,KS Williamson,MK Pandey,2,3,0,0,1,2,2,0,0,0,1,0,0
6480bb9ac9149c73fdf073b3,2023,,,2,A Nortje,Lalit Yadav,2,6,0,0,1,0,1,0,0,1,5,0,0
6480bb9b2ca4a7b325526f1f,2009,,,2,LA Carseldine,NV Ojha,2,9,0,0,1,2,3,0,0,0,6,0,0
6480bb9d967f5a4cfbd8c74d,2011,,,1,NV Ojha,Y Venugopal Rao,2,3,0,0,1,1,2,0,0,1,1,0,0
6480bb9f60d58ee39ba047b9,2013,,,2,GH Vihari,NLTC Perera,2,2,0,0,1,2,2,0,0,0,0,0,0
6480bba01893b0faadb9c761,2013,,,2,CH Gayle,V Kohli,2,7,0,0,1,1,4,0,0,1,3,0,0
6480bb9c7b7d7712bdc663de,2009/10,,,1,SR Tendulkar,SS Tiwary,2,7,0,0,1,0,1,0,0,2,6,0,0
6480bb973d98bfd2d4a5f108,2020/21,,,2,AD Russell,EJG Morgan,2,4,0,0,1,0,2,0,0,1,2,0,0
6480bb9c968c81bdfcc6df5b,2009,,,1,A Mishra,TM Dilshan,2,2,0,0,1,0,1,0,0,1,1,0,0
6480bb9ee7a29c9b96ed61e5,2011,,,1,P Kumar,PP Chawla,2,8,0,0,1,0,7,0,0,1,1,0,0
6480bb94f06c6048c8088194,2018,,,1,JC Buttler,K Gowtham,2,5,0,0,1,2,3,0,0,0,2,0,0
6480bb961cdee4d82c395517,2020/21,,,1,Abdul Samad,Abhishek Sharma,2,2,0,0,0,0,1,0,0,1,1,0,0
6480bb9e34659755628e7471,2012,,,2,AC Gilchrist,Mandeep Singh,2,7,0,0,1,1,3,0,0,1,4,0,0
6480bb99ed38bcb4025b8d86,2023,,,2,F du Plessis,MG Bracewell,2,3,0,0,1,0,1,0,0,2,2,0,0
6480bb9ab34d149420eae546,2023,,,2,RK Singh,SP Narine,2,2,0,0,1,0,0,0,0,1,2,0,0
6480bb98f98edd45b1ccb406,2022,,,2,N Rana,RK Singh,2,7,0,0,1,1,6,0,0,1,1,0,0
6480bb995193664eda3e9e10,2022,,,2,Ishan Kishan,RG Sharma,2,6,0,0,1,0,0,0,0,2,6,0,0
6480bba07fa24b891b818984,2013,,,1,AC Gilchrist,Mandeep Singh,2,10,0,0,1,1,5,0,0,1,5,0,0
6480bb9c13817091131f76e3,2009/10,,,1,A Symonds,RG Sharma,2,3,0,0,1,1,1,0,0,1,2,0,0
6480bb9a1e358307d26cd50d,2023,,,2,CJ Jordan,TH David,2,4,0,0,1,1,2,0,0,1,2,0,0
6480bb9ea75f51e7a33e90ed,2012,,,2,P Awana,P Kumar,2,1,0,0,0,0,0,0,0,2,1,0,0
6480bb94834e2b780c4782b5,2017,,,2,HH Pandya,KA Pollard,2,5,0,0,1,0,1,0,0,2,4,0,0
6480bba07e219ed95b7b06df,2013,,,2,SPD Smith,Yuvraj Singh,2,3,0,0,1,0,0,0,0,2,3,0,0
6480bb9541caaeddc9ddaac3,2019,,,2,JC Archer,S Gopal,2,4,0,0,1,1,1,0,0,0,3,0,0
6480bb95f45dffe4751efc46,2019,,,2,Mandeep Singh,SN Khan,2,4,0,0,1,0,0,0,0,2,4,0,0
6480bba097818bcc0db9555d,2014,,,2,KL Rahul,KV Sharma,2,4,0,0,1,0,3,0,0,1,1,0,0
6480bba0d2cdb40c68c4739c,2013,,,1,M Vijay,MEK Hussey,2,4,0,0,1,1,2,0,0,1,2,0,0
6480bb94d8ce46258c13e90e,2017,,,2,DT Christian,Washington Sundar,2,2,0,0,0,0,0,0,0,2,2,0,0
6480bb96267b63eb2c6747b0,2019,,,1,CA Ingram,SS Iyer,2,4,0,0,1,1,2,0,0,1,2,0,0
6480bb9b5d0191a0a2611916,2009,,,2,GC Smith,RJ Quiney,2,4,0,0,1,0,3,0,0,1,1,0,0
6480bb9fa1611443840261b7,2012,,,2,MA Agarwal,V Kohli,2,3,0,0,1,1,2,0,0,1,1,0,0
6480bb9ec07aa72ec89917f0,2012,,,2,DJ Bravo,RA Jadeja,2,4,0,0,1,1,1,0,0,1,3,0,0
6480bb9740aaba2132c0eb0e,2021,,,2,AB de Villiers,DT Christian,2,5,0,0,1,1,2,0,0,1,3,0,0
6480bb94ce8e0a620532955b,2018,,,1,MS Dhoni,RA Jadeja,2,1,0,0,0,2,1,0,0,0,0,0,0
6480bb99695e001cdaca81e0,2022,,,1,MS Dhoni,Simarjeet Singh,2,3,0,0,1,0,0,0,0,2,3,0,0
6480bb9bc80883a975281815,2009,,,2,GC Smith,SA Asnodkar,2,5,0,0,1,1,3,0,0,0,2,0,0
6480bb982f070b023b901b3e,2021,,,1,KH Pandya,NM Coulter-Nile,2,3,0,0,1,1,1,0,0,1,2,0,0
6480bb97c48a16e84b55a325,2020/21,,,2,DA Warner,SP Goswami,2,4,0,0,1,1,1,0,0,0,3,0,0
6480bba07fa24b891b818984,2013,,,2,Harbhajan Singh,SL Malinga,2,5,0,0,1,1,4,0,0,1,1,0,0
6480bba1af51ddc81185931d,2014,,,1,V Kohli,VH Zol,2,5,0,0,1,0,1,0,0,2,4,0,0
6480bb995f3db9699a1f794d,2022,,,1,DP Conway,RD Gaikwad,2,6,0,0,1,0,0,0,0,2,6,0,0
6480bb97c48a16e84b55a325,2020/21,,,1,AB de Villiers,Navdeep Saini,2,4,0,0,1,1,2,0,0,1,2,0,0
6480bb93d5dc00a79edede9c,2017,,,2,B Kumar,Rashid Khan,2,3,0,0,1,1,1,0,0,1,2,0,0
6480bb945f95e767a8a9cc10,2017,,,2,KD Karthik,PJ Sangwan,2,3,0,0,1,1,1,0,0,1,2,0,0
6480bb9552e25b3867e5c38a,2019,,,2,KM Jadhav,RA Jadeja,2,3,0,0,1,1,1,0,0,1,2,0,0
6480bb95f282ca61c07afe9b,2018,,,2,DR Shorey,MS Dhoni,2,7,0,0,1,0,2,0,0,0,5,0,0
6480bb99773871f8e2ddc4b1,2022,,,1,B Kumar,R Shepherd,2,2,0,0,1,1,1,0,0,0,1,0,0
6480bb962a1612c936d161ba,2019,,,1,KH Pandya,RG Sharma,2,6,0,0,1,1,3,0,0,1,3,0,0
6480bba1553f17c77d5f1ca2,2014,,,2,CM Gautam,LMP Simmons,2,8,0,0,1,1,3,0,0,1,5,0,0
6480bb9d05f8e769574069fa,2009/10,,,2,AD Mathews,BB McCullum,2,5,0,0,1,1,2,0,0,1,3,0,0
6480bba237377ccc608266d2,2016,,,1,DA Miller,MG Johnson,2,3,0,0,1,1,1,0,0,1,2,0,0
6480bb9ca21b98f1be8254e2,2009/10,,,2,A Kumble,KP Appanna,2,3,0,0,0,1,1,0,0,1,2,0,0
6480bb931e6d2b03141b586d,2017,,,2,G Gambhir,MK Pandey,2,5,0,0,1,0,4,0,0,1,1,0,0
6480bb95014388d3e8c62904,2019,,,2,AR Patel,RR Pant,2,2,0,0,1,0,0,0,0,2,2,0,0
6480bb9f3ca20834ecc7607a,2012,,,1,JH Kallis,MS Bisla,2,5,0,0,1,2,4,0,0,0,1,0,0
6480bba23b270561e8026bd2,2015,,,1,B Kumar,KV Sharma,2,5,0,0,1,0,2,0,0,2,3,0,0
6480bb9b3a5e1af467fb027b,2009,,,1,KP Pietersen,RV Uthappa,2,4,0,0,1,0,1,0,0,2,3,0,0
6480bb97220be892fbfc2a36,2021,,,1,KA Pollard,KH Pandya,2,6,0,0,1,1,4,0,0,1,2,0,0
6480bb9f8ab73cf7c77cef03,2012,,,1,GB Hogg,OA Shah,2,1,0,0,0,0,0,0,0,2,1,0,0
6480bba0ad06ad631cf7665f,2014,,,2,KD Karthik,MK Tiwary,2,5,0,0,1,2,3,0,0,0,2,0,0
6480bb9737b1d7284b5297c1,2021,,,2,HV Patel,Mohammed Siraj,2,2,0,0,0,1,1,0,0,0,1,0,0
6480bb97220be892fbfc2a36,2021,,,1,RD Chahar,TA Boult,2,2,0,0,1,2,2,0,0,0,0,0,0
6480bb97220be892fbfc2a36,2021,,,1,Ishan Kishan,RG Sharma,2,4,0,0,1,1,3,0,0,1,1,0,0
6480bb984a8abbb79a69e6ce,2022,,,2,Abhishek Sharma,N Pooran,2,10,0,0,1,1,1,0,0,0,9,0,0
6480bb9ba6cd609c32579bde,2009,,,1,BB McCullum,WP Saha,2,3,0,0,1,1,2,0,0,1,1,0,0
6480bb9c71030f4c6f018f55,2009,,,1,Jaskaran Singh,RJ Harris,2,1,0,0,0,0,0,0,0,2,1,0,0
6480bb94adb227976b33d30b,2018,,,1,RR Pant,SS Iyer,2,2,0,0,1,0,1,0,0,1,1,0,0
6480bba2563745309ee2bdfb,2016,,,2,KC Cariappa,MM Sharma,2,4,0,0,1,1,2,0,0,1,2,0,0
6480bb9822eeb0c1c117f221,2021,,,2,AT Rayudu,RD Gaikwad,2,4,0,0,1,1,3,0,0,1,1,0,0
6480bba2db1e2def1b597ed3,2015,,,2,DA Miller,SN Thakur,2,3,0,0,1,1,2,0,0,1,1,0,0
6480bba250b404cdcbff22c8,2015,,,2,HH Pandya,KA Pollard,2,3,0,0,1,1,2,0,0,1,1,0,0
6480bb95f2e3c32afe233820,2018,,,1,B Kumar,S Kaul,2,3,0,0,1,1,2,0,0,1,1,0,0
6480bb99d2bd76016d47896d,2023,,,1,KH Pandya,KR Mayers,2,3,0,0,1,1,1,0,0,1,2,0,0
6480bb966539f85263cb6429,2019,,,2,SE Rutherford,SS Iyer,2,4,0,0,1,2,4,0,0,0,0,0,0
6480bba0a3e806f41a4dab41,2013,,,2,A Mithun,R Vinay Kumar,2,2,0,0,1,2,2,0,0,0,0,0,0
6480bb9429a15517bb46f3be,2018,,,1,A Dananjaya,HH Pandya,2,4,0,0,1,2,3,0,0,0,1,0,0
6480bb948211fe47e65f2e77,2018,,,2,HH Pandya,M Markande,2,4,0,0,1,0,2,0,0,1,2,0,0
6480bb9618b5973b98c0ba18,2019,,,1,KS Williamson,Rashid Khan,2,3,0,0,1,1,1,0,0,1,2,0,0
6480bb962fbc99d08dc59f56,2020/21,,,1,CH Morris,V Kohli,2,2,0,0,1,0,0,0,0,2,2,0,0
6480bb9894cc2d00f057a1f1,2021,,,2,RA Tripathi,Shubman Gill,2,4,0,0,1,1,1,0,0,1,3,0,0
6480bb9c620c92d09ba1b6b9,2009,,,2,AS Raut,RA Jadeja,2,3,0,0,1,1,2,0,0,1,1,0,0
6480bb9a7d91d721555835e5,2007/08,,,2,DB Das,Umar Gul,2,4,0,0,1,1,3,0,0,1,1,0,0
6480bb95816d3ad3bc382ab6,2018,,,1,JC Archer,RA Tripathi,2,10,0,0,1,0,4,0,0,2,6,0,0
6480bb981f136a7564719d7f,2022,,,1,K Rabada,RD Chahar,2,3,0,0,1,0,0,0,0,2,3,0,0
6480bb94ee669473878c11c2,2017,,,2,P Negi,S Badree,2,4,0,0,1,2,3,0,0,0,1,0,0
6480bba1e64915b9e7c849ca,2014,,,2,DA Miller,WP Saha,2,5,0,0,1,1,4,0,0,1,1,0,0
6480bb9ae4498012aa089436,2023,,,1,AT Rayudu,S Dube,2,4,0,0,1,1,2,0,0,1,2,0,0
6480bb9525ace33768e8b671,2019,,,1,AT Rayudu,KM Jadhav,2,3,0,0,1,1,1,0,0,1,2,0,0
6480bb9c13817091131f76e3,2009/10,,,1,HH Gibbs,VVS Laxman,2,3,0,0,1,1,2,0,0,1,1,0,0
6480bba0f401cc6b6bc6ed10,2013,,,2,BB Samantray,NLTC Perera,2,4,0,0,1,1,3,0,0,0,1,0,0
6480bb9e32ed1b9e077b8c11,2011,,,1,AL Menaria,LRPL Taylor,2,5,0,0,1,1,2,0,0,1,3,0,0
6480bb9f36da1a646c80be45,2013,,,2,BMAJ Mendis,MC Juneja,2,3,0,0,1,0,1,0,0,2,2,0,0
6480bb95f282ca61c07afe9b,2018,,,1,TG Southee,UT Yadav,2,6,0,0,1,1,1,0,0,1,5,0,0
6480bb9f895e5780080c8059,2012,,,1,DJ Hussey,PC Valthaty,2,6,0,0,1,2,4,0,0,0,2,0,0
6480bba10e78f50f124b406a,2015,,,1,RR Rossouw,V Kohli,2,3,0,0,1,1,2,0,0,1,1,0,0
6480bb9c6f1c8ea3dc73226f,2009/10,,,1,AB de Villiers,MF Maharoof,2,4,0,0,1,0,2,0,0,1,2,0,0
6480bb993e61058e682e2ff4,2023,,,2,D Padikkal,JC Buttler,2,8,0,0,1,1,5,0,0,0,3,0,0
6480bb938ed49c6d5c211429,2017,,,1,CR Woakes,YK Pathan,2,2,0,0,0,1,1,0,0,1,1,0,0
6480bb966c197bad273f91f1,2020/21,,,2,JC Archer,S Gopal,2,3,0,0,1,1,1,0,0,1,2,0,0
6480bb9b62eb35d78fcd7df0,2007/08,,,2,G Gambhir,V Sehwag,2,2,0,0,1,1,1,0,0,0,1,0,0
6480bb9df60a79ae5f20b748,2011,,,1,RE van der Merwe,UT Yadav,2,5,0,0,1,1,1,0,0,0,4,0,0
6480bb96c95abb10156a6055,2020/21,,,1,Q de Kock,SA Yadav,2,3,0,0,1,1,2,0,0,1,1,0,0
6480bb994877788ec5b187ff,2023,,,1,MM Ali,MS Dhoni,2,2,0,0,0,1,1,0,0,1,1,0,0
6480bba0c63a6317296391b7,2013,,,1,Harbhajan Singh,SL Malinga,2,3,0,0,1,1,2,0,0,1,1,0,0
6480bba35038a60ea566794a,2016,,,1,AJ Finch,DR Smith,2,4,0,0,1,1,1,0,0,1,3,0,0
6480bb9be88c31fc563da86f,2009,,,1,JD Ryder,SP Goswami,2,5,0,0,1,2,5,0,0,0,0,0,0
6480bb93182304739a535742,2017,,,1,BA Stokes,MS Dhoni,2,7,0,0,1,1,4,0,0,1,3,0,0
6480bba280f09c38002cf14b,2015,,,1,J Botha,PP Chawla,2,3,0,0,1,0,1,0,0,1,2,0,0
6480bb95c28e7980e1768064,2018,,,1,DJ Bravo,MS Dhoni,2,2,0,0,0,1,1,0,0,1,1,0,0
6480bba07e219ed95b7b06df,2013,,,2,AJ Finch,Yuvraj Singh,2,4,0,0,1,2,4,0,0,0,0,0,0
6480bba0001885407e860a8d,2013,,,2,A Nehra,UT Yadav,2,6,0,0,1,0,1,0,0,2,5,0,0
6480bb961cdee4d82c395517,2020/21,,,2,PP Shaw,S Dhawan,2,5,0,0,1,2,5,0,0,0,0,0,0
6480bb9d76ba2d9dd45c74a8,2011,,,2,DPMD Jayawardene,PA Patel,2,4,0,0,1,1,2,0,0,1,2,0,0
6480bb9c58b62383739c022e,2009,,,1,DS Kulkarni,Harbhajan Singh,2,4,0,0,1,1,4,0,0,0,0,0,0
6480bb967d799ced7fe5d8e9,2020/21,,,2,JO Holder,PK Garg,2,4,0,0,1,1,2,0,0,1,2,0,0
6480bba163bd0c619365a16b,2015,,,1,MA Agarwal,SS Iyer,2,3,0,0,1,1,2,0,0,1,1,0,0
6480bb9f36ad55c3c7fd6548,2012,,,2,MK Tiwary,YK Pathan,2,5,0,0,1,1,4,0,0,1,1,0,0
6480bb99f47261f111a6cc1a,2023,,,2,Arjun Tendulkar,N Wadhera,2,3,0,0,1,1,1,0,0,1,2,0,0
6480bba26c6e47258e0c7d24,2015,,,1,CH Gayle,V Kohli,2,7,0,0,0,1,5,0,0,1,2,0,0
6480bba3b818a7cff6fe4f89,2016,,,1,B Kumar,NV Ojha,2,2,0,0,1,1,1,0,0,0,1,0,0
6480bb94738952e740c68749,2018,,,2,CH Gayle,MA Agarwal,2,3,0,0,1,0,1,0,0,2,2,0,0
6480bba2ad3f26917361061f,2016,,,1,SN Khan,V Kohli,2,3,0,0,1,1,2,0,0,1,1,0,0
6480bb9bed3e2a1a008f93a6,2007/08,,,2,AB Dinda,Shoaib Akhtar,2,5,0,0,1,1,1,0,0,1,4,0,0
6480bba0fee4ae82492a666f,2013,,,1,NLTC Perera,PA Patel,2,4,0,0,1,1,1,0,0,1,3,0,0
6480bba0295edd6084b9503b,2014,,,1,AJ Finch,S Dhawan,2,5,0,0,1,2,5,0,0,0,0,0,0
6480bba07fa24b891b818984,2013,,,1,Azhar Mahmood,DA Miller,2,4,0,0,1,1,3,0,0,1,1,0,0
6480bb949a2d28d1ad7d367f,2018,,,1,CH Morris,R Tewatia,2,3,0,0,1,1,1,0,0,1,2,0,0
6480bb973d64aa91e60b4088,2021,,,1,RA Jadeja,SK Raina,2,3,0,0,1,1,1,0,0,0,2,0,0
6480bb984f6c41cd28aa0353,2022,,,2,B Kumar,R Shepherd,2,3,0,0,1,1,2,0,0,1,1,0,0
6480bb9eb559e2934b31c47c,2012,,,2,AT Rayudu,SR Tendulkar,2,3,0,0,1,1,1,0,0,1,2,0,0
6480bb9797043717cd96890a,2021,,,1,MK Lomror,R Tewatia,2,2,0,0,0,1,1,0,0,0,1,0,0
6480bb962a1612c936d161ba,2019,,,2,Harbhajan Singh,MJ Santner,2,5,0,0,1,1,3,0,0,1,2,0,0
6480bb95816d3ad3bc382ab6,2018,,,2,AB de Villiers,SN Khan,2,4,0,0,1,1,2,0,0,1,2,0,0
6480bb9ab49fc97bbb30576f,2023,,,2,MD Shanaka,Shubman Gill,2,4,0,0,1,0,3,0,0,1,1,0,0
6480bb9341152e168005ccc9,2017,,,2,BA Stokes,DT Christian,2,4,0,0,1,1,1,0,0,1,3,0,0
6480bb9db0ecec8acdd30619,2011,,,1,A Mithun,M Kaif,2,2,0,0,0,0,0,0,0,2,2,0,0
6480bb9f955d5c84cde78f58,2012,,,2,M Kartik,R Sharma,2,4,0,0,1,1,1,0,0,0,3,0,0
6480bba0cdc200ad3ab8fbf5,2014,,,2,CM Gautam,KA Pollard,2,3,0,0,1,1,1,0,0,1,2,0,0
6480bb9a77f349a0fd8d96d6,2023,,,1,P Simran Singh,S Dhawan,2,2,0,0,1,2,2,0,0,0,0,0,0
6480bb9e156723e64d6bd26b,2012,,,1,B Chipli,S Dhawan,2,9,0,0,1,1,6,0,0,1,3,0,0
6480bb9efe3f9991539e7f6c,2012,,,2,A Nehra,R Sharma,2,2,0,0,1,1,1,0,0,0,1,0,0
6480bb98aae066234fd8f11e,2022,,,1,A Manohar,DA Miller,2,3,0,0,1,1,2,0,0,1,1,0,0
6480bba18a431be2cc738de0,2014,,,1,KD Karthik,Q de Kock,2,3,0,0,1,1,1,0,0,0,2,0,0
6480bb977f55a1c473670850,2021,,,1,DA Miller,GD Phillips,2,7,0,0,1,2,3,0,0,0,4,0,0
6480bb9fe31a789bcb52d583,2012,,,1,B Kumar,WD Parnell,2,4,0,0,1,1,2,0,0,1,2,0,0
6480bb9d5d93b08a19c16313,2009/10,,,2,DJ Hussey,MK Tiwary,2,4,0,0,1,0,3,0,0,0,1,0,0
6480bb9f68a0a232d83c338c,2012,,,2,HH Gibbs,RG Sharma,2,3,0,0,1,2,2,0,0,0,1,0,0
6480bb9558345af5a1bb044d,2019,,,1,Mohammed Siraj,UT Yadav,2,1,0,0,0,0,0,0,0,0,1,0,0
6480bb962831291a868490e7,2020/21,,,2,AR Patel,K Rabada,2,4,0,0,1,1,3,0,0,1,1,0,0
6480bba120182b9ca0b70004,2014,,,1,BR Dunk,CJ Anderson,2,8,0,0,1,0,0,0,0,1,8,0,0
6480bb939c56810fd88e895b,2017,,,2,SR Watson,Vishnu Vinod,2,6,0,0,1,1,4,0,0,1,2,0,0
6480bba237377ccc608266d2,2016,,,1,DA Miller,NS Naik,2,4,0,0,1,1,1,0,0,1,3,0,0
6480bb97c92184fed1a879f3,2021,,,1,Abdul Samad,JJ Roy,2,5,0,0,1,1,2,0,0,1,3,0,0
6480bb94988cb8c136ec7e46,2018,,,1,AJ Tye,BB Sran,2,2,0,0,0,2,2,0,0,0,0,0,0
6480bba33dab752d79e587d2,2016,,,1,KS Williamson,NV Ojha,2,4,0,0,1,0,1,0,0,2,3,0,0
6480bb99864a94e086c8395e,2022,,,1,AK Markram,RA Tripathi,2,3,0,0,1,2,2,0,0,0,1,0,0
6480bb995193664eda3e9e10,2022,,,2,DR Sams,KA Pollard,2,3,0,0,1,1,2,0,0,1,1,0,0
6480bba1d3b4ddc36050e3f3,2014,,,2,PP Chawla,RN ten Doeschate,2,4,0,0,1,1,1,0,0,1,3,0,0
6480bb964c4bea88164f168d,2020/21,,,2,R Parag,RV Uthappa,2,6,0,0,1,1,4,0,0,1,2,0,0
6480bba3caa5150f2db7a1dc,2016,,,2,BB McCullum,DR Smith,2,16,0,0,1,1,7,0,0,1,9,0,0
6480bb9f777b7b1e89543a6e,2013,,,2,AT Rayudu,R Dhawan,2,4,0,0,1,2,3,0,0,0,1,0,0
6480bb9c89f35f11aae1f2d0,2009/10,,,2,P Dogra,SK Warne,2,2,0,0,1,1,1,0,0,0,1,0,0
6480bb9b1fc007965b68d4d9,2009,,,1,DB Ravi Teja,FH Edwards,2,4,0,0,1,1,1,0,0,1,3,0,0
6480bb9553f3fc8903579544,2018,,,2,Kuldeep Yadav,M Prasidh Krishna,2,8,0,0,1,1,3,0,0,1,5,0,0
6480bb9dd778cb6c44535092,2009/10,,,2,AP Tare,S Dhawan,2,5,0,0,1,1,3,0,0,1,2,0,0
6480bb958e752648ab95362b,2019,,,1,RV Uthappa,SP Narine,2,5,0,0,1,1,1,0,0,1,4,0,0
6480bb9f6f311344dac147cc,2012,,,2,AD Mathews,SPD Smith,2,4,0,0,1,1,1,0,0,1,3,0,0
6480bb94c2dcb1007bf6788b,2017,,,2,HM Amla,MJ Guptill,2,5,0,0,1,1,3,0,0,1,2,0,0
6480bb94cb5adf24f5ad15c3,2017,,,1,MJ McClenaghan,PA Patel,2,3,0,0,1,1,1,0,0,0,2,0,0
6480bba01893b0faadb9c761,2013,,,2,J Syed Mohammad,R Rampaul,2,3,0,0,1,2,3,0,0,0,0,0,0
6480bb94f1c027945eeb8b10,2017,,,2,Harbhajan Singh,MJ McClenaghan,2,1,0,0,0,0,0,0,0,2,1,0,0
6480bb99c6aa5989a16174d1,2023,,,2,Abdul Basith,Dhruv Jurel,2,2,0,0,0,1,1,0,0,1,1,0,0
6480bb9c8f3ef1685cdf4017,2009,,,2,MN van Wyk,SC Ganguly,2,5,0,0,1,0,2,0,0,1,3,0,0
6480bb96d1b3bea0aa2127e4,2020/21,,,2,NS Naik,PJ Cummins,2,5,0,0,1,0,2,0,0,2,3,0,0
6480bb99efa58b95852be382,2023,,,1,RA Jadeja,S Dube,2,3,0,0,1,1,2,0,0,1,1,0,0
6480bb9e80233e83b9d1be1f,2012,,,1,Harbhajan Singh,RP Singh,2,6,0,0,1,1,2,0,0,0,4,0,0
6480bb960d9d6af315534958,2019,,,1,R Ashwin,SM Curran,2,4,0,0,1,0,3,0,0,1,1,0,0
6480bb950ced01a335bd7833,2019,,,1,PA Patel,SO Hetmyer,2,10,0,0,1,1,1,0,0,1,9,0,0
6480bba19e29de4f208211ac,2014,,,2,V Kohli,Yuvraj Singh,2,5,0,0,1,0,2,0,0,2,3,0,0
6480bb9824c4678d005d7aeb,2022,,,2,SP Jackson,SS Iyer,2,3,0,0,1,1,2,0,0,0,1,0,0
6480bb9f60d58ee39ba047b9,2013,,,2,PA Patel,PA Reddy,2,8,0,0,1,0,0,0,0,1,8,0,0
6480bba0f401cc6b6bc6ed10,2013,,,1,AM Rahane,STR Binny,2,4,0,0,1,1,3,0,0,1,1,0,0
6480bb9435048f20502ba1e1,2018,,,1,C de Grandhomme,Washington Sundar,2,4,0,0,1,1,1,0,0,1,3,0,0
6480bb94351a8b10e20d14d9,2017,,,1,HM Amla,MJ Guptill,2,5,0,0,1,0,0,0,0,2,5,0,0
6480bb9b2a5f2fd5053534dc,2007/08,,,2,DPMD Jayawardene,LA Pomersbach,2,5,0,0,1,1,2,0,0,1,3,0,0
6480bb9498a98d52f9285b52,2017,,,2,MS Dhoni,SPD Smith,2,7,0,0,1,2,6,0,0,0,1,0,0
6480bb9c8cbb5dec60b7d50a,2009/10,,,2,AC Gilchrist,VVS Laxman,2,4,0,0,1,1,3,0,0,1,1,0,0
6480bb99ecbdaaf953b8eee5,2023,,,1,AT Rayudu,MJ Santner,2,2,0,0,0,1,1,0,0,1,1,0,0
6480bb951677500061c85592,2019,,,2,B Kumar,Mohammad Nabi,2,5,0,0,1,1,3,0,0,0,2,0,0
6480bb9ee779ef1e445d0506,2012,,,1,AT Rayudu,RG Sharma,2,5,0,0,1,1,2,0,0,1,3,0,0
6480bba18a2fe828fa106f6c,2014,,,2,KA Pollard,MEK Hussey,2,3,0,0,1,1,1,0,0,1,2,0,0
6480bb9d1ed71a4f47892d00,2009/10,,,2,AS Raut,P Dogra,2,9,0,0,1,1,3,0,0,1,6,0,0
6480bba0ad06ad631cf7665f,2014,,,2,JD Unadkat,S Nadeem,2,8,0,0,1,1,5,0,0,1,3,0,0
6480bb9eb2690fb1ed356b42,2011,,,1,Harbhajan Singh,SL Malinga,2,1,0,0,1,1,1,0,0,0,0,0,0
6480bb9c1e676472f4841aa9,2009/10,,,2,ML Hayden,PA Patel,2,6,0,0,1,1,3,0,0,1,3,0,0
6480bba0f401cc6b6bc6ed10,2013,,,2,PA Patel,S Dhawan,2,6,0,0,1,1,3,0,0,1,3,0,0
6480bb9b95eac8df5d0180b0,2007/08,,,1,Shoaib Malik,V Sehwag,2,2,0,0,0,1,1,0,0,1,1,0,0
6480bb9b166300b6298fc71a,2009,,,1,K Goel,KC Sangakkara,2,5,0,0,1,1,4,0,0,0,1,0,0
6480bb98adf21699eaa67796,2022,,,1,KD Karthik,Mohammed Siraj,2,1,0,0,0,2,1,0,0,0,0,0,0
6480bba20559f15c3489f637,2015,,,1,Harbhajan Singh,KA Pollard,2,5,0,0,1,0,4,0,0,1,1,0,0
6480bb9a7d91d721555835e5,2007/08,,,2,DJ Hussey,LR Shukla,2,2,0,0,1,0,0,0,0,2,2,0,0
6480bba0587190387a754733,2013,,,1,IK Pathan,KM Jadhav,2,2,0,0,1,0,0,0,0,2,2,0,0
6480bba1b8e3071cc513602a,2014,,,1,DS Kulkarni,KW Richardson,2,4,0,0,1,1,2,0,0,1,2,0,0
6480bb98436587de59527f2e,2022,,,2,PP Shaw,RR Pant,2,2,0,0,1,0,0,0,0,1,2,0,0
6480bb9d5cca30c933d4baf4,2011,,,2,LRPL Taylor,STR Binny,2,9,0,0,1,0,5,0,0,2,4,0,0
6480bb9bbb0ec0266749f518,2007/08,,,1,Misbah-ul-Haq,V Kohli,2,3,0,0,1,2,2,0,0,0,1,0,0
6480bb9f6f311344dac147cc,2012,,,1,BB McCullum,YK Pathan,2,7,0,0,1,0,4,0,0,2,3,0,0
6480bba097818bcc0db9555d,2014,,,2,DA Warner,KL Rahul,2,2,0,0,1,0,1,0,0,1,1,0,0
6480bb94dfad571ef76493a9,2017,,,1,A Mishra,K Rabada,2,8,0,0,1,1,5,0,0,0,3,0,0
6480bba265483f7db002ec7c,2015,,,2,MC Henriques,RS Bopara,2,4,0,0,1,2,2,0,0,0,2,0,0
6480bb9ca5c1d511ad78e92d,2009,,,1,JH Kallis,RV Uthappa,2,6,0,0,1,1,1,0,0,1,5,0,0
6480bb954714437843ab3647,2019,,,1,CH Morris,RR Pant,2,3,0,0,1,2,2,0,0,0,1,0,0
6480bb95816d3ad3bc382ab6,2018,,,2,AB de Villiers,MM Ali,2,3,0,0,1,1,1,0,0,1,2,0,0
6480bb9db6a011b38afed5dc,2011,,,2,DPMD Jayawardene,PA Patel,2,3,0,0,1,2,3,0,0,0,0,0,0
6480bba25855b7a7195a9bc5,2016,,,2,HH Pandya,TG Southee,2,2,0,0,0,1,1,0,0,1,1,0,0
6480bb96ef6f4c2c85264241,2019,,,2,BB Sran,RD Chahar,2,2,0,0,0,1,1,0,0,1,1,0,0
6480bb9de80788b3c3ebe4e1,2009/10,,,1,AC Voges,AS Raut,2,4,0,0,1,1,3,0,0,1,1,0,0
6480bb9525ace33768e8b671,2019,,,1,F du Plessis,SK Raina,2,3,0,0,1,0,1,0,0,2,2,0,0
6480bb9ca181f55cb21526f5,2009/10,,,1,Harbhajan Singh,R Sathish,2,4,0,0,1,1,2,0,0,1,2,0,0
6480bb971c9e4a3ef11759f3,2021,,,1,CH Gayle,MA Agarwal,2,5,0,0,1,0,1,0,0,2,4,0,0
6480bba0c63a6317296391b7,2013,,,2,AM Rahane,SR Watson,2,6,0,0,1,0,2,0,0,2,4,0,0
6480bb990942cd416cf5f447,2022,,,2,DJ Hooda,JO Holder,2,4,0,0,1,1,2,0,0,1,2,0,0
6480bba0dcd1149b9b0b501f,2013,,,1,B Kumar,Parvez Rasool,2,6,0,0,1,1,3,0,0,1,3,0,0
6480bba2a215721aadf7a90a,2015,,,2,CH Morris,PV Tambe,2,2,0,0,0,1,1,0,0,1,1,0,0
6480bb9341152e168005ccc9,2017,,,1,AF Milne,STR Binny,2,3,0,0,1,1,1,0,0,1,2,0,0
6480bb9a807eb5f39489408a,2023,,,1,DL Chahar,MS Dhoni,2,3,0,0,1,1,2,0,0,0,1,0,0
6480bb94351a8b10e20d14d9,2017,,,1,AR Patel,GJ Maxwell,2,1,0,0,0,2,1,0,0,0,0,0,0
6480bb98adf21699eaa67796,2022,,,1,KD Karthik,Shahbaz Ahmed,2,4,0,0,1,1,2,0,0,1,2,0,0
6480bb99f47261f111a6cc1a,2023,,,1,R Tewatia,Rashid Khan,2,1,0,0,0,0,0,0,0,2,1,0,0
6480bb99cbb648c5c0ecb205,2023,,,2,Shubman Gill,V Shankar,2,4,0,0,1,0,1,0,0,2,3,0,0
6480bb9c757dbd7f92b1130a,2009/10,,,1,A Symonds,MD Mishra,2,3,0,0,1,1,2,0,0,0,1,0,0
6480bba2e680f2464af841ae,2015,,,2,DA Warner,MC Henriques,2,2,0,0,1,1,2,0,0,0,0,0,0
6480bba2679194b06d4834db,2016,,,2,MJ Guptill,PA Patel,2,4,0,0,1,2,4,0,0,0,0,0,0
6480bb9b6ded6d116cfe02ee,2009,,,1,LR Shukla,Yashpal Singh,2,5,0,0,1,0,3,0,0,2,2,0,0
6480bb95cf9d446747bd74fe,2019,,,1,CA Ingram,S Dhawan,2,2,0,0,1,2,2,0,0,0,0,0,0
6480bb9c12f907c7b81b11a9,2009,,,2,A Singh,MM Patel,2,3,0,0,0,1,2,0,0,1,1,0,0
6480bb9e1751fd9db64a2834,2011,,,1,Harbhajan Singh,JEC Franklin,2,2,0,0,0,1,1,0,0,1,1,0,0
6480bb95385ebb9bda58a643,2019,,,2,C Munro,SS Iyer,2,7,0,0,1,0,4,0,0,2,3,0,0
6480bb958f77e7d3929d28e3,2018,,,1,KL Rahul,MK Tiwary,2,7,0,0,1,0,2,0,0,2,5,0,0
6480bb94a964c10b5f10ae52,2017,,,2,MM Sharma,Sandeep Sharma,2,4,0,0,1,2,4,0,0,0,0,0,0
6480bb9edb0554f003f5428a,2012,,,2,CH Gayle,TM Dilshan,2,6,0,0,1,1,3,0,0,1,3,0,0
6480bb9908b154f78b12b8fb,2023,,,2,DJ Willey,KD Karthik,2,4,0,0,1,2,3,0,0,0,1,0,0
6480bb9e95693a2c4c4531e8,2011,,,2,IK Pathan,JR Hopes,2,3,0,0,1,0,1,0,0,2,2,0,0
6480bb9eb35365cccf73d55c,2011,,,2,G Gambhir,R Bhatia,2,6,0,0,0,1,3,0,0,1,3,0,0
6480bb9e591b94e62772e66a,2012,,,2,RP Singh,SL Malinga,2,3,0,0,1,1,1,0,0,1,2,0,0
6480bba1d3370c13ea1f79f3,2014,,,2,Mohammed Shami,R Shukla,2,2,0,0,0,1,1,0,0,1,1,0,0
6480bb9bd918d2e963f0218a,2009,,,2,DB Ravi Teja,Y Venugopal Rao,2,4,0,0,1,1,1,0,0,1,3,0,0
6480bba2d324f0342e6af689,2016,,,1,DW Steyn,P Kumar,2,3,0,0,1,1,2,0,0,1,1,0,0
6480bb9e95693a2c4c4531e8,2011,,,1,PP Chawla,RJ Harris,2,2,0,0,0,1,1,0,0,1,1,0,0
6480bb975ea60ce128803d60,2021,,,2,M Prasidh Krishna,PJ Cummins,2,4,0,0,1,0,1,0,0,1,3,0,0
6480bb9623a26d3fbfe59f25,2020/21,,,2,AJ Finch,D Padikkal,2,4,0,0,1,1,2,0,0,1,2,0,0
6480bb932f8447acd7840076,2017,,,2,JJ Roy,SK Raina,2,3,0,0,1,2,2,0,0,0,1,0,0
6480bb9e88141830a7a309b5,2011,,,2,MK Tiwary,SP Goswami,2,3,0,0,1,2,2,0,0,0,1,0,0
6480bba2e3610f863b52b887,2016,,,1,DJ Hooda,S Dhawan,2,10,0,0,1,1,9,0,0,1,1,0,0
6480bb98373b1ea5035ab3da,2021,,,2,N Rana,Shubman Gill,2,2,0,0,1,0,1,0,0,1,1,0,0
6480bb9d59f2ded94f736145,2011,,,2,DB Ravi Teja,MS Gony,2,2,0,0,0,1,1,0,0,0,1,0,0
6480bb9f231505ffc493730f,2012,,,2,AA Jhunjhunwala,DT Christian,2,2,0,0,0,1,1,0,0,1,1,0,0
6480bb98aae066234fd8f11e,2022,,,2,Mandeep Singh,RR Pant,2,4,0,0,1,0,3,0,0,1,1,0,0
6480bba03b6f98689b851317,2013,,,1,MS Bisla,SMSM Senanayake,2,3,0,0,0,1,2,0,0,0,1,0,0
6480bba1743abcb135a6a4c7,2015,,,1,Anureet Singh,GJ Bailey,2,3,0,0,1,0,1,0,0,1,2,0,0
6480bb9bef0d1fffea8bfd11,2009,,,2,S Sohal,SM Katich,2,2,0,0,1,2,2,0,0,0,0,0,0
6480bba0ad06ad631cf7665f,2014,,,2,Mohammed Shami,S Nadeem,2,3,0,0,1,1,3,0,0,0,0,0,0
6480bba2f36e449a59f4a812,2015,,,1,Imran Tahir,KM Jadhav,2,6,0,0,1,1,2,0,0,1,4,0,0
6480bb9f60d58ee39ba047b9,2013,,,1,KM Jadhav,S Nadeem,2,3,0,0,1,2,2,0,0,0,1,0,0
6480bb95d4da0397e79acffa,2019,,,1,RV Uthappa,SP Narine,2,5,0,0,1,1,2,0,0,0,3,0,0
6480bb951677500061c85592,2019,,,1,Ishan Kishan,KA Pollard,2,7,0,0,1,0,4,0,0,2,3,0,0
6480bb9c44492d9e5fc4bb60,2009/10,,,2,JH Kallis,MK Pandey,2,9,0,0,1,1,2,0,0,0,7,0,0
6480bb95b33a36f0dd77d1a1,2018,,,1,BCJ Cutting,JP Duminy,2,1,0,0,0,2,1,0,0,0,0,0,0
6480bb96f1eadf803ffc292c,2020/21,,,1,HV Patel,K Rabada,2,4,0,0,1,1,2,0,0,1,2,0,0
6480bb9fc3369c6f5a549d05,2013,,,1,MC Juneja,V Sehwag,2,3,0,0,1,2,3,0,0,0,0,0,0
6480bb9d76ba2d9dd45c74a8,2011,,,2,KM Jadhav,NLTC Perera,2,5,0,0,1,1,3,0,0,1,2,0,0
6480bb9baa08d0494c0b8dc3,2007/08,,,2,Misbah-ul-Haq,V Kohli,2,5,0,0,1,0,1,0,0,2,4,0,0
6480bb9f4780a208e13bfb3d,2013,,,2,A Chandila,DH Yagnik,2,3,0,0,1,1,1,0,0,1,2,0,0
6480bb98373b1ea5035ab3da,2021,,,2,EJG Morgan,LH Ferguson,2,5,0,0,1,0,3,0,0,2,2,0,0
6480bb9a365c63af4b3de24c,2023,,,1,R Dhawan,Sikandar Raza,2,1,0,0,0,0,0,0,0,2,1,0,0
6480bb963d224b9be17f2c75,2019,,,1,DJ Hooda,Shakib Al Hasan,2,3,0,0,1,0,1,0,0,2,2,0,0
6480bb96ec7d98e34055e8fc,2020/21,,,1,DA Miller,SPD Smith,2,2,0,0,1,0,0,0,0,1,2,0,0
6480bb9b332c16fba9cd28bc,2009,,,2,JP Duminy,ST Jayasuriya,2,10,0,0,1,1,6,0,0,1,4,0,0
6480bb9edd901481f13ce9ba,2012,,,2,AB McDonald,AB de Villiers,2,5,0,0,1,2,3,0,0,0,2,0,0
6480bba0d3cbb27b257a9c1f,2013,,,1,PP Chawla,R Sathish,2,2,0,0,0,1,1,0,0,1,1,0,0
6480bb9435048f20502ba1e1,2018,,,1,C de Grandhomme,TG Southee,2,5,0,0,1,1,3,0,0,1,2,0,0
6480bb9c13817091131f76e3,2009/10,,,1,Jaskaran Singh,TL Suman,2,3,0,0,1,0,1,0,0,2,2,0,0
6480bba1d3370c13ea1f79f3,2014,,,2,M Vijay,Q de Kock,2,4,0,0,1,1,3,0,0,1,1,0,0
6480bb9ef7c6084992b7cdf8,2012,,,2,B Chipli,DW Steyn,2,3,0,0,1,0,0,0,0,2,3,0,0
6480bba1af51ddc81185931d,2014,,,1,RR Rossouw,YV Takawale,2,5,0,0,1,1,4,0,0,1,1,0,0
6480bb97746881ab34c38bf8,2020/21,,,2,Q de Kock,SA Yadav,2,4,0,0,1,2,2,0,0,0,2,0,0
6480bb952f20835ddd6e533f,2019,,,2,BA Stokes,SV Samson,2,2,0,0,1,0,0,0,0,2,2,0,0
6480bb982fc21d541267f7b9,2022,,,1,DP Conway,RD Gaikwad,2,4,0,0,1,0,0,0,0,0,4,0,0
6480bb981dc3f7250f93bc92,2022,,,2,AR Patel,SN Thakur,2,3,0,0,1,1,1,0,0,1,2,0,0
6480bb94f06c6048c8088194,2018,,,1,JC Buttler,SV Samson,2,3,0,0,1,1,1,0,0,1,2,0,0
6480bb96e18d7a1b3e62552d,2019,,,2,M Ashwin,Mohammed Shami,2,2,0,0,0,1,1,0,0,1,1,0,0
6480bb9808d6857eeb335d94,2022,,,2,Lalit Yadav,RR Pant,2,9,0,0,1,0,5,0,0,2,4,0,0
6480bb96e76ccde6082d7564,2020/21,,,2,GJ Maxwell,KL Rahul,2,2,0,0,1,0,0,0,0,2,2,0,0
6480bb9bcf9df9e7ae0416ba,2009,,,1,A Kumble,R Vinay Kumar,2,4,0,0,1,0,0,0,0,2,4,0,0
6480bb9740aaba2132c0eb0e,2021,,,2,AB de Villiers,KA Jamieson,2,3,0,0,1,1,2,0,0,1,1,0,0
6480bb9a87f64c1a12f62ece,2007/08,,,1,JDP Oram,S Badrinath,2,1,0,0,0,0,0,0,0,2,1,0,0
6480bb9c7b7d7712bdc663de,2009/10,,,2,MD Mishra,TL Suman,2,4,0,0,1,0,2,0,0,2,2,0,0
6480bb9eb14c6138aebfbf98,2012,,,1,AC Gilchrist,P Dogra,2,2,0,0,1,0,0,0,0,1,2,0,0
6480bba0208e8fbb34afdc50,2013,,,1,MC Henriques,V Kohli,2,3,0,0,1,0,1,0,0,2,2,0,0
6480bb95f282ca61c07afe9b,2018,,,1,C de Grandhomme,TG Southee,2,6,0,0,1,1,3,0,0,1,3,0,0
6480bb9f87652064dab6c573,2013,,,2,SMSM Senanayake,SP Narine,2,3,0,0,1,1,2,0,0,1,1,0,0
6480bb9e05381e16815803e9,2011,,,1,P Kumar,SD Chitnis,2,3,0,0,1,1,1,0,0,1,2,0,0
6480bb97a42828c5a5ebef1c,2020/21,,,2,A Nortje,K Rabada,2,1,0,0,0,0,0,0,0,0,1,0,0
6480bb94adb227976b33d30b,2018,,,2,MG Johnson,PP Chawla,2,3,0,0,1,2,2,0,0,0,1,0,0
6480bb94b882fb725e3f98e5,2018,,,2,S Dhawan,WP Saha,2,5,0,0,1,0,1,0,0,1,4,0,0
6480bba0cdc200ad3ab8fbf5,2014,,,2,AT Rayudu,KA Pollard,2,3,0,0,1,1,2,0,0,1,1,0,0
6480bba11a59d64bb4aa66f4,2014,,,2,JP Faulkner,KK Cooper,2,2,0,0,1,0,0,0,0,2,2,0,0
6480bb9938b659481e3ab6dc,2022,,,1,R Ashwin,TA Boult,2,1,0,0,0,2,1,0,0,0,0,0,0
6480bba328f7475f4b87d3ff,2016,,,2,JO Holder,SP Narine,2,7,0,0,1,1,2,0,0,1,5,0,0
6480bb9dc4ec5a52f8bcc465,2009/10,,,2,JP Duminy,R McLaren,2,2,0,0,1,1,1,0,0,0,1,0,0
6480bb9c0dec1a788da66d33,2009/10,,,1,S Narwal,SW Tait,2,2,0,0,0,1,1,0,0,1,1,0,0
6480bb9aa64355ce98da1141,2007/08,,,1,A Kumble,DW Steyn,2,5,0,0,1,1,2,0,0,1,3,0,0
6480bb971c9e4a3ef11759f3,2021,,,1,Arshdeep Singh,Mohammed Shami,2,2,0,0,0,1,1,0,0,1,1,0,0
6480bb9525ace33768e8b671,2019,,,1,AT Rayudu,SW Billings,2,6,0,0,1,1,2,0,0,0,4,0,0
6480bb9651b51fdcda05e4c8,2020/21,,,2,S Gopal,VR Aaron,2,9,0,0,0,1,1,0,0,0,8,0,0
6480bb9bee2e48d9c41b1e23,2009,,,2,DR Smith,TL Suman,2,4,0,0,1,1,2,0,0,1,2,0,0
6480bb948f3284f793b2763c,2018,,,2,UT Yadav,V Kohli,2,3,0,0,1,1,2,0,0,1,1,0,0
6480bb9b6ded6d116cfe02ee,2009,,,2,JP Duminy,ST Jayasuriya,2,5,0,0,1,2,3,0,0,0,2,0,0
6480bba38056992b92414bab,2016,,,2,KS Williamson,MC Henriques,2,3,0,0,1,1,2,0,0,1,1,0,0
6480bb9b283b30d0503656f7,2007/08,,,2,DP Vijaykumar,PM Sarvesh Kumar,2,3,0,0,0,1,1,0,0,1,2,0,0
6480bb9f6b144f2a6d105b32,2013,,,1,AS Rajpoot,DP Nannes,2,5,0,0,0,2,5,0,0,0,0,0,0
6480bba0f858e6c12b25d8c3,2014,,,2,R Dhawan,V Sehwag,2,2,0,0,1,0,0,0,0,2,2,0,0
6480bb9a51ee1ef33a5b2dbb,2007/08,,,2,BJ Hodge,DB Das,2,5,0,0,1,1,3,0,0,1,2,0,0
6480bb9e6d7f7f691dde322d,2012,,,2,B Chipli,JP Duminy,2,5,0,0,1,1,3,0,0,1,2,0,0
6480bb9d362f72789dcdc5a7,2009/10,,,1,JA Morkel,S Badrinath,2,5,0,0,1,1,4,0,0,1,1,0,0
6480bb9341152e168005ccc9,2017,,,1,S Aravind,YS Chahal,2,3,0,0,0,1,1,0,0,1,2,0,0
6480bba08cc4182f0127f2e2,2013,,,1,DR Smith,KD Karthik,2,5,0,0,1,0,1,0,0,2,4,0,0
6480bb98825d8ceb716e3f3c,2022,,,2,N Pooran,Washington Sundar,2,2,0,0,1,0,0,0,0,2,2,0,0
6480bb93182304739a535742,2017,,,2,AP Tare,SW Billings,2,7,0,0,1,0,5,0,0,0,2,0,0
6480bb9d6919e7181371271f,2011,,,2,AC Gilchrist,SE Marsh,2,4,0,0,1,1,3,0,0,1,1,0,0
6480bb98c0ad46409044aad2,2022,,,1,RA Jadeja,S Dube,2,4,0,0,1,1,2,0,0,1,2,0,0
6480bb94c5d20726ee59d3d6,2017,,,2,C de Grandhomme,CA Lynn,2,8,0,0,1,1,6,0,0,1,2,0,0
6480bb945901306d3cb2b759,2018,,,2,S Gopal,STR Binny,2,5,0,0,1,1,3,0,0,1,2,0,0
6480bb9746dfc5c467942a84,2021,,,2,Ishan Kishan,SA Yadav,2,4,0,0,1,1,1,0,0,1,3,0,0
6480bb95385ebb9bda58a643,2019,,,2,RR Pant,SS Iyer,2,4,0,0,1,1,1,0,0,1,3,0,0
6480bb99f47261f111a6cc1a,2023,,,2,C Green,Tilak Varma,2,3,0,0,1,0,0,0,0,2,3,0,0
6480bb98adf21699eaa67796,2022,,,2,D Pretorius,MS Dhoni,2,5,0,0,1,1,3,0,0,1,2,0,0
6480bb9c3b082d71291a593c,2009,,,1,JH Kallis,RV Uthappa,2,2,0,0,1,0,1,0,0,1,1,0,0
6480bb93ec7e3351941d3b5b,2017,,,2,S Aravind,SR Watson,2,4,0,0,1,0,1,0,0,2,3,0,0
6480bb9abfe839459b1a28f6,2007/08,,,1,RG Sharma,Y Venugopal Rao,2,4,0,0,1,1,2,0,0,1,2,0,0
6480bb9c50838010977c168c,2009,,,1,MS Dhoni,SK Raina,2,2,0,0,1,2,2,0,0,0,0,0,0
6480bb9be7cbbb90a12dc916,2009,,,1,Joginder Sharma,T Thushara,2,2,0,0,0,0,0,0,0,1,2,0,0
6480bba1568e0f3990191600,2014,,,2,KK Nair,STR Binny,2,3,0,0,1,1,1,0,0,1,2,0,0
6480bb9be2940d96c1f903ca,2007/08,,,1,M Ntini,SK Raina,2,10,0,0,0,0,6,0,0,2,4,0,0
6480bb9da398a7c3c645732c,2011,,,2,Harpreet Singh,MK Pandey,2,4,0,0,1,1,2,0,0,1,2,0,0
6480bb983ad1bab18d1d8774,2022,,,1,SP Narine,SS Iyer,2,5,0,0,1,1,2,0,0,1,3,0,0
6480bb9fe3bc767415c60bfa,2012,,,1,IK Pathan,UT Yadav,2,2,0,0,0,1,1,0,0,1,1,0,0
6480bb97fb920d483d0da2af,2020/21,,,1,KS Williamson,Rashid Khan,2,1,0,0,0,2,1,0,0,0,0,0,0
6480bb97493381c4d7dc7bf4,2021,,,1,M Vohra,SV Samson,2,8,0,0,1,1,2,0,0,1,6,0,0
6480bb9d0f6794fbf429449b,2011,,,2,DPMD Jayawardene,PA Patel,2,6,0,0,1,1,4,0,0,1,2,0,0
6480bb99f2a793884331579e,2023,,,2,C Green,TH David,2,2,0,0,0,1,1,0,0,1,1,0,0
6480bb9a9801c2dda3fe88e9,2007/08,,,1,K Goel,SM Katich,2,6,0,0,1,1,3,0,0,0,3,0,0
6480bb948211fe47e65f2e77,2018,,,1,KS Williamson,Shakib Al Hasan,2,5,0,0,1,0,1,0,0,2,4,0,0
6480bb96c10dfe3d8c259db3,2020/21,,,1,Shahbaz Ahmed,Washington Sundar,2,2,0,0,0,1,1,0,0,0,1,0,0
6480bba3b830360cf7031278,2016,,,1,JC Buttler,KH Pandya,2,2,0,0,1,2,2,0,0,0,0,0,0
6480bba234aac105851964b1,2015,,,2,AB de Villiers,CH Gayle,2,5,0,0,1,1,3,0,0,1,2,0,0
6480bb9bcc2f6123673672d0,2007/08,,,2,AM Nayar,RV Uthappa,2,4,0,0,1,1,3,0,0,1,1,0,0
6480bba2fbc243afec641844,2015,,,1,DA Miller,GJ Maxwell,2,8,0,0,1,2,5,0,0,0,3,0,0
6480bb98aae066234fd8f11e,2022,,,1,MS Wade,Shubman Gill,2,3,0,0,1,1,2,0,0,1,1,0,0
6480bba1670ace74604a420f,2015,,,1,MM Sharma,R Ashwin,2,1,0,0,0,2,1,0,0,0,0,0,0
6480bb9cdf6c63fec90a42df,2009/10,,,2,S Badrinath,SK Raina,2,3,0,0,1,1,1,0,0,1,2,0,0
6480bb9a8053274c083224d9,2023,,,1,JC Archer,PP Chawla,2,2,0,0,0,0,0,0,0,2,2,0,0
6480bb95085c25712f29bd36,2019,,,1,MM Ali,MP Stoinis,2,5,0,0,1,0,2,0,0,2,3,0,0
6480bb954714437843ab3647,2019,,,2,Abhishek Sharma,B Kumar,2,3,0,0,1,1,2,0,0,1,1,0,0
6480bb993e61058e682e2ff4,2023,,,2,JC Buttler,YBK Jaiswal,2,9,0,0,1,0,2,0,0,1,7,0,0
6480bb9480627b50308b7903,2017,,,1,AJ Finch,Ishan Kishan,2,9,0,0,1,0,3,0,0,2,6,0,0
6480bb973da000031d26fbba,2021,,,1,AK Markram,KL Rahul,2,2,0,0,1,1,1,0,0,0,1,0,0
6480bb9a0a8baa96f94e8db9,2023,,,2,A Badoni,DJ Hooda,2,4,0,0,1,1,3,0,0,1,1,0,0
6480bb9d91920239b62f48ad,2009/10,,,1,LRPL Taylor,RV Uthappa,2,3,0,0,1,1,1,0,0,1,2,0,0
6480bba0c9e6d590ed35eb56,2014,,,2,JJ Bumrah,PP Ojha,2,2,0,0,0,1,1,0,0,0,1,0,0
6480bb9d1f9a3cf1fa86e11c,2011,,,2,AB de Villiers,V Kohli,2,10,0,0,1,0,7,0,0,2,3,0,0
6480bb980ea7c3bcea4fdf9c,2022,,,1,JO Holder,MP Stoinis,2,4,0,0,1,1,2,0,0,1,2,0,0
6480bb9b9614f21d90333e15,2007/08,,,2,M Rawat,Pankaj Singh,2,6,0,0,0,1,1,0,0,1,5,0,0
6480bb9f90a251567178de39,2012,,,2,KC Sangakkara,S Dhawan,2,6,0,0,1,1,4,0,0,1,2,0,0
6480bb980095555db76d49cb,2022,,,1,Ishan Kishan,SA Yadav,2,5,0,0,1,1,3,0,0,1,2,0,0
6480bb967d799ced7fe5d8e9,2020/21,,,2,PK Garg,Sandeep Sharma,2,4,0,0,1,2,2,0,0,0,2,0,0
6480bb991a76403912eef285,2023,,,1,PBB Rajapaksa,S Dhawan,2,3,0,0,1,1,1,0,0,1,2,0,0
6480bb9837deb0fb66704166,2022,,,1,DA Warner,R Powell,2,6,0,0,1,0,1,0,0,2,5,0,0
6480bb9c50838010977c168c,2009,,,1,L Balaji,M Muralitharan,2,2,0,0,0,0,1,0,0,1,1,0,0
6480bb9d03ce4b87b32b91f5,2009/10,,,2,SB Jakati,T Thushara,2,2,0,0,1,0,0,0,0,2,2,0,0
6480bba0001885407e860a8d,2013,,,2,BMAJ Mendis,DA Warner,2,3,0,0,1,2,1,0,0,0,2,0,0
6480bba3041017fe2c0593f2,2016,,,1,AJ Finch,BB McCullum,2,7,0,0,1,0,3,0,0,1,4,0,0
6480bb9c21492b9a562c6f46,2009/10,,,2,OA Shah,WP Saha,2,3,0,0,0,1,1,0,0,1,2,0,0
6480bb9aded509be64de3bfb,2007/08,,,2,AB Dinda,I Sharma,2,1,0,0,0,0,0,0,0,2,1,0,0
6480bb94f06c6048c8088194,2018,,,1,B Laughlin,DS Kulkarni,2,4,0,0,0,1,3,0,0,1,1,0,0
6480bb94ca96a1c1f17d1294,2017,,,2,S Aravind,V Kohli,2,6,0,0,1,0,1,0,0,2,5,0,0
6480bb9371e90dbd44ee19a3,2017,,,1,KK Nair,SW Billings,2,4,0,0,1,0,3,0,0,2,1,0,0
6480bb96b7b695186bbb6a3e,2019,,,2,RA Jadeja,SN Thakur,2,2,0,0,1,0,0,0,0,2,2,0,0
6480bba22daffa649f339a05,2016,,,2,MS Dhoni,SPD Smith,2,4,0,0,1,1,1,0,0,1,3,0,0
6480bb9e80233e83b9d1be1f,2012,,,1,DJ Jacobs,RE Levi,2,11,0,0,1,0,10,0,0,0,1,0,0
6480bb984a44a355b856fd1a,2022,,,1,HV Patel,Shahbaz Ahmed,2,3,0,0,1,0,1,0,0,2,2,0,0
6480bba250b404cdcbff22c8,2015,,,2,Harbhajan Singh,J Suchith,2,2,0,0,0,1,1,0,0,1,1,0,0
6480bb9d4e112d675b2925df,2009/10,,,2,KD Karthik,R Bhatia,2,3,0,0,1,0,0,0,0,2,3,0,0
6480bb9c620c92d09ba1b6b9,2009,,,1,DB Ravi Teja,RP Singh,2,1,0,0,0,2,1,0,0,0,0,0,0
6480bb9cb881721acc1bab60,2009,,,2,AB Agarkar,Mashrafe Mortaza,2,2,0,0,0,0,0,0,0,2,2,0,0
6480bb98f01e4672b988c112,2022,,,1,SO Hetmyer,TA Boult,2,1,0,0,0,0,0,0,0,2,1,0,0
6480bba1ebb63d1bd8c60b9d,2014,,,2,JDS Neesham,KP Pietersen,2,7,0,0,1,2,6,0,0,0,1,0,0
6480bb97220be892fbfc2a36,2021,,,2,Harbhajan Singh,KD Karthik,2,2,0,0,0,2,2,0,0,0,0,0,0
6480bba1d3b4ddc36050e3f3,2014,,,1,AR Patel,DA Miller,2,2,0,0,1,0,0,0,0,2,2,0,0
6480bb9eb2690fb1ed356b42,2011,,,1,KA Pollard,SR Tendulkar,2,3,0,0,1,1,1,0,0,1,2,0,0
6480bb9908b154f78b12b8fb,2023,,,2,KD Karthik,V Kohli,2,4,0,0,1,1,2,0,0,1,2,0,0
6480bba2f36e449a59f4a812,2015,,,1,MA Agarwal,SS Iyer,2,5,0,0,1,1,4,0,0,0,1,0,0
6480bb9fcb2b412c0ebd4afa,2013,,,2,M Kartik,R Vinay Kumar,2,2,0,0,1,0,0,0,0,2,2,0,0
6480bb931b06a170006b4713,2017,,,1,SA Yadav,YK Pathan,2,2,0,0,1,1,1,0,0,1,1,0,0
6480bb9c7a11e1cbeea46b0e,2009/10,,,2,AA Jhunjhunwala,GC Smith,2,8,0,0,1,2,5,0,0,0,3,0,0
6480bba1743abcb135a6a4c7,2015,,,2,CH Morris,TG Southee,2,3,0,0,0,2,3,0,0,0,0,0,0
6480bb945f95e767a8a9cc10,2017,,,1,MK Tiwary,RA Tripathi,2,3,0,0,1,0,2,0,0,1,1,0,0
6480bb9baccf501985a56d64,2007/08,,,2,TM Dilshan,VY Mahesh,2,3,0,0,0,1,2,0,0,0,1,0,0
6480bb9575ad32214d0f6ec0,2019,,,2,AM Rahane,JC Archer,2,4,0,0,1,1,1,0,0,1,3,0,0
6480bb9fa1611443840261b7,2012,,,2,HV Patel,P Parameswaran,2,2,0,0,0,1,1,0,0,0,1,0,0
6480bb9e21655ee16a96b2c3,2012,,,1,DL Vettori,M Kaif,2,3,0,0,1,1,2,0,0,1,1,0,0
6480bb97af05ebd5c4f575c4,2021,,,2,KK Ahmed,Mujeeb Ur Rahman,2,3,0,0,1,1,2,0,0,1,1,0,0
6480bb97fb920d483d0da2af,2020/21,,,1,KS Williamson,PK Garg,2,2,0,0,1,2,1,0,0,0,1,0,0
6480bba3041017fe2c0593f2,2016,,,1,DS Kulkarni,SB Jakati,2,3,0,0,1,1,1,0,0,1,2,0,0
6480bb9b50f9e801edc13d5a,2007/08,,,1,R Dravid,V Kohli,2,4,0,0,1,2,3,0,0,0,1,0,0
6480bb9bf2869505c9393b7d,2009,,,2,AB Dinda,M Kartik,2,2,0,0,1,2,2,0,0,0,0,0,0
6480bb9cdf6c63fec90a42df,2009/10,,,1,M Kartik,SE Bond,2,5,0,0,1,2,4,0,0,0,1,0,0
6480bb9a43249ece8e841e56,2023,,,1,F du Plessis,V Kohli,2,5,0,0,1,1,1,0,0,1,4,0,0
6480bb9996eb97dd08b62f78,2023,,,2,JM Sharma,NT Ellis,2,3,0,0,1,1,1,0,0,1,2,0,0
6480bba0f401cc6b6bc6ed10,2013,,,1,STR Binny,SV Samson,2,10,0,0,1,1,5,0,0,1,5,0,0
6480bb98d2cd0fa3ed0ffc21,2022,,,1,MA Agarwal,S Dhawan,2,6,0,0,1,1,5,0,0,1,1,0,0
6480bb977f55a1c473670850,2021,,,1,C Sakariya,DA Miller,2,4,0,0,1,1,1,0,0,1,3,0,0
6480bb932d6ccb8870dcd72d,2017,,,1,AR Patel,GJ Maxwell,2,3,0,0,1,1,3,0,0,0,0,0,0
6480bb9a577cde04d3672225,2023,,,1,HH Pandya,Rashid Khan,2,3,0,0,1,0,1,0,0,0,2,0,0
6480bb94ee669473878c11c2,2017,,,2,CH Gayle,V Kohli,2,4,0,0,1,0,3,0,0,0,1,0,0
6480bba3aa840e4e9450a200,2016,,,1,CR Brathwaite,Q de Kock,2,3,0,0,1,1,2,0,0,1,1,0,0
6480bb9ddcbb8fbbad6614c8,2009/10,,,1,DA Warner,PD Collingwood,2,2,0,0,1,0,1,0,0,2,1,0,0
6480bb981f136a7564719d7f,2022,,,2,DA Miller,HH Pandya,2,2,0,0,1,1,2,0,0,0,0,0,0
6480bb9f87652064dab6c573,2013,,,1,P Kumar,PP Chawla,2,3,0,0,1,1,2,0,0,1,1,0,0
6480bba2965d1d15aa6f723e,2016,,,1,Q de Kock,SV Samson,2,9,0,0,1,1,3,0,0,1,6,0,0
6480bb973d64aa91e60b4088,2021,,,2,DA Miller,R Parag,2,5,0,0,1,0,3,0,0,1,2,0,0
6480bb9f022f0e8cd6e9cdeb,2012,,,1,P Negi,UT Yadav,2,3,0,0,1,1,1,0,0,0,2,0,0
6480bba0f1ebf9ff255e1c91,2013,,,2,PA Reddy,S Dhawan,2,5,0,0,1,2,5,0,0,0,0,0,0
6480bb9fa236b26050f19633,2012,,,1,AL Menaria,R Dravid,2,4,0,0,1,2,4,0,0,0,0,0,0
6480bb948f3284f793b2763c,2018,,,2,AB de Villiers,V Kohli,2,3,0,0,1,1,2,0,0,1,1,0,0
6480bb94aad1a08ca4276b4e,2018,,,1,MM Sharma,Mujeeb Ur Rahman,2,3,0,0,1,1,1,0,0,0,2,0,0
6480bb98b8bb5b0d2c2f0848,2022,,,1,D Brevis,Ishan Kishan,2,3,0,0,1,1,2,0,0,0,1,0,0
6480bba2f3ed8323f852acfa,2016,,,2,GJ Maxwell,SE Marsh,2,4,0,0,1,1,2,0,0,1,2,0,0
6480bb9fe8f5df13fc8d1bc3,2012,,,1,DB Das,R Bhatia,2,3,0,0,0,1,2,0,0,1,1,0,0
6480bb97af05ebd5c4f575c4,2021,,,2,Abhishek Sharma,V Shankar,2,4,0,0,1,2,4,0,0,0,0,0,0
6480bb9b4b74852492343291,2007/08,,,2,AB de Villiers,S Dhawan,2,4,0,0,1,1,3,0,0,1,1,0,0
6480bba0adee98d459585bed,2014,,,1,KD Karthik,KP Pietersen,2,3,0,0,1,2,3,0,0,0,0,0,0
6480bb9f7bae5ad85c4473ba,2012,,,1,DR Smith,RJ Peterson,2,3,0,0,1,1,1,0,0,0,2,0,0
6480bb99fa79383bdc7df827,2022,,,1,K Rabada,RD Chahar,2,2,0,0,1,0,1,0,0,1,1,0,0
6480bb9c8c6c106c6ffbeae4,2009/10,,,1,P Kumar,V Kohli,2,3,0,0,1,0,1,0,0,2,2,0,0
6480bb9be2940d96c1f903ca,2007/08,,,2,A Kumble,B Akhil,2,1,0,0,0,2,1,0,0,0,0,0,0
6480bba065b341458c934986,2013,,,2,DB Das,JH Kallis,2,5,0,0,1,2,4,0,0,0,1,0,0
6480bb94a964c10b5f10ae52,2017,,,2,I Sharma,MM Sharma,2,9,0,0,1,1,5,0,0,1,4,0,0
6480bba18a289cc4b8d173a4,2014,,,1,JJ Bumrah,S Gopal,2,3,0,0,1,0,2,0,0,1,1,0,0
6480bb9763013a01eae041f2,2020/21,,,2,Rashid Khan,Sandeep Sharma,2,7,0,0,0,2,6,0,0,0,1,0,0
6480bb983ad1bab18d1d8774,2022,,,1,TG Southee,UT Yadav,2,4,0,0,1,1,2,0,0,1,2,0,0
6480bba3de527604cd2f96f3,2016,,,2,DA Warner,DJ Hooda,2,4,0,0,1,1,3,0,0,1,1,0,0
6480bba26c6e47258e0c7d24,2015,,,2,AD Mathews,JP Duminy,2,6,0,0,1,1,3,0,0,0,3,0,0
6480bb98dd9a2108c79e1014,2022,,,1,M Shahrukh Khan,RD Chahar,2,3,0,0,1,2,3,0,0,0,0,0,0
6480bb96f8379d02d3435ceb,2020/21,,,2,MS Dhoni,SR Watson,2,6,0,0,1,1,2,0,0,1,4,0,0
6480bb96fb897a6ff486ffe4,2020/21,,,2,RV Uthappa,SV Samson,2,2,0,0,1,2,2,0,0,0,0,0,0
6480bba2fbc243afec641844,2015,,,2,BB McCullum,MEK Hussey,2,6,0,0,1,1,2,0,0,1,4,0,0
6480bb9404b444be6724e41e,2017,,,1,A Mishra,S Nadeem,2,1,0,0,0,2,1,0,0,0,0,0,0
6480bb972a7d4e1071ea662e,2021,,,1,JJ Bumrah,TA Boult,2,2,0,0,0,1,1,0,0,1,1,0,0
6480bba17bce347084729c56,2015,,,1,AJ Finch,AT Rayudu,2,12,0,0,1,0,5,0,0,0,7,0,0
6480bba08cc4182f0127f2e2,2013,,,2,CH Morris,RA Jadeja,2,5,0,0,1,1,4,0,0,0,1,0,0
6480bb9c89e2e8ecb04f94cb,2009/10,,,2,UT Yadav,Y Nagar,2,4,0,0,1,1,2,0,0,1,2,0,0
6480bb99ed38bcb4025b8d86,2023,,,2,DJ Willey,KD Karthik,2,3,0,0,1,1,2,0,0,0,1,0,0
6480bba2b99fcf06aaeac805,2015,,,2,J Theron,STR Binny,2,2,0,0,0,1,1,0,0,1,1,0,0
6480bb9be2940d96c1f903ca,2007/08,,,1,S Badrinath,SK Raina,2,4,0,0,1,1,3,0,0,0,1,0,0
6480bb9b2a5f2fd5053534dc,2007/08,,,1,CRD Fernando,VS Yeligati,2,2,0,0,1,0,0,0,0,2,2,0,0
6480bb9b77a0ff5cb3d0e3e0,2009,,,2,A Mishra,R Bhatia,2,6,0,0,1,1,2,0,0,1,4,0,0
6480bb98dd9a2108c79e1014,2022,,,1,JM Bairstow,MA Agarwal,2,5,0,0,1,0,2,0,0,2,3,0,0
6480bb9d61e9b86b0f0aae49,2009/10,,,1,RG Sharma,RJ Harris,2,4,0,0,1,1,2,0,0,1,2,0,0
6480bba07fa24b891b818984,2013,,,2,Harbhajan Singh,R Dhawan,2,5,0,0,1,1,1,0,0,1,4,0,0
6480bba1d3b4ddc36050e3f3,2014,,,2,G Gambhir,RV Uthappa,2,8,0,0,1,1,3,0,0,1,5,0,0
6480bb9d3ab782f83ce3e381,2011,,,1,B Chipli,S Dhawan,2,3,0,0,1,1,1,0,0,1,2,0,0
6480bb9db38208342bc57b96,2011,,,1,EJG Morgan,MK Tiwary,2,2,0,0,1,2,2,0,0,0,0,0,0
6480bb9a1032ce724214f6dd,2007/08,,,2,Mohammad Asif,VY Mahesh,2,4,0,0,1,0,1,0,0,2,3,0,0
6480bb9c454e9eefca545bde,2009/10,,,1,DPMD Jayawardene,IK Pathan,2,3,0,0,1,1,2,0,0,1,1,0,0
6480bba01893b0faadb9c761,2013,,,2,AB de Villiers,V Kohli,2,3,0,0,1,2,2,0,0,0,1,0,0
6480bb9c1e676472f4841aa9,2009/10,,,2,GJ Bailey,SK Raina,2,2,0,0,1,2,2,0,0,0,0,0,0
6480bba107ba9f7f041862c1,2014,,,2,MK Pandey,RV Uthappa,2,3,0,0,1,1,2,0,0,1,1,0,0
6480bb9d3ab782f83ce3e381,2011,,,1,DT Christian,S Dhawan,2,4,0,0,1,1,3,0,0,1,1,0,0
6480bb99a620a7afdb3217fe,2023,,,2,Kuldeep Yadav,Mukesh Kumar,2,4,0,0,0,1,3,0,0,1,1,0,0
6480bb9ab34d149420eae546,2023,,,1,A Badoni,Q de Kock,2,3,0,0,1,1,1,0,0,1,2,0,0
6480bb9e8dfd9ba30b93cbd8,2012,,,2,F du Plessis,M Vijay,2,5,0,0,1,0,0,0,0,2,5,0,0
6480bb9bd918d2e963f0218a,2009,,,1,A Kumble,P Kumar,2,2,0,0,0,1,1,0,0,1,1,0,0
6480bba1f2392e6761d39d66,2014,,,2,Harbhajan Singh,P Kumar,2,3,0,0,1,1,1,0,0,1,2,0,0
6480bb9b1fc007965b68d4d9,2009,,,2,PR Shah,Z Khan,2,3,0,0,0,1,1,0,0,1,2,0,0
6480bba3d3dc891a3092643e,2016,,,1,MS Dhoni,UT Khawaja,2,3,0,0,1,1,1,0,0,1,2,0,0
6480bb9ea49fe0f895bf242a,2012,,,2,AL Menaria,J Botha,2,3,0,0,1,0,0,0,0,2,3,0,0
6480bb9448fe25ec89c5fcff,2017,,,1,KA Pollard,N Rana,2,6,0,0,1,2,3,0,0,0,3,0,0
6480bb9d80e97e178e5f68de,2011,,,2,LR Shukla,R Bhatia,2,2,0,0,1,2,2,0,0,0,0,0,0
6480bb9f68a0a232d83c338c,2012,,,2,HH Gibbs,SR Tendulkar,2,5,0,0,1,0,4,0,0,0,1,0,0
6480bb9d038ed22e46cbeccb,2011,,,1,A Mishra,DB Ravi Teja,2,5,0,0,1,2,3,0,0,0,2,0,0
6480bb98f98edd45b1ccb406,2022,,,2,Harshit Rana,Shivam Mavi,2,1,0,0,1,2,1,0,0,0,0,0,0
6480bba19701e99975ce7c59,2015,,,1,JP Faulkner,STR Binny,2,4,0,0,1,1,1,0,0,1,3,0,0
6480bb9de80788b3c3ebe4e1,2009/10,,,1,FY Fazal,SR Watson,2,3,0,0,1,1,1,0,0,1,2,0,0
6480bba1568e0f3990191600,2014,,,1,AB de Villiers,VH Zol,2,3,0,0,1,1,1,0,0,1,2,0,0
6480bb947a7076697fc0b339,2017,,,1,MK Tiwary,SPD Smith,2,3,0,0,1,1,2,0,0,1,1,0,0
6480bba16e510ff78ef635a1,2014,,,2,BJ Hodge,SV Samson,2,3,0,0,1,1,1,0,0,1,2,0,0
6480bba34d78f594b07da1bc,2016,,,2,F Behardien,Gurkeerat Singh,2,5,0,0,1,0,1,0,0,2,4,0,0
6480bb94ee669473878c11c2,2017,,,2,S Badree,TS Mills,2,6,0,0,1,0,2,0,0,2,4,0,0
6480bb9c7b7d7712bdc663de,2009/10,,,2,Jaskaran Singh,PP Ojha,2,4,0,0,1,0,2,0,0,2,2,0,0
6480bb94738952e740c68749,2018,,,2,AS Rajpoot,R Ashwin,2,3,0,0,1,2,2,0,0,0,1,0,0
6480bb9a7194d8b20952afae,2007/08,,,2,JH Kallis,W Jaffer,2,4,0,0,1,1,1,0,0,1,3,0,0
6480bb9f895e5780080c8059,2012,,,1,DJ Hussey,SD Chitnis,2,8,0,0,1,1,2,0,0,1,6,0,0
6480bb97493381c4d7dc7bf4,2021,,,1,DA Miller,SV Samson,2,4,0,0,1,0,2,0,0,2,2,0,0
6480bba0001885407e860a8d,2013,,,1,DJG Sammy,PA Patel,2,5,0,0,1,1,1,0,0,1,4,0,0
6480bb9c44492d9e5fc4bb60,2009/10,,,2,JH Kallis,RE van der Merwe,2,3,0,0,1,1,1,0,0,1,2,0,0
6480bb9e56c724ba25b94666,2011,,,1,Bipul Sharma,P Kumar,2,2,0,0,1,0,0,0,0,2,2,0,0
6480bb9be2940d96c1f903ca,2007/08,,,1,L Balaji,SK Raina,2,4,0,0,1,0,4,0,0,0,0,0,0
6480bb945901306d3cb2b759,2018,,,1,DJ Bravo,RA Jadeja,2,1,0,0,0,0,0,0,0,2,1,0,0
6480bb9d66dc7da0d45e453c,2011,,,2,Bipul Sharma,P Kumar,2,2,0,0,0,0,0,0,0,2,2,0,0
6480bb9f0f1f6c03d8e2f039,2013,,,2,BB Samantray,GH Vihari,2,12,0,0,1,0,4,0,0,1,8,0,0
6480bb9fd9db46138a9bb209,2013,,,2,AB de Villiers,DT Christian,2,2,0,0,1,0,0,0,0,2,2,0,0
6480bba136257b71aa9952cf,2014,,,1,DJ Hussey,MS Dhoni,2,4,0,0,1,1,3,0,0,1,1,0,0
6480bb9e156723e64d6bd26b,2012,,,1,Ankit Sharma,CL White,2,3,0,0,1,1,2,0,0,1,1,0,0
6480bba328f7475f4b87d3ff,2016,,,2,M Morkel,SP Narine,2,3,0,0,0,1,1,0,0,1,2,0,0
6480bba0d2cdb40c68c4739c,2013,,,2,KA Pollard,MG Johnson,2,3,0,0,1,1,1,0,0,1,2,0,0
6480bb9a7d91d721555835e5,2007/08,,,2,DB Das,WP Saha,2,3,0,0,1,1,1,0,0,1,2,0,0
6480bb9618b5973b98c0ba18,2019,,,2,AB de Villiers,SO Hetmyer,2,6,0,0,1,0,1,0,0,2,5,0,0
6480bb94c2dcb1007bf6788b,2017,,,1,Mandeep Singh,P Negi,2,3,0,0,1,0,1,0,0,2,2,0,0
6480bb94457bfc7687322f80,2017,,,1,AB de Villiers,Mandeep Singh,2,5,0,0,1,1,2,0,0,0,3,0,0
6480bb96e76ccde6082d7564,2020/21,,,1,N Rana,Shubman Gill,2,5,0,0,1,2,4,0,0,0,1,0,0
6480bb9a2b33e06f46eed54f,2023,,,1,RK Singh,SN Thakur,2,3,0,0,1,1,1,0,0,1,2,0,0
6480bba38060854b4fab1831,2016,,,2,PA Patel,RG Sharma,2,7,0,0,1,1,2,0,0,1,5,0,0
6480bb9ec07aa72ec89917f0,2012,,,2,JA Morkel,SB Jakati,2,3,0,0,0,0,1,0,0,1,2,0,0
6480bba1c0aa361f3c6e454c,2015,,,1,J Suchith,R Vinay Kumar,2,1,0,0,0,0,0,0,0,0,1,0,0
6480bb9e5ab10d1241d6509d,2012,,,2,AD Mathews,MN Samuels,2,4,0,0,1,0,2,0,0,1,2,0,0
6480bba26c6e47258e0c7d24,2015,,,2,JP Duminy,KM Jadhav,2,3,0,0,1,2,2,0,0,0,1,0,0
6480bb96ec7d98e34055e8fc,2020/21,,,2,F du Plessis,M Vijay,2,5,0,0,1,2,3,0,0,0,2,0,0
6480bb93ec7e3351941d3b5b,2017,,,2,SR Watson,Sachin Baby,2,5,0,0,1,1,2,0,0,1,3,0,0
6480bb98d8f59b81335f4a3d,2021,,,1,HV Patel,PWH de Silva,2,4,0,0,1,1,3,0,0,1,1,0,0
6480bb9f59fd8000010baf09,2013,,,1,J Syed Mohammad,V Kohli,2,3,0,0,1,1,2,0,0,1,1,0,0
6480bb99695e001cdaca81e0,2022,,,1,MM Ali,RD Gaikwad,1,2,0,0,1,0,2,0,0,0,0,0,0
6480bb9c2778066dafd78a71,2009/10,,,1,JM Kemp,S Badrinath,1,8,0,0,1,1,1,0,0,0,7,0,0
6480bb9d79d603cc45fc9b3c,2011,,,1,A Symonds,TL Suman,1,1,0,0,0,1,1,0,0,0,0,0,0
6480bba1de7febd9f1f0138e,2014,,,2,DH Yagnik,KK Cooper,1,2,0,0,0,1,2,0,0,0,0,0,0
6480bb958e752648ab95362b,2019,,,1,N Rana,RV Uthappa,1,4,0,0,1,0,3,0,0,0,1,0,0
6480bb9ce93a7b4315d8fa30,2009,,,2,KD Karthik,R Bhatia,1,2,0,0,1,1,1,0,0,0,1,0,0
6480bba18a289cc4b8d173a4,2014,,,1,AT Rayudu,KA Pollard,1,2,0,0,1,1,1,0,0,0,1,0,0
6480bb9a61edc0c77bc4bc86,2007/08,,,1,KD Karthik,Shoaib Malik,1,2,0,0,1,0,0,0,0,1,2,0,0
6480bb95945c5e5dc4d8c7d6,2019,,,1,HH Pandya,KH Pandya,1,3,0,0,1,1,2,0,0,0,1,0,0
6480bb9a43249ece8e841e56,2023,,,2,RG Sharma,SA Yadav,1,2,0,0,1,0,1,0,0,1,1,0,0
6480bb99349f00f851e8d2fd,2023,,,1,Atharva Taide,Harpreet Singh,1,3,0,0,1,0,1,0,0,1,2,0,0
6480bb9651b51fdcda05e4c8,2020/21,,,1,RA Tripathi,SP Narine,1,3,0,0,1,1,1,0,0,0,2,0,0
6480bb961ee814aee7b674ac,2020/21,,,2,MA Agarwal,N Pooran,1,4,0,0,1,1,1,0,0,0,3,0,0
6480bb9384cbae8edee3707f,2017,,,2,AP Tare,SV Samson,1,4,0,0,1,0,1,0,0,1,3,0,0
6480bba0adee98d459585bed,2014,,,2,KA Pollard,Z Khan,1,1,0,0,0,1,1,0,0,0,0,0,0
6480bb96c40b697b63d08717,2019,,,1,DJ Hooda,Rashid Khan,1,0,0,0,1,0,0,0,0,0,0,0,0
6480bb9b1fc007965b68d4d9,2009,,,1,HH Gibbs,VVS Laxman,1,2,0,0,1,1,1,0,0,0,1,0,0
6480bb9a7577454a5220c94b,2007/08,,,2,M Rawat,SK Trivedi,1,4,0,0,1,0,3,0,0,1,1,0,0
6480bba04b49d2ff5f997e02,2013,,,2,S Kaul,UT Yadav,1,1,0,0,0,0,0,0,0,1,1,0,0
6480bba34d78f594b07da1bc,2016,,,2,DA Miller,Gurkeerat Singh,1,3,0,0,1,1,2,0,0,0,1,0,0
6480bb9f3700dfaa08e18c43,2012,,,2,R Ashwin,S Anirudha,1,1,0,0,0,0,1,0,0,0,0,0,0
6480bb9ade063258af41163b,2007/08,,,2,SB Bangar,WPUJC Vaas,1,2,0,0,1,1,1,0,0,0,1,0,0
6480bb9938b659481e3ab6dc,2022,,,1,R Ashwin,R Parag,1,0,0,0,1,0,0,0,0,0,0,0,0
6480bba0404171e13faa181e,2013,,,1,DB Das,R Bhatia,1,2,0,0,1,0,1,0,0,1,1,0,0
6480bb960d5042aa46b7776b,2020/21,,,1,KA Pollard,NM Coulter-Nile,1,5,0,0,1,0,2,0,0,1,3,0,0
6480bb9b7b8617115de9683b,2007/08,,,1,PP Ojha,RP Singh,1,2,0,0,1,1,1,0,0,0,1,0,0
6480bba09d6b23c8722fd208,2013,,,2,AT Rayudu,SL Malinga,1,3,0,0,1,1,1,0,0,0,2,0,0
6480bba2f39653e2f61baca2,2015,,,1,LMP Simmons,PA Patel,1,1,0,0,1,0,1,0,0,0,0,0,0
6480bb9b77a0ff5cb3d0e3e0,2009,,,2,PJ Sangwan,R Bhatia,1,4,0,0,1,0,3,0,0,1,1,0,0
6480bb979e91d1ff9b54c737,2020/21,,,2,Ishan Kishan,KH Pandya,1,1,0,0,0,0,0,0,0,1,1,0,0
6480bb9a7577454a5220c94b,2007/08,,,2,SA Asnodkar,Sohail Tanvir,1,6,0,0,1,1,4,0,0,0,2,0,0
6480bb9c89f35f11aae1f2d0,2009/10,,,1,G Gambhir,V Sehwag,1,2,0,0,1,1,1,0,0,0,1,0,0
6480bb9f0f959bc6104820c3,2013,,,1,AD Russell,IK Pathan,1,2,0,0,1,0,1,0,0,1,1,0,0
6480bb97b945155c90dccd3d,2021,,,2,DL Chahar,SN Thakur,1,1,0,0,0,1,1,0,0,0,0,0,0
6480bb9d61e9b86b0f0aae49,2009/10,,,1,AC Gilchrist,HH Gibbs,1,4,0,0,1,0,1,0,0,1,3,0,0
6480bba2e3610f863b52b887,2016,,,1,EJG Morgan,S Dhawan,1,3,0,0,1,0,2,0,0,1,1,0,0
6480bb964592640608a9163c,2020/21,,,2,JC Buttler,SV Samson,1,3,0,0,1,1,3,0,0,0,0,0,0
6480bb96686655f09172741d,2020/21,,,2,I Udana,Navdeep Saini,1,2,0,0,1,0,1,0,0,1,1,0,0
6480bb9a4de9fe3e7319ce39,2007/08,,,2,GC Smith,M Rawat,1,4,0,0,1,1,2,0,0,0,2,0,0
6480bb9b77a0ff5cb3d0e3e0,2009,,,1,M Muralitharan,S Tyagi,1,2,0,0,1,1,2,0,0,0,0,0,0
6480bb9cf1471ad233c7b0af,2009,,,2,NV Ojha,RJ Quiney,1,3,0,0,1,0,0,0,0,1,3,0,0
6480bb9dc8b09381d0f01a9d,2011,,,1,JA Morkel,S Badrinath,1,2,0,0,1,0,2,0,0,0,0,0,0
6480bba0c3cc8c51bc6c1c3a,2013,,,1,OA Shah,STR Binny,1,1,0,0,1,1,1,0,0,0,0,0,0
6480bb96c95abb10156a6055,2020/21,,,2,F du Plessis,M Vijay,1,6,0,0,1,0,0,0,0,0,6,0,0
6480bb931b06a170006b4713,2017,,,1,Shakib Al Hasan,YK Pathan,1,1,0,0,0,1,1,0,0,0,0,0,0
6480bba1ece63aa1c77a954e,2015,,,2,DR Smith,F du Plessis,1,5,0,0,1,0,2,0,0,1,3,0,0
6480bb994877788ec5b187ff,2023,,,2,SS Prabhudessai,Shahbaz Ahmed,1,2,0,0,1,0,1,0,0,0,1,0,0
6480bb95f37ebb69ffb216e0,2019,,,2,CA Ingram,HV Patel,1,1,0,0,1,1,1,0,0,0,0,0,0
6480bb94605dacb25c83dc35,2018,,,2,LE Plunkett,SS Iyer,1,2,0,0,1,0,1,0,0,1,1,0,0
6480bb94ee669473878c11c2,2017,,,1,MK Pandey,RV Uthappa,1,4,0,0,1,1,1,0,0,0,3,0,0
6480bb9fa1611443840261b7,2012,,,1,CL White,KC Sangakkara,1,5,0,0,1,1,5,0,0,0,0,0,0
6480bb9dc8b09381d0f01a9d,2011,,,2,NL McCullum,R Sharma,1,2,0,0,1,0,1,0,0,1,1,0,0
6480bb99d43295fa2d82c9dc,2023,,,2,DA Warner,PP Shaw,1,4,0,0,1,1,2,0,0,0,2,0,0
6480bb9f4bdcea2f81049fe9,2012,,,1,P Negi,UT Yadav,1,4,0,0,1,0,0,0,0,1,4,0,0
6480bb94f46306dbde97aa5c,2017,,,2,G Gambhir,RV Uthappa,1,4,0,0,1,0,1,0,0,1,3,0,0
6480bb99fa79383bdc7df827,2022,,,2,F du Plessis,RM Patidar,1,6,0,0,1,0,2,0,0,0,4,0,0
6480bb9d03ce4b87b32b91f5,2009/10,,,2,R Ashwin,SK Raina,1,2,0,0,1,1,1,0,0,0,1,0,0
6480bb93d5dc00a79edede9c,2017,,,2,NV Ojha,V Shankar,1,3,0,0,1,0,1,0,0,1,2,0,0
6480bb94f06c6048c8088194,2018,,,1,DS Kulkarni,JD Unadkat,1,2,0,0,1,0,0,0,0,1,2,0,0
6480bba2e680f2464af841ae,2015,,,1,JP Duminy,KM Jadhav,1,2,0,0,1,0,1,0,0,1,1,0,0
6480bb9a1e358307d26cd50d,2023,,,2,K Kartikeya,PP Chawla,1,2,0,0,1,0,1,0,0,0,1,0,0
6480bb9c442caaabe9eb2275,2009,,,2,DS Kulkarni,SL Malinga,1,2,0,0,1,1,2,0,0,0,0,0,0
6480bb9e3db1392e753dd785,2012,,,1,MK Pandey,SC Ganguly,1,6,0,0,1,0,2,0,0,1,4,0,0
6480bb9a3ffea6235f54cc1e,2023,,,2,B Kumar,M Markande,1,3,0,0,0,0,1,0,0,1,2,0,0
6480bb9a1a3ab2ab8297871d,2007/08,,,2,GC Smith,RA Jadeja,1,1,0,0,1,0,1,0,0,0,0,0,0
6480bb9c757dbd7f92b1130a,2009/10,,,1,KAJ Roach,RP Singh,1,2,0,0,1,0,1,0,0,1,1,0,0
6480bba223f162806c0794ac,2015,,,2,LMP Simmons,RG Sharma,1,3,0,0,1,0,2,0,0,1,1,0,0
6480bba048fb3d33ea0711e7,2013,,,2,DJG Sammy,PA Patel,1,4,0,0,1,0,3,0,0,1,1,0,0
6480bba3caa5150f2db7a1dc,2016,,,2,BB McCullum,KD Karthik,1,4,0,0,1,1,1,0,0,0,3,0,0
6480bb9825eb960aded1ff64,2022,,,2,V Shankar,WP Saha,1,3,0,0,1,0,2,0,0,1,1,0,0
6480bb9f2305d07e3c65be11,2013,,,2,DJ Hussey,PC Valthaty,1,2,0,0,1,1,1,0,0,0,1,0,0
6480bba000b91f6c5cf57fdb,2013,,,2,AM Rahane,SR Watson,1,7,0,0,1,0,4,0,0,1,3,0,0
6480bba2db1e2def1b597ed3,2015,,,2,M Vohra,V Sehwag,1,2,0,0,1,0,0,0,0,1,2,0,0
6480bb9754755bb7a7427d52,2021,,,1,KD Karthik,PJ Cummins,1,2,0,0,1,0,1,0,0,1,1,0,0
6480bba1ff55936e203ca5a6,2014,,,1,AR Patel,GJ Bailey,1,1,0,0,1,1,1,0,0,0,0,0,0
6480bb9c6f1c8ea3dc73226f,2009/10,,,1,PJ Sangwan,S Ladda,1,3,0,0,1,1,2,0,0,0,1,0,0
6480bb97372fc5d5ef4c436a,2021,,,1,MP Stoinis,RR Pant,1,6,0,0,1,0,5,0,0,1,1,0,0
6480bb9b72f6a46338302131,2009,,,2,RR Raje,SS Tiwary,1,2,0,0,1,1,1,0,0,0,1,0,0
6480bb96f8379d02d3435ceb,2020/21,,,1,CV Varun,PJ Cummins,1,1,0,0,1,1,1,0,0,0,0,0,0
6480bb9558345af5a1bb044d,2019,,,2,Q de Kock,SA Yadav,1,3,0,0,1,0,2,0,0,1,1,0,0
6480bb996c5ae75a32d978e8,2022,,,1,N Jagadeesan,S Dube,1,3,0,0,1,1,1,0,0,0,2,0,0
6480bb9a3ffea6235f54cc1e,2023,,,2,AK Markram,HC Brook,1,5,0,0,1,1,1,0,0,0,4,0,0
6480bb9498a98d52f9285b52,2017,,,2,JD Unadkat,Washington Sundar,1,2,0,0,0,0,0,0,0,0,2,0,0
6480bba0b5eabeb0a150b93f,2013,,,1,CH Gayle,R Rampaul,1,2,0,0,1,1,1,0,0,0,1,0,0
6480bba34d78f594b07da1bc,2016,,,2,Gurkeerat Singh,KJ Abbott,1,3,0,0,1,1,2,0,0,0,1,0,0
6480bb94d8aa9021808a4760,2017,,,1,CJ Jordan,NV Ojha,1,2,0,0,1,0,1,0,0,1,1,0,0
6480bb95ff5da0069bc5274e,2018,,,1,AD Russell,RV Uthappa,1,2,0,0,1,1,1,0,0,0,1,0,0
6480bb94b991069934e5c7d2,2018,,,2,CA Lynn,SP Narine,1,3,0,0,1,0,2,0,0,1,1,0,0
6480bb9c17dcdfd5b06984f0,2009/10,,,2,CH Gayle,Mandeep Singh,1,5,0,0,1,1,1,0,0,0,4,0,0
6480bb9b0b09749af4aa32dd,2009,,,1,KC Sangakkara,RS Bopara,1,2,0,0,1,1,1,0,0,0,1,0,0
6480bb9c7a11e1cbeea46b0e,2009/10,,,1,AP Tare,SS Tiwary,1,2,0,0,1,0,1,0,0,1,1,0,0
6480bb9db6a011b38afed5dc,2011,,,2,RP Singh,RV Gomez,1,1,0,0,0,0,1,0,0,0,0,0,0
6480bb9774dd8e44bbeeb5a4,2021,,,1,DJ Hooda,MA Agarwal,1,2,0,0,1,1,1,0,0,0,1,0,0
6480bb9d3c4dfa9f054aa47f,2011,,,2,A Singh,SK Warne,1,4,0,0,1,0,2,0,0,1,2,0,0
6480bb9d86effd7e5e6a5261,2011,,,2,MA Agarwal,TM Dilshan,1,2,0,0,1,1,1,0,0,0,1,0,0
6480bb94ee669473878c11c2,2017,,,2,S Aravind,YS Chahal,1,3,0,0,1,1,1,0,0,0,2,0,0
6480bb9fcbbfd8053f253537,2012,,,1,S Nadeem,VR Aaron,1,2,0,0,1,0,1,0,0,1,1,0,0
6480bb9e8dfd9ba30b93cbd8,2012,,,1,DB Ravi Teja,MS Gony,1,2,0,0,1,0,0,0,0,1,2,0,0
6480bb9e9162dceff15dc334,2011,,,1,DPMD Jayawardene,R Vinay Kumar,1,1,0,0,1,0,0,0,0,1,1,0,0
6480bb9d182be5b0fbe5a4e2,2011,,,2,Harbhajan Singh,SL Malinga,1,4,0,0,1,0,0,0,0,1,4,0,0
6480bb99350726d00af209bf,2022,,,2,Abhishek Sharma,RA Tripathi,1,4,0,0,1,0,2,0,0,1,2,0,0
6480bb9f00ef088221497043,2013,,,1,LR Shukla,R Bhatia,1,8,0,0,1,1,2,0,0,0,6,0,0
6480bb932d6ccb8870dcd72d,2017,,,2,MK Tiwary,R Bhatia,1,1,0,0,0,1,1,0,0,0,0,0,0
6480bb98323919fff9902666,2022,,,1,JM Bairstow,JM Sharma,1,2,0,0,1,0,1,0,0,1,1,0,0
6480bb99bbae76f3f761d060,2023,,,2,N Jagadeesan,SP Narine,1,4,0,0,1,1,1,0,0,0,3,0,0
6480bb94009d0662ee94f07b,2018,,,2,DJ Hooda,S Kaul,1,5,0,0,1,1,1,0,0,0,4,0,0
6480bba29fb420d92aef1d2a,2015,,,2,NV Ojha,S Dhawan,1,3,0,0,1,0,3,0,0,0,0,0,0
6480bb9f36da1a646c80be45,2013,,,1,KD Karthik,SR Tendulkar,1,3,0,0,1,0,2,0,0,1,1,0,0
6480bb94738952e740c68749,2018,,,1,KS Williamson,S Dhawan,1,4,0,0,1,0,3,0,0,1,1,0,0
6480bb9c13817091131f76e3,2009/10,,,2,KC Sangakkara,RS Bopara,1,4,0,0,1,0,3,0,0,1,1,0,0
6480bb9eae43aed76989151b,2011,,,1,AB de Villiers,KB Arun Karthik,1,3,0,0,1,0,1,0,0,1,2,0,0
6480bb932f8447acd7840076,2017,,,2,DS Kulkarni,KD Karthik,1,4,0,0,1,1,1,0,0,0,3,0,0
6480bb93ff8d1f4cd07859ce,2017,,,2,CH Morris,SS Iyer,1,1,0,0,0,0,0,0,0,1,1,0,0
6480bb9d80e97e178e5f68de,2011,,,2,G Gambhir,MK Tiwary,1,2,0,0,1,1,2,0,0,0,0,0,0
6480bb9c442caaabe9eb2275,2009,,,2,JP Duminy,L Ronchi,1,2,0,0,1,0,0,0,0,0,2,0,0
6480bb9ed74d222a3da56dfa,2012,,,2,G Gambhir,YK Pathan,1,4,0,0,1,0,1,0,0,1,3,0,0
6480bba11c977a5d11c1aa38,2015,,,1,DA Warner,RS Bopara,1,2,0,0,1,0,1,0,0,1,1,0,0
6480bb9d79d603cc45fc9b3c,2011,,,2,AC Gilchrist,PC Valthaty,1,5,0,0,1,0,2,0,0,1,3,0,0
6480bb9b2e179d359c1d446d,2009,,,1,PP Ojha,RP Singh,1,1,0,0,1,1,1,0,0,0,0,0,0
6480bb972a7d4e1071ea662e,2021,,,1,HH Pandya,Ishan Kishan,1,2,0,0,1,0,1,0,0,1,1,0,0
6480bb9814efd9a91e8c911f,2021,,,2,CH Morris,R Tewatia,1,6,0,0,1,0,2,0,0,1,4,0,0
6480bb9c757dbd7f92b1130a,2009/10,,,2,KA Pollard,SR Tendulkar,1,6,0,0,1,1,5,0,0,0,1,0,0
6480bb965f597c872396f67c,2020/21,,,1,PJ Cummins,Shubman Gill,1,8,0,0,1,1,8,0,0,0,0,0,0
6480bb945460b25d997060fb,2018,,,2,Mohammed Shami,V Shankar,1,2,0,0,1,1,1,0,0,0,1,0,0
6480bb9c757dbd7f92b1130a,2009/10,,,1,A Symonds,RG Sharma,1,4,0,0,1,0,4,0,0,0,0,0,0
6480bb9e30b7f3c09cfbdabb,2011,,,2,AA Chavan,AL Menaria,1,4,0,0,1,1,3,0,0,0,1,0,0
6480bb95014388d3e8c62904,2019,,,1,P Negi,TG Southee,1,3,0,0,1,0,1,0,0,1,2,0,0
6480bb98960cf9374ee9420d,2022,,,1,KH Pandya,KL Rahul,1,2,0,0,1,1,2,0,0,0,0,0,0
6480bb99b4febfb641fddd39,2023,,,2,KD Karthik,V Kohli,1,4,0,0,1,0,3,0,0,1,1,0,0
6480bba3041017fe2c0593f2,2016,,,2,AB de Villiers,Sachin Baby,1,4,0,0,1,1,1,0,0,0,3,0,0
6480bb98f98edd45b1ccb406,2022,,,1,A Badoni,PVD Chameera,1,2,0,0,1,0,1,0,0,0,1,0,0
6480bba27b4786f36f706f8e,2016,,,1,AT Rayudu,JC Buttler,1,5,0,0,1,1,4,0,0,0,1,0,0
6480bba1f2392e6761d39d66,2014,,,2,AP Tare,AT Rayudu,1,2,0,0,1,0,1,0,0,1,1,0,0
6480bb97af05ebd5c4f575c4,2021,,,2,Rashid Khan,V Shankar,1,2,0,0,1,0,1,0,0,1,1,0,0
6480bb9e300070746cc2eb67,2011,,,2,DL Vettori,SS Tiwary,1,2,0,0,1,0,1,0,0,1,1,0,0
6480bb99a620a7afdb3217fe,2023,,,2,DA Warner,Kuldeep Yadav,1,4,0,0,1,0,1,0,0,1,3,0,0
6480bb9f218f37b46bef4afb,2013,,,1,Azhar Mahmood,Mandeep Singh,1,4,0,0,1,0,4,0,0,0,0,0,0
6480bb9c8c6c106c6ffbeae4,2009/10,,,1,A Kumble,V Kohli,1,1,0,0,0,1,1,0,0,0,0,0,0
6480bb9b8860198955e581d8,2007/08,,,2,DPMD Jayawardene,Yuvraj Singh,1,2,0,0,1,0,0,0,0,1,2,0,0
6480bba192383a244f185c5a,2014,,,1,JP Duminy,M Vijay,1,2,0,0,1,1,1,0,0,0,1,0,0
6480bba223f162806c0794ac,2015,,,1,DR Smith,F du Plessis,1,3,0,0,1,1,3,0,0,0,0,0,0
6480bb9a7d91d721555835e5,2007/08,,,2,I Sharma,Umar Gul,1,1,0,0,1,0,0,0,0,1,1,0,0
6480bb9c89f35f11aae1f2d0,2009/10,,,2,FY Fazal,NV Ojha,1,3,0,0,1,0,2,0,0,1,1,0,0
6480bb9ef7c6084992b7cdf8,2012,,,2,Ankit Sharma,B Chipli,1,1,0,0,0,1,1,0,0,0,0,0,0
6480bb99315aee6cd9d56504,2023,,,2,KL Rahul,KR Mayers,1,3,0,0,1,0,0,0,0,0,3,0,0
6480bb9a6e44b0c8da00ca72,2007/08,,,1,B Lee,S Sreesanth,1,2,0,0,1,1,1,0,0,0,1,0,0
6480bb9db6a011b38afed5dc,2011,,,2,RA Jadeja,RV Gomez,1,5,0,0,1,1,2,0,0,0,3,0,0
6480bb9827e9fb920cf62809,2021,,,1,JJ Roy,WP Saha,1,2,0,0,1,1,1,0,0,0,1,0,0
6480bb96f8379d02d3435ceb,2020/21,,,1,KL Nagarkoti,PJ Cummins,1,2,0,0,1,0,2,0,0,0,0,0,0
6480bb9a9801c2dda3fe88e9,2007/08,,,2,G Gambhir,S Dhawan,1,5,0,0,1,1,2,0,0,0,3,0,0
6480bb9371e90dbd44ee19a3,2017,,,2,DA Miller,GJ Maxwell,1,3,0,0,1,1,1,0,0,0,2,0,0
6480bb9b2e179d359c1d446d,2009,,,1,AA Bilakhia,TL Suman,1,2,0,0,1,0,1,0,0,1,1,0,0
6480bb9bfcaabf33b5687e32,2007/08,,,2,DR Smith,YV Takawale,1,2,0,0,1,0,1,0,0,0,1,0,0
6480bba0001885407e860a8d,2013,,,2,A Nehra,IK Pathan,1,2,0,0,1,0,0,0,0,1,2,0,0
6480bb9552e25b3867e5c38a,2019,,,2,AT Rayudu,SR Watson,1,4,0,0,1,0,1,0,0,1,3,0,0
6480bb97af44a48533f08540,2020/21,,,1,DJ Hooda,GJ Maxwell,1,2,0,0,0,1,1,0,0,0,1,0,0
6480bb96acacf3be646d300a,2020/21,,,2,AM Rahane,S Dhawan,1,3,0,0,1,1,2,0,0,0,1,0,0
6480bb98634dba60191637ad,2021,,,1,CH Gayle,MA Agarwal,1,4,0,0,1,1,2,0,0,0,2,0,0
6480bb980ea7c3bcea4fdf9c,2022,,,1,KH Pandya,MP Stoinis,1,4,0,0,1,1,2,0,0,0,2,0,0
6480bb9fd4a1af6234c9e57c,2012,,,1,AB de Villiers,AUK Pathan,1,2,0,0,1,0,1,0,0,1,1,0,0
6480bb937dc0a09df8f7aeee,2017,,,2,DA Miller,GJ Maxwell,1,3,0,0,1,0,1,0,0,1,2,0,0
6480bb99a620a7afdb3217fe,2023,,,2,A Nortje,Kuldeep Yadav,1,2,0,0,1,0,1,0,0,1,1,0,0
6480bb94bf9a1728b1b12f4d,2018,,,2,AM Rahane,BA Stokes,1,4,0,0,1,1,1,0,0,0,3,0,0
6480bba0d3cbb27b257a9c1f,2013,,,1,DA Miller,MS Gony,1,2,0,0,1,0,1,0,0,1,1,0,0
6480bb99f33a7dd80eb0a544,2023,,,2,M Shahrukh Khan,RD Chahar,1,1,0,0,1,0,0,0,0,0,1,0,0
6480bb9a1e358307d26cd50d,2023,,,2,TH David,Vishnu Vinod,1,2,0,0,1,1,1,0,0,0,1,0,0
6480bb9a4de9fe3e7319ce39,2007/08,,,1,MV Boucher,P Kumar,1,12,0,0,1,1,6,0,0,0,6,0,0
6480bb9a81d7fd0ac0307b4d,2023,,,1,C Green,Tilak Varma,1,2,0,0,1,0,1,0,0,1,1,0,0
6480bb9dd89d4266d59a4592,2011,,,1,AB de Villiers,V Kohli,1,2,0,0,1,1,1,0,0,0,1,0,0
6480bb965aa0867bce4e79b3,2019,,,1,KM Jadhav,MS Dhoni,1,2,0,0,1,0,1,0,0,1,1,0,0
6480bb94cfe5aeb50e36aef3,2017,,,1,P Kumar,RA Jadeja,1,2,0,0,1,1,2,0,0,0,0,0,0
6480bb99af95c6c90c4c3924,2023,,,2,Abhishek Sharma,MA Agarwal,1,3,0,0,1,1,2,0,0,0,1,0,0
6480bba0a4e7c61a5656729e,2014,,,2,PA Patel,YV Takawale,1,8,0,0,1,1,1,0,0,0,7,0,0
6480bb987c720def5fbaf218,2022,,,2,JJ Bumrah,M Ashwin,1,1,0,0,1,0,1,0,0,0,0,0,0
6480bba2557febf92f9f79ab,2015,,,2,PJ Cummins,RN ten Doeschate,1,2,0,0,1,0,2,0,0,0,0,0,0
6480bb97ea8bfb43e3f7515f,2020/21,,,2,RA Jadeja,SM Curran,1,3,0,0,1,0,1,0,0,1,2,0,0
6480bba29fb420d92aef1d2a,2015,,,2,Bipul Sharma,MC Henriques,1,2,0,0,1,1,2,0,0,0,0,0,0
6480bb9765a785922ad360fe,2021,,,1,KM Jadhav,MK Pandey,1,2,0,0,1,0,0,0,0,1,2,0,0
6480bb9d3c4dfa9f054aa47f,2011,,,2,AL Menaria,SK Warne,1,5,0,0,1,0,2,0,0,1,3,0,0
6480bb9c50838010977c168c,2009,,,2,IK Pathan,WA Mota,1,2,0,0,1,1,1,0,0,0,1,0,0
6480bb96edb3270eba0af1d4,2020/21,,,1,AB de Villiers,V Kohli,1,3,0,0,1,0,2,0,0,1,1,0,0
6480bb9c37b72d7a51019794,2009/10,,,1,Harmeet Singh,RG Sharma,1,1,0,0,1,0,0,0,0,1,1,0,0
6480bb9e5de755887230bb00,2012,,,2,JA Morkel,RA Jadeja,1,2,0,0,1,1,1,0,0,0,1,0,0
6480bb9f68a0a232d83c338c,2012,,,1,MA Agarwal,R Vinay Kumar,1,2,0,0,1,0,0,0,0,1,2,0,0
6480bb94f46306dbde97aa5c,2017,,,2,SA Yadav,UT Yadav,1,2,0,0,1,1,2,0,0,0,0,0,0
6480bb988b447f26d7a96c0c,2022,,,1,KH Pandya,KL Rahul,1,2,0,0,0,1,1,0,0,0,1,0,0
6480bb982f070b023b901b3e,2021,,,2,PP Shaw,SPD Smith,1,4,0,0,1,0,2,0,0,1,2,0,0
6480bb9623a26d3fbfe59f25,2020/21,,,2,AJ Finch,V Kohli,1,7,0,0,1,0,2,0,0,1,5,0,0
6480bb9908b154f78b12b8fb,2023,,,1,AD Russell,VR Iyer,1,2,0,0,1,1,1,0,0,0,1,0,0
6480bb97af05ebd5c4f575c4,2021,,,2,B Kumar,Mujeeb Ur Rahman,1,2,0,0,1,1,2,0,0,0,0,0,0
6480bb9d1ed71a4f47892d00,2009/10,,,1,CH Gayle,SC Ganguly,1,2,0,0,1,0,2,0,0,0,0,0,0
6480bb968211e65fcbffa192,2019,,,1,Navdeep Saini,UT Yadav,1,1,0,0,0,0,1,0,0,0,0,0,0
6480bba2b7be71a15b2bb3de,2015,,,2,F du Plessis,P Negi,1,3,0,0,1,1,3,0,0,0,0,0,0
6480bb94704f6dfeb7f4d270,2017,,,2,CA Lynn,RV Uthappa,1,2,0,0,1,1,1,0,0,0,1,0,0
6480bb9940bd3bf36dd4897f,2023,,,2,DJ Hooda,PN Mankad,1,1,0,0,1,1,1,0,0,0,0,0,0
6480bb937dc0a09df8f7aeee,2017,,,2,Sandeep Sharma,VR Aaron,1,1,0,0,1,0,0,0,0,0,1,0,0
6480bba1c0aa361f3c6e454c,2015,,,1,LMP Simmons,PA Patel,1,4,0,0,1,1,3,0,0,0,1,0,0
6480bba26ca6ec72ba377236,2016,,,1,MC Henriques,NV Ojha,1,3,0,0,1,0,0,0,0,1,3,0,0
6480bb99433f6e11060ba714,2022,,,2,LS Livingstone,S Dhawan,1,2,0,0,1,1,1,0,0,0,1,0,0
6480bb9e56c724ba25b94666,2011,,,1,DJ Hussey,KD Karthik,1,4,0,0,1,0,3,0,0,1,1,0,0
6480bb950c59218964b27cc0,2018,,,1,JC Archer,MK Lomror,1,2,0,0,1,0,1,0,0,1,1,0,0
6480bb9d91920239b62f48ad,2009/10,,,1,JH Kallis,KP Pietersen,1,5,0,0,1,0,4,0,0,1,1,0,0
6480bb937dc0a09df8f7aeee,2017,,,2,AR Patel,MM Sharma,1,2,0,0,1,0,1,0,0,1,1,0,0
6480bb9a9dc58f49d783faa9,2023,,,2,JE Root,SV Samson,1,2,0,0,1,1,1,0,0,0,1,0,0
6480bb9f0f1f6c03d8e2f039,2013,,,1,B Kumar,MK Pandey,1,2,0,0,1,0,1,0,0,1,1,0,0
6480bb9f9eae77e599a46300,2012,,,1,JEC Franklin,SR Tendulkar,1,8,0,0,1,1,6,0,0,0,2,0,0
6480bb99d43295fa2d82c9dc,2023,,,2,DA Warner,YV Dhull,1,4,0,0,1,0,0,0,0,1,4,0,0
6480bba0a3e806f41a4dab41,2013,,,2,MC Henriques,SS Tiwary,1,3,0,0,1,0,0,0,0,1,3,0,0
6480bba107ba9f7f041862c1,2014,,,2,R Vinay Kumar,SP Narine,1,1,0,0,0,0,0,0,0,1,1,0,0
6480bb995193664eda3e9e10,2022,,,2,JJ Bumrah,KA Pollard,1,2,0,0,1,0,0,0,0,1,2,0,0
6480bb97aabcd4374e076d04,2021,,,1,Abdul Samad,JO Holder,1,2,0,0,1,0,1,0,0,1,1,0,0
6480bb9506d56930505d45ae,2019,,,2,AR Patel,SS Iyer,1,1,0,0,1,1,1,0,0,0,0,0,0
6480bba0f1ebf9ff255e1c91,2013,,,2,GH Vihari,S Dhawan,1,2,0,0,1,1,1,0,0,0,1,0,0
6480bba04b49d2ff5f997e02,2013,,,2,IK Pathan,M Morkel,1,2,0,0,1,1,1,0,0,0,1,0,0
6480bb9ce93a7b4315d8fa30,2009,,,1,DR Smith,Y Venugopal Rao,1,2,0,0,1,0,1,0,0,1,1,0,0
6480bba0da054e3d917f71fb,2013,,,1,R Dravid,SV Samson,1,6,0,0,1,1,1,0,0,0,5,0,0
6480bba1ece63aa1c77a954e,2015,,,1,AM Rahane,KK Nair,1,1,0,0,0,0,0,0,0,1,1,0,0
6480bb94b9d954a885cc531b,2017,,,1,KH Pandya,KV Sharma,1,5,0,0,1,0,0,0,0,1,5,0,0
6480bba071a7a0cbb02d505a,2013,,,1,DA Warner,KM Jadhav,1,2,0,0,1,0,0,0,0,0,2,0,0
6480bba3fc9599eca1b87a77,2016,,,2,AJ Finch,P Kumar,1,5,0,0,1,0,1,0,0,1,4,0,0
6480bba090c88df75eba18e6,2014,,,1,AM Nayar,KK Nair,1,5,0,0,1,0,2,0,0,0,3,0,0
6480bb95ff5da0069bc5274e,2018,,,2,BB Sran,R Ashwin,1,2,0,0,1,1,1,0,0,0,1,0,0
6480bb9e83b8575f74b8e962,2012,,,2,DL Vettori,RR Bhatkal,1,2,0,0,1,1,1,0,0,0,1,0,0
6480bba234aac105851964b1,2015,,,1,R Ashwin,RA Jadeja,1,1,0,0,0,1,1,0,0,0,0,0,0
6480bb9480627b50308b7903,2017,,,2,KH Pandya,MJ McClenaghan,1,1,0,0,1,0,0,0,0,1,1,0,0
6480bb977453ebef15f59e25,2021,,,1,SP Narine,Shubman Gill,1,2,0,0,1,0,1,0,0,1,1,0,0
6480bb9b8cc888fe3f01f2a4,2009,,,1,KC Sangakkara,S Sohal,1,5,0,0,1,0,2,0,0,1,3,0,0
6480bba0f401cc6b6bc6ed10,2013,,,2,GH Vihari,S Dhawan,1,9,0,0,1,1,8,0,0,0,1,0,0
6480bba3ebbd8e4867dfa673,2016,,,1,JP Duminy,P Negi,1,1,0,0,1,1,1,0,0,0,0,0,0
6480bb9fe8f5df13fc8d1bc3,2012,,,1,DB Das,MK Tiwary,1,2,0,0,1,1,1,0,0,0,1,0,0
6480bba1f5d65d6146678a7f,2015,,,1,A Mishra,AD Mathews,1,4,0,0,1,1,1,0,0,0,3,0,0
6480bb9f4780a208e13bfb3d,2013,,,2,A Chandila,S Sreesanth,1,4,0,0,1,1,2,0,0,0,2,0,0
6480bb970c637fd0c057dca9,2021,,,2,B Kumar,Rashid Khan,1,2,0,0,1,0,0,0,0,0,2,0,0
6480bb9d3c4dfa9f054aa47f,2011,,,2,SK Trivedi,SK Warne,1,3,0,0,1,0,2,0,0,1,1,0,0
6480bba0a9f68a29bda72302,2013,,,1,MK Tiwary,YK Pathan,1,3,0,0,1,0,2,0,0,1,1,0,0
6480bb9ea49fe0f895bf242a,2012,,,2,A Singh,GB Hogg,1,3,0,0,1,0,3,0,0,0,0,0,0
6480bb9575ad32214d0f6ec0,2019,,,1,DA Miller,Mandeep Singh,1,3,0,0,1,1,1,0,0,0,2,0,0
6480bb94bf9a1728b1b12f4d,2018,,,2,AM Rahane,JC Archer,1,1,0,0,0,0,0,0,0,1,1,0,0
6480bb9c7a11e1cbeea46b0e,2009/10,,,1,R McLaren,Z Khan,1,1,0,0,0,1,1,0,0,0,0,0,0
6480bb9929c7e430acd1ef18,2022,,,2,AR Patel,R Powell,1,3,0,0,1,1,3,0,0,0,0,0,0
6480bba048fb3d33ea0711e7,2013,,,1,LA Pomersbach,Sandeep Sharma,1,2,0,0,0,1,1,0,0,0,1,0,0
6480bb9c620c92d09ba1b6b9,2009,,,2,RA Jadeja,SK Warne,1,2,0,0,1,1,1,0,0,0,1,0,0
6480bb9df60a79ae5f20b748,2011,,,2,DJ Jacobs,SR Tendulkar,1,8,0,0,1,1,6,0,0,0,2,0,0
6480bb94704f6dfeb7f4d270,2017,,,2,C de Grandhomme,CA Lynn,1,1,0,0,1,0,0,0,0,1,1,0,0
6480bb95fa6394e733c532a9,2018,,,2,KD Karthik,Shubman Gill,1,2,0,0,0,1,2,0,0,0,0,0,0
6480bb9ee779ef1e445d0506,2012,,,2,M Kartik,R Sharma,1,3,0,0,1,1,3,0,0,0,0,0,0
6480bba140ee53a14fe06e0d,2014,,,2,M Manhas,MS Dhoni,1,1,0,0,1,1,1,0,0,0,0,0,0
6480bba2bae80e615447f251,2015,,,2,D Wiese,HV Patel,1,2,0,0,1,1,1,0,0,0,1,0,0
6480bb9d59f2ded94f736145,2011,,,1,DPMD Jayawardene,PA Patel,1,4,0,0,1,0,1,0,0,0,3,0,0
6480bb98960cf9374ee9420d,2022,,,2,DR Sams,JD Unadkat,1,2,0,0,1,0,1,0,0,1,1,0,0
6480bb9e565ef5f11c5c8f55,2011,,,1,DJ Hussey,SE Marsh,1,1,0,0,0,0,1,0,0,0,0,0,0
6480bb9da398a7c3c645732c,2011,,,2,NL McCullum,R Sharma,1,2,0,0,1,0,1,0,0,0,1,0,0
6480bb9b3a5e1af467fb027b,2009,,,1,R Dravid,RV Uthappa,1,2,0,0,1,1,1,0,0,0,1,0,0
6480bb99c26e725b7b6f1637,2023,,,1,KH Pandya,Yudhvir Singh,1,1,0,0,1,0,0,0,0,1,1,0,0
6480bba20559f15c3489f637,2015,,,2,GH Vihari,KV Sharma,1,3,0,0,1,1,2,0,0,0,1,0,0
6480bb9e591b94e62772e66a,2012,,,1,IK Pathan,KP Pietersen,1,2,0,0,1,0,1,0,0,1,1,0,0
6480bba1827557ebdfc70821,2015,,,1,Anureet Singh,MG Johnson,1,2,0,0,1,0,1,0,0,0,1,0,0
6480bb9c5ec0713155cad138,2009/10,,,1,TL Suman,WPUJC Vaas,1,3,0,0,1,1,2,0,0,0,1,0,0
6480bb9ef8d4c23c6e5be4c7,2011,,,2,BJ Hodge,PA Patel,1,2,0,0,1,0,1,0,0,1,1,0,0
6480bba048fb3d33ea0711e7,2013,,,1,LA Pomersbach,PP Chawla,1,3,0,0,1,1,1,0,0,0,2,0,0
6480bba0d2cdb40c68c4739c,2013,,,1,M Vijay,S Badrinath,1,5,0,0,1,1,2,0,0,0,3,0,0
6480bb9553f3fc8903579544,2018,,,1,BCJ Cutting,RG Sharma,1,2,0,0,1,1,1,0,0,0,1,0,0
6480bb9c442caaabe9eb2275,2009,,,2,AM Rahane,RR Raje,1,2,0,0,1,0,0,0,0,1,2,0,0
6480bb9f4780a208e13bfb3d,2013,,,2,A Chandila,SW Tait,1,3,0,0,1,0,0,0,0,1,3,0,0
6480bba07b5396a7b65684d3,2013,,,2,Iqbal Abdulla,L Balaji,1,4,0,0,1,1,1,0,0,0,3,0,0
6480bba2fc84811f520b04cf,2016,,,2,AJ Finch,BB McCullum,1,6,0,0,1,1,4,0,0,0,2,0,0
6480bb99433f6e11060ba714,2022,,,2,LS Livingstone,MA Agarwal,1,3,0,0,1,1,1,0,0,0,2,0,0
6480bb9b9dd7fe8c5cbdbab0,2009,,,1,JA Morkel,M Muralitharan,1,2,0,0,0,1,1,0,0,0,1,0,0
6480bb9a0a8baa96f94e8db9,2023,,,2,K Gowtham,Ravi Bishnoi,1,3,0,0,1,1,1,0,0,0,2,0,0
6480bb9765a785922ad360fe,2021,,,1,B Kumar,Sandeep Sharma,1,2,0,0,1,0,1,0,0,0,1,0,0
6480bba136257b71aa9952cf,2014,,,2,MG Johnson,WP Saha,1,3,0,0,1,1,1,0,0,0,2,0,0
6480bb99537b54b870dc74d1,2023,,,1,Harpreet Brar,R Dhawan,1,2,0,0,1,0,1,0,0,1,1,0,0
6480bb9d22388e966342dba8,2009/10,,,2,AT Rayudu,SS Tiwary,1,3,0,0,1,0,1,0,0,0,2,0,0
6480bb98291bb8b3f3e8145d,2022,,,2,CV Varun,Rasikh Salam,1,2,0,0,1,1,1,0,0,0,1,0,0
6480bb939b2499e9af6ee18c,2017,,,2,BB McCullum,DR Smith,1,2,0,0,1,0,0,0,0,0,2,0,0
6480bb9b50f9e801edc13d5a,2007/08,,,1,Misbah-ul-Haq,SP Goswami,1,3,0,0,1,0,1,0,0,1,2,0,0
6480bba33dab752d79e587d2,2016,,,1,B Kumar,NV Ojha,1,3,0,0,1,1,2,0,0,0,1,0,0
6480bb9e2c96ab2b87d9466a,2011,,,2,CA Ingram,V Sehwag,1,2,0,0,1,1,2,0,0,0,0,0,0
6480bb960d5042aa46b7776b,2020/21,,,1,Ishan Kishan,SS Tiwary,1,3,0,0,1,0,0,0,0,1,3,0,0
6480bb963c729ccbcb9446f8,2020/21,,,1,AD Russell,N Rana,1,3,0,0,1,0,0,0,0,1,3,0,0
6480bb9f777b7b1e89543a6e,2013,,,2,AT Rayudu,Harbhajan Singh,1,3,0,0,1,0,2,0,0,1,1,0,0
6480bba1de7febd9f1f0138e,2014,,,2,DH Yagnik,STR Binny,1,2,0,0,1,1,1,0,0,0,1,0,0
6480bba0c9e6d590ed35eb56,2014,,,1,PA Patel,V Kohli,1,3,0,0,1,1,1,0,0,0,2,0,0
6480bb987c720def5fbaf218,2022,,,2,D Brevis,Ishan Kishan,1,3,0,0,1,0,2,0,0,0,1,0,0
6480bb9618b5973b98c0ba18,2019,,,2,PA Patel,V Kohli,1,3,0,0,1,0,3,0,0,0,0,0,0
6480bb9737b1d7284b5297c1,2021,,,1,JJ Bumrah,RD Chahar,1,2,0,0,1,1,2,0,0,0,0,0,0
6480bb9b52b93b56f5a16e52,2007/08,,,1,A Mishra,VY Mahesh,1,2,0,0,1,1,2,0,0,0,0,0,0
6480bb9b52b93b56f5a16e52,2007/08,,,1,MK Tiwary,S Dhawan,1,8,0,0,1,0,1,0,0,1,7,0,0
6480bb9eb14c6138aebfbf98,2012,,,1,DJ Hussey,P Dogra,1,2,0,0,1,1,1,0,0,0,1,0,0
6480bb9fc3369c6f5a549d05,2013,,,1,S Nadeem,UT Yadav,1,8,0,0,1,0,3,0,0,1,5,0,0
6480bb995193664eda3e9e10,2022,,,1,CV Varun,RK Singh,1,6,0,0,0,0,0,0,0,1,6,0,0
6480bb9a1032ce724214f6dd,2007/08,,,2,S Dhawan,V Sehwag,1,3,0,0,1,1,3,0,0,0,0,0,0
6480bba2bae80e615447f251,2015,,,1,MM Sharma,P Negi,1,1,0,0,1,0,0,0,0,0,1,0,0
6480bb9f87652064dab6c573,2013,,,2,L Balaji,SP Narine,1,1,0,0,0,0,0,0,0,0,1,0,0
6480bb97a42828c5a5ebef1c,2020/21,,,1,Ishan Kishan,KA Pollard,1,3,0,0,1,1,1,0,0,0,2,0,0
6480bb9ce7891d47a7fe9c12,2009/10,,,2,DPMD Jayawardene,IK Pathan,1,2,0,0,1,0,1,0,0,1,1,0,0
6480bba1587a54176a9badf4,2014,,,1,RN ten Doeschate,YK Pathan,1,2,0,0,1,0,1,0,0,1,1,0,0
6480bb9bf2869505c9393b7d,2009,,,2,AB Agarkar,MC Henriques,1,2,0,0,1,1,1,0,0,0,1,0,0
6480bba30373b229e0090b67,2016,,,2,AB de Villiers,V Kohli,1,2,0,0,1,1,1,0,0,0,1,0,0
6480bb9e56c724ba25b94666,2011,,,2,KA Pollard,TL Suman,1,2,0,0,1,0,1,0,0,0,1,0,0
6480bb948211fe47e65f2e77,2018,,,2,HH Pandya,JJ Bumrah,1,10,0,0,1,0,9,0,0,1,1,0,0
6480bb94d8ce46258c13e90e,2017,,,1,Harbhajan Singh,MJ McClenaghan,1,1,0,0,1,1,1,0,0,0,0,0,0
6480bb9bdde9db92f880e40d,2007/08,,,2,DPMD Jayawardene,TM Srivastava,1,1,0,0,0,0,0,0,0,1,1,0,0
6480bba0b46cf5430edef3f5,2014,,,2,JH Kallis,YK Pathan,1,2,0,0,1,0,1,0,0,1,1,0,0
6480bb9a8ac627a1ebf8dacf,2007/08,,,1,B Akhil,P Kumar,1,1,0,0,1,1,1,0,0,0,0,0,0
6480bba287d112bccc55ccd2,2015,,,2,D Wiese,HV Patel,1,1,0,0,0,1,1,0,0,0,0,0,0
6480bb983ad1bab18d1d8774,2022,,,2,Anuj Rawat,F du Plessis,1,3,0,0,1,0,2,0,0,1,1,0,0
6480bb9af1b34d6aa89e434e,2023,,,2,JM Sharma,LS Livingstone,1,4,0,0,1,0,3,0,0,1,1,0,0
6480bb9cf1471ad233c7b0af,2009,,,2,AS Raut,SK Warne,1,2,0,0,1,1,2,0,0,0,0,0,0
6480bb93182304739a535742,2017,,,1,AB Dinda,Imran Tahir,1,4,0,0,1,1,2,0,0,0,2,0,0
6480bb976344f6d667dfd965,2021,,,1,Lalit Yadav,RR Pant,1,4,0,0,1,0,3,0,0,1,1,0,0
6480bba07b5396a7b65684d3,2013,,,2,G Gambhir,MS Bisla,1,4,0,0,1,0,2,0,0,0,2,0,0
6480bba0a222eb875a07f5a3,2014,,,1,M Vijay,MK Tiwary,1,4,0,0,1,0,1,0,0,1,3,0,0
6480bb9809c62ba77e5df472,2021,,,2,EJG Morgan,KD Karthik,1,2,0,0,1,1,1,0,0,0,1,0,0
6480bba33195e5ebac1da82a,2016,,,2,HM Amla,M Vijay,1,6,0,0,1,0,5,0,0,1,1,0,0
6480bb94640655c49683aee1,2018,,,1,KA Pollard,RG Sharma,1,2,0,0,1,1,1,0,0,0,1,0,0
6480bb9b09e6c98206422ae5,2009,,,1,AB Agarkar,I Sharma,1,1,0,0,1,0,0,0,0,1,1,0,0
6480bba388682c5ca10ff37a,2016,,,2,BCJ Cutting,Yuvraj Singh,1,1,0,0,1,0,0,0,0,0,1,0,0
6480bb9996eb97dd08b62f78,2023,,,2,Arshdeep Singh,JM Sharma,1,2,0,0,1,0,0,0,0,0,2,0,0
6480bb99fe078839da40e7ab,2023,,,2,AR Patel,Aman Hakim Khan,1,3,0,0,1,1,1,0,0,0,2,0,0
6480bb99695e001cdaca81e0,2022,,,1,M Theekshana,MS Dhoni,1,4,0,0,1,0,3,0,0,1,1,0,0
6480bb9894cc2d00f057a1f1,2021,,,2,KD Karthik,RA Tripathi,1,8,0,0,1,0,3,0,0,1,5,0,0
6480bb9618b5973b98c0ba18,2019,,,1,KS Williamson,MK Pandey,1,3,0,0,1,1,1,0,0,0,2,0,0
6480bb9d79d603cc45fc9b3c,2011,,,2,PP Chawla,RJ Harris,1,2,0,0,1,0,0,0,0,1,2,0,0
6480bb98cbaaf700d226941a,2022,,,2,KA Pollard,TH David,1,5,0,0,1,0,2,0,0,1,3,0,0
6480bb9affc08d6384ac3992,2023,,,1,AK Markram,RA Tripathi,1,2,0,0,1,1,1,0,0,0,1,0,0
6480bb9fa3a890f94f179477,2013,,,1,M Vohra,Mandeep Singh,1,2,0,0,1,1,1,0,0,0,1,0,0
6480bb9746dfc5c467942a84,2021,,,2,JJ Bumrah,SS Tiwary,1,2,0,0,0,1,2,0,0,0,0,0,0
6480bba179195d83fa7fbfbb,2014,,,2,AD Russell,RV Uthappa,1,2,0,0,1,1,1,0,0,0,1,0,0
6480bb9c8cbb5dec60b7d50a,2009/10,,,2,PP Ojha,RP Singh,1,2,0,0,0,0,0,0,0,0,2,0,0
6480bb9c266a85f1960d87e9,2009,,,1,G Gambhir,TM Dilshan,1,5,0,0,1,1,3,0,0,0,2,0,0
6480bb99e520ec7a66b73adb,2022,,,1,MR Marsh,PP Shaw,1,2,0,0,1,0,1,0,0,1,1,0,0
6480bb9fe8f5df13fc8d1bc3,2012,,,1,G Gambhir,JH Kallis,1,4,0,0,1,1,3,0,0,0,1,0,0
6480bb9797043717cd96890a,2021,,,1,MK Lomror,R Parag,1,2,0,0,1,1,1,0,0,0,1,0,0
6480bb97b97c36ac8be3582f,2021,,,2,B Kumar,T Natarajan,1,1,0,0,0,1,1,0,0,0,0,0,0
6480bb9ec90f99c5ea40b014,2012,,,2,R Dravid,SP Goswami,1,3,0,0,1,0,2,0,0,1,1,0,0
6480bba3b830360cf7031278,2016,,,1,HH Pandya,Harbhajan Singh,1,3,0,0,1,1,3,0,0,0,0,0,0
6480bb9558c0acb502a3b1a9,2019,,,2,GH Vihari,HV Patel,1,2,0,0,1,0,0,0,0,0,2,0,0
6480bba19cc161a3fb8a8795,2014,,,1,R Dhawan,Shivam Sharma,1,1,0,0,0,0,0,0,0,1,1,0,0
6480bba265483f7db002ec7c,2015,,,1,Anureet Singh,MG Johnson,1,4,0,0,1,0,2,0,0,1,2,0,0
6480bb9a61edc0c77bc4bc86,2007/08,,,1,AB de Villiers,G Gambhir,1,2,0,0,1,0,1,0,0,1,1,0,0
6480bba3b818a7cff6fe4f89,2016,,,1,BB Sran,Bipul Sharma,1,1,0,0,0,0,0,0,0,0,1,0,0
6480bb94fc240a33621b10a6,2018,,,1,Shubman Gill,TK Curran,1,3,0,0,1,0,0,0,0,1,3,0,0
6480bb9fc28e897b3c53f359,2012,,,2,Harbhajan Singh,KA Pollard,1,5,0,0,1,1,4,0,0,0,1,0,0
6480bba273adb498d96b27a9,2016,,,1,Q de Kock,SV Samson,1,2,0,0,1,0,1,0,0,1,1,0,0
6480bba29fb420d92aef1d2a,2015,,,2,B Kumar,DW Steyn,1,2,0,0,0,0,1,0,0,1,1,0,0
6480bb961570df6942a00888,2019,,,2,DJ Bravo,KM Jadhav,1,1,0,0,0,0,0,0,0,1,1,0,0
6480bb975ea60ce128803d60,2021,,,2,N Rana,Shubman Gill,1,4,0,0,1,1,3,0,0,0,1,0,0
6480bb9ee779ef1e445d0506,2012,,,1,MM Patel,PP Ojha,1,2,0,0,0,1,2,0,0,0,0,0,0
6480bba19cc161a3fb8a8795,2014,,,1,BE Hendricks,R Dhawan,1,2,0,0,1,0,1,0,0,1,1,0,0
6480bb9af968df9497d2b9c4,2007/08,,,1,BB McCullum,RT Ponting,1,2,0,0,1,0,1,0,0,1,1,0,0
6480bb9b52b93b56f5a16e52,2007/08,,,1,A Mishra,TM Dilshan,1,4,0,0,1,1,3,0,0,0,1,0,0
6480bb9651b51fdcda05e4c8,2020/21,,,1,N Rana,Shubman Gill,1,2,0,0,1,0,1,0,0,1,1,0,0
6480bb9d59f2ded94f736145,2011,,,1,BJ Hodge,DPMD Jayawardene,1,2,0,0,1,0,2,0,0,0,0,0,0
6480bb9814efd9a91e8c911f,2021,,,2,Anuj Rawat,S Dube,1,2,0,0,1,0,1,0,0,1,1,0,0
6480bba120182b9ca0b70004,2014,,,2,KL Rahul,NV Ojha,1,2,0,0,1,0,1,0,0,1,1,0,0
6480bb9d69cb9046a72d8fbe,2009/10,,,2,PP Ojha,RP Singh,1,7,0,0,1,1,4,0,0,0,3,0,0
6480bb9fc28e897b3c53f359,2012,,,1,M Vijay,MEK Hussey,1,7,0,0,1,1,5,0,0,0,2,0,0
6480bba2704d23da78c3eb15,2016,,,2,MM Sharma,Swapnil Singh,1,2,0,0,1,1,1,0,0,0,1,0,0
6480bb9a81d7fd0ac0307b4d,2023,,,2,Mohsin Khan,Naveen-ul-Haq,1,10,0,0,1,0,7,0,0,1,3,0,0
6480bb98e87e6f83b61088ea,2022,,,2,AT Rayudu,RA Jadeja,1,5,0,0,1,1,2,0,0,0,3,0,0
6480bb9929c7e430acd1ef18,2022,,,1,AT Rayudu,S Dube,1,4,0,0,1,0,3,0,0,0,1,0,0
6480bba250b404cdcbff22c8,2015,,,1,A Nehra,MM Sharma,1,2,0,0,1,0,1,0,0,1,1,0,0
6480bb9ca181f55cb21526f5,2009/10,,,1,DJ Bravo,R Sathish,1,3,0,0,1,0,1,0,0,0,2,0,0
6480bb9936b7698da2c2030c,2023,,,1,A Zampa,SO Hetmyer,1,1,0,0,1,1,1,0,0,0,0,0,0
6480bb9bee2e48d9c41b1e23,2009,,,2,PP Ojha,Shoaib Ahmed,1,4,0,0,1,0,2,0,0,1,2,0,0
6480bb94b9d954a885cc531b,2017,,,1,AT Rayudu,LMP Simmons,1,3,0,0,1,1,2,0,0,0,1,0,0
6480bb9f9eae77e599a46300,2012,,,1,RG Sharma,SR Tendulkar,1,3,0,0,1,0,3,0,0,0,0,0,0
6480bb9bbb0ec0266749f518,2007/08,,,2,Shahid Afridi,VVS Laxman,1,2,0,0,1,1,2,0,0,0,0,0,0
6480bba090c88df75eba18e6,2014,,,2,PA Patel,YV Takawale,1,4,0,0,1,1,1,0,0,0,3,0,0
6480bb97d5e3b0911408f222,2020/21,,,1,CH Morris,Gurkeerat Singh,1,3,0,0,1,0,2,0,0,1,1,0,0
6480bb96e8ba017befb2bc8a,2020/21,,,1,PP Shaw,S Dhawan,1,3,0,0,1,1,1,0,0,0,2,0,0
6480bb98cbaaf700d226941a,2022,,,1,JC Buttler,R Parag,1,3,0,0,1,0,2,0,0,0,1,0,0
6480bb9d40fc01528c7b7270,2009/10,,,1,AG Paunikar,NV Ojha,1,2,0,0,1,0,1,0,0,1,1,0,0
6480bb9fa3a890f94f179477,2013,,,1,P Kumar,RJ Harris,1,3,0,0,1,0,1,0,0,0,2,0,0
6480bb9dbefe5e2cceb23e01,2011,,,2,Joginder Sharma,S Badrinath,1,2,0,0,1,0,1,0,0,1,1,0,0
6480bba234aac105851964b1,2015,,,2,MA Starc,SN Khan,1,2,0,0,1,1,1,0,0,0,1,0,0
6480bba3b830360cf7031278,2016,,,2,MC Henriques,S Dhawan,1,2,0,0,0,1,2,0,0,0,0,0,0
6480bb9f1faffe780b407e67,2013,,,1,MK Pandey,RV Uthappa,1,6,0,0,1,0,4,0,0,1,2,0,0
6480bb9e335bec070f88430f,2011,,,2,S Badrinath,SK Raina,1,4,0,0,1,0,3,0,0,0,1,0,0
6480bb96593f4f87a2c294bc,2020/21,,,2,Rashid Khan,Sandeep Sharma,1,2,0,0,1,0,1,0,0,1,1,0,0
6480bb993e61058e682e2ff4,2023,,,1,AS Joseph,R Tewatia,1,1,0,0,0,0,0,0,0,1,1,0,0
6480bb970d7cbd85b6ada680,2021,,,2,KA Jamieson,Mohammed Siraj,1,2,0,0,0,1,1,0,0,0,1,0,0
6480bb932d6ccb8870dcd72d,2017,,,2,AM Rahane,MA Agarwal,1,5,0,0,1,1,1,0,0,0,4,0,0
6480bb9e59fe7a0f48b7f9b9,2012,,,1,P Negi,V Sehwag,1,3,0,0,1,1,2,0,0,0,1,0,0
6480bba28724848c0f3ef034,2015,,,2,G Gambhir,MK Pandey,1,2,0,0,1,0,1,0,0,1,1,0,0
6480bb9d97cceb6330e84df0,2011,,,1,NV Ojha,Y Nagar,1,3,0,0,1,0,2,0,0,0,1,0,0
6480bba255079696d5cfa453,2015,,,2,DA Miller,GJ Bailey,1,2,0,0,1,0,1,0,0,1,1,0,0
6480bb9824c4678d005d7aeb,2022,,,2,AD Russell,SS Iyer,1,4,0,0,1,0,1,0,0,1,3,0,0
6480bb9825eb960aded1ff64,2022,,,2,Shubman Gill,WP Saha,1,6,0,0,1,0,1,0,0,1,5,0,0
6480bb9a9dc58f49d783faa9,2023,,,2,JC Buttler,YBK Jaiswal,1,2,0,0,1,0,0,0,0,0,2,0,0
6480bb966539f85263cb6429,2019,,,2,CH Morris,SS Iyer,1,4,0,0,1,0,1,0,0,1,3,0,0
6480bb955f4b3a84d6973620,2018,,,1,C Munro,PP Shaw,1,4,0,0,1,0,1,0,0,1,3,0,0
6480bb9c37b72d7a51019794,2009/10,,,2,FY Fazal,NV Ojha,1,2,0,0,1,0,0,0,0,0,2,0,0
6480bb96a467817b9b68ca94,2020/21,,,2,Sandeep Sharma,T Natarajan,1,3,0,0,0,1,2,0,0,0,1,0,0
6480bb9b52b93b56f5a16e52,2007/08,,,2,SK Warne,YK Pathan,1,2,0,0,1,0,1,0,0,1,1,0,0
6480bb9a0474602f26069e45,2007/08,,,2,S Vidyut,SP Fleming,1,4,0,0,1,1,2,0,0,0,2,0,0
6480bb9ef18c54e7aafdd223,2012,,,2,AD Mascarenhas,Bipul Sharma,1,2,0,0,1,0,1,0,0,1,1,0,0
6480bb94aad1a08ca4276b4e,2018,,,2,BB McCullum,Q de Kock,1,2,0,0,1,0,1,0,0,1,1,0,0
6480bba069d61566bb63ac2b,2014,,,2,G Gambhir,JH Kallis,1,3,0,0,1,0,1,0,0,1,2,0,0
6480bb9aa64355ce98da1141,2007/08,,,1,V Kohli,W Jaffer,1,4,0,0,1,0,0,0,0,0,4,0,0
6480bb97a4220e27710e38de,2021,,,2,AD Russell,Harbhajan Singh,1,7,0,0,1,1,7,0,0,0,0,0,0
6480bb9f03dd3a09740f0bd0,2013,,,2,EJG Morgan,YK Pathan,1,4,0,0,1,1,2,0,0,0,2,0,0
6480bba2563745309ee2bdfb,2016,,,2,KC Cariappa,Sandeep Sharma,1,2,0,0,1,0,1,0,0,1,1,0,0
6480bb96fed7a7ee65076e4a,2020/21,,,1,R Parag,R Tewatia,1,1,0,0,1,0,1,0,0,0,0,0,0
6480bb9808d6857eeb335d94,2022,,,1,N Rana,UT Yadav,1,2,0,0,1,0,1,0,0,0,1,0,0
6480bb94457bfc7687322f80,2017,,,1,A Choudhary,YS Chahal,1,2,0,0,1,0,0,0,0,1,2,0,0
6480bb9ea75f51e7a33e90ed,2012,,,1,MS Dhoni,RA Jadeja,1,4,0,0,1,1,4,0,0,0,0,0,0
6480bb9cc5312f3d7cfb650e,2009/10,,,1,B Lee,RS Bopara,1,1,0,0,0,1,1,0,0,0,0,0,0
6480bba2b7be71a15b2bb3de,2015,,,1,LMP Simmons,PA Patel,1,5,0,0,1,1,2,0,0,0,3,0,0
6480bba223f162806c0794ac,2015,,,2,KA Pollard,RG Sharma,1,8,0,0,1,1,4,0,0,0,4,0,0
6480bb9f00ef088221497043,2013,,,1,LR Shukla,SMSM Senanayake,1,2,0,0,1,0,1,0,0,1,1,0,0
6480bb9746dfc5c467942a84,2021,,,1,MM Ali,RD Gaikwad,1,4,0,0,1,0,3,0,0,1,1,0,0
6480bb95945c5e5dc4d8c7d6,2019,,,1,HH Pandya,MJ McClenaghan,1,4,0,0,1,0,0,0,0,1,4,0,0
6480bb9f7bae5ad85c4473ba,2012,,,1,DR Smith,SL Malinga,1,2,0,0,1,1,1,0,0,0,1,0,0
6480bba1c67d2c9c1279a4c8,2014,,,2,DA Warner,IK Pathan,1,4,0,0,1,0,3,0,0,0,1,0,0
6480bb9b52b93b56f5a16e52,2007/08,,,2,MM Patel,YK Pathan,1,1,0,0,1,0,0,0,0,1,1,0,0
6480bb9e41b781523bd5aafe,2012,,,1,DB Das,LR Shukla,1,1,0,0,1,0,0,0,0,1,1,0,0
6480bb9936b7698da2c2030c,2023,,,2,AT Rayudu,DP Conway,1,2,0,0,1,1,2,0,0,0,0,0,0
6480bb95c701f5c8388f7f88,2018,,,1,AJ Tye,AR Patel,1,4,0,0,1,0,3,0,0,1,1,0,0
6480bb9c121ee402b7b2eda6,2009,,,2,AA Bilakhia,RG Sharma,1,2,0,0,1,0,0,0,0,1,2,0,0
6480bba2256bfaaf14c57ead,2015,,,2,SA Yadav,YK Pathan,1,2,0,0,1,0,1,0,0,1,1,0,0
6480bb9b77a0ff5cb3d0e3e0,2009,,,2,KD Karthik,M Manhas,1,5,0,0,1,1,1,0,0,0,4,0,0
6480bb9894cc2d00f057a1f1,2021,,,2,RA Tripathi,Shakib Al Hasan,1,3,0,0,1,1,1,0,0,0,2,0,0
6480bb9b95eac8df5d0180b0,2007/08,,,2,JR Hopes,LA Pomersbach,1,3,0,0,1,0,1,0,0,1,2,0,0
6480bb9a07d46704efe103ef,2007/08,,,1,AS Yadav,RP Singh,1,2,0,0,1,0,1,0,0,1,1,0,0
6480bb95085c25712f29bd36,2019,,,1,DW Steyn,UT Yadav,1,1,0,0,0,0,0,0,0,1,1,0,0
6480bb95e435367dc64d9844,2019,,,2,BA Stokes,SPD Smith,1,4,0,0,1,0,2,0,0,1,2,0,0
6480bb9a807eb5f39489408a,2023,,,1,DL Chahar,TU Deshpande,1,1,0,0,0,0,0,0,0,0,1,0,0
6480bba23ed328dbb847b4e7,2016,,,1,SR Watson,VR Aaron,1,1,0,0,1,1,1,0,0,0,0,0,0
6480bb95014388d3e8c62904,2019,,,2,PP Shaw,S Dhawan,1,3,0,0,1,1,2,0,0,0,1,0,0
6480bb9802d8f5ec4413766d,2022,,,1,HH Pandya,Rashid Khan,1,2,0,0,1,1,1,0,0,0,1,0,0
6480bba08ffdd4393211d261,2014,,,2,F du Plessis,MS Dhoni,1,2,0,0,1,0,1,0,0,0,1,0,0
6480bb9ed74d222a3da56dfa,2012,,,2,MK Tiwary,RN ten Doeschate,1,3,0,0,1,0,1,0,0,1,2,0,0
6480bb9558c0acb502a3b1a9,2019,,,1,M Ashwin,Mandeep Singh,1,2,0,0,1,1,2,0,0,0,0,0,0
6480bb96d1b3bea0aa2127e4,2020/21,,,2,EJG Morgan,NS Naik,1,3,0,0,1,0,2,0,0,1,1,0,0
6480bb9e9f1ef9ac02266570,2011,,,1,B Chipli,I Sharma,1,1,0,0,0,1,1,0,0,0,0,0,0
6480bb9b52b93b56f5a16e52,2007/08,,,2,MM Patel,SK Trivedi,1,2,0,0,0,0,0,0,0,1,2,0,0
6480bb9f7bae5ad85c4473ba,2012,,,1,AT Rayudu,RG Sharma,1,3,0,0,1,0,2,0,0,1,1,0,0
6480bb9f58a3e7ea877fc9dc,2012,,,1,CL White,KC Sangakkara,1,3,0,0,1,0,1,0,0,1,2,0,0
6480bba2704d23da78c3eb15,2016,,,2,MM Sharma,Sandeep Sharma,1,1,0,0,0,0,0,0,0,1,1,0,0
6480bb95a8153d4daac6e4f7,2019,,,1,CA Lynn,RV Uthappa,1,2,0,0,1,1,1,0,0,0,1,0,0
6480bb99349f00f851e8d2fd,2023,,,2,JC Archer,TH David,1,2,0,0,0,1,2,0,0,0,0,0,0
6480bb9b95eac8df5d0180b0,2007/08,,,1,MF Maharoof,V Sehwag,1,2,0,0,1,0,1,0,0,0,1,0,0
6480bb9fa1611443840261b7,2012,,,2,SS Tiwary,Z Khan,1,5,0,0,1,1,1,0,0,0,4,0,0
6480bb987c720def5fbaf218,2022,,,1,JM Sharma,OF Smith,1,2,0,0,0,0,1,0,0,1,1,0,0
6480bb9a24adc8d916dfe2db,2023,,,1,MD Shanaka,MM Sharma,1,1,0,0,0,0,0,0,0,0,1,0,0
6480bb974123cbc9756ceefa,2021,,,1,HV Patel,KS Bharat,1,1,0,0,0,1,1,0,0,0,0,0,0
6480bb947a7076697fc0b339,2017,,,2,DM Bravo,G Gambhir,1,5,0,0,1,1,2,0,0,0,3,0,0
6480bba2fc84811f520b04cf,2016,,,1,DA Miller,WP Saha,1,2,0,0,1,0,1,0,0,1,1,0,0
6480bb9f02801d2090cdba0d,2012,,,2,KD Karthik,PP Ojha,1,2,0,0,1,0,1,0,0,1,1,0,0
6480bb991a76403912eef285,2023,,,1,S Dhawan,Sikandar Raza,1,3,0,0,1,0,1,0,0,1,2,0,0
6480bba1743abcb135a6a4c7,2015,,,2,DJ Hooda,STR Binny,1,3,0,0,1,0,0,0,0,0,3,0,0
6480bb9c6f1c8ea3dc73226f,2009/10,,,1,M Manhas,MF Maharoof,1,3,0,0,1,1,3,0,0,0,0,0,0
6480bb94aa9b082aa58a3822,2017,,,2,SV Samson,SW Billings,1,6,0,0,1,1,4,0,0,0,2,0,0
6480bb9f0f959bc6104820c3,2013,,,2,R Shukla,S Sreesanth,1,2,0,0,0,1,2,0,0,0,0,0,0
6480bb9d22388e966342dba8,2009/10,,,2,S Dhawan,SR Tendulkar,1,10,0,0,1,0,8,0,0,1,2,0,0
6480bb96902b7c96b94f406a,2019,,,1,AD Russell,RV Uthappa,1,1,0,0,1,0,1,0,0,0,0,0,0
6480bb94a0422f6d0abe276b,2017,,,2,AR Bawne,PJ Cummins,1,1,0,0,0,1,1,0,0,0,0,0,0
6480bb9dd89d4266d59a4592,2011,,,2,P Kumar,RJ Harris,1,2,0,0,1,1,1,0,0,0,1,0,0
6480bba280f09c38002cf14b,2015,,,1,SP Narine,UT Yadav,1,1,0,0,0,0,1,0,0,0,0,0,0
6480bb9f2305d07e3c65be11,2013,,,2,Gurkeerat Singh,MS Gony,1,1,0,0,1,1,1,0,0,0,0,0,0
6480bb96c10dfe3d8c259db3,2020/21,,,1,AB de Villiers,Washington Sundar,1,2,0,0,1,1,2,0,0,0,0,0,0
6480bb9cd6fe6fad0d6efbd9,2009/10,,,1,GC Smith,YK Pathan,1,6,0,0,1,1,1,0,0,0,5,0,0
6480bb952f20835ddd6e533f,2019,,,2,K Gowtham,RA Tripathi,1,3,0,0,1,0,0,0,0,0,3,0,0
6480bb98f01e4672b988c112,2022,,,2,KH Pandya,MP Stoinis,1,2,0,0,1,0,1,0,0,1,1,0,0
6480bb94c2dcb1007bf6788b,2017,,,1,CH Gayle,Mandeep Singh,1,4,0,0,1,0,2,0,0,1,2,0,0
6480bb9ed6aefcc9cd13d851,2012,,,2,MN Samuels,SPD Smith,1,1,0,0,0,1,1,0,0,0,0,0,0
6480bb9a8ac627a1ebf8dacf,2007/08,,,1,R Dravid,V Kohli,1,2,0,0,1,0,1,0,0,1,1,0,0
6480bba192383a244f185c5a,2014,,,1,KP Pietersen,M Vijay,1,2,0,0,1,0,1,0,0,1,1,0,0
6480bba2b99fcf06aaeac805,2015,,,2,DJ Hooda,STR Binny,1,2,0,0,1,1,2,0,0,0,0,0,0
6480bb99ed38bcb4025b8d86,2023,,,2,Anuj Rawat,KD Karthik,1,5,0,0,1,1,5,0,0,0,0,0,0
6480bb9c963968000dfd00d1,2009/10,,,2,J Theron,PP Chawla,1,1,0,0,1,0,1,0,0,0,0,0,0
6480bb94ee669473878c11c2,2017,,,2,CH Gayle,Mandeep Singh,1,5,0,0,1,0,2,0,0,1,3,0,0
6480bba1ebb63d1bd8c60b9d,2014,,,2,Mohammed Shami,S Nadeem,1,2,0,0,1,0,1,0,0,1,1,0,0
6480bb9c58b62383739c022e,2009,,,2,J Botha,SK Warne,1,2,0,0,1,1,2,0,0,0,0,0,0
6480bb9efe3f9991539e7f6c,2012,,,2,M Manhas,MK Pandey,1,5,0,0,1,1,2,0,0,0,3,0,0
6480bb94ca96a1c1f17d1294,2017,,,2,STR Binny,V Kohli,1,7,0,0,1,1,7,0,0,0,0,0,0
6480bba0b5eabeb0a150b93f,2013,,,2,AB Dinda,M Manhas,1,1,0,0,0,1,1,0,0,0,0,0,0
6480bb947a7c9fe868fc901a,2017,,,1,S Nadeem,Z Khan,1,4,0,0,1,0,3,0,0,1,1,0,0
6480bb9bcc2f6123673672d0,2007/08,,,2,PR Shah,RV Uthappa,1,2,0,0,1,0,1,0,0,1,1,0,0
6480bb9c17dcdfd5b06984f0,2009/10,,,2,CH Gayle,MK Tiwary,1,4,0,0,1,1,1,0,0,0,3,0,0
6480bb96e2809aa0bc35c7e9,2019,,,1,E Lewis,Q de Kock,1,6,0,0,1,1,6,0,0,0,0,0,0
6480bb9e713e850d3dd0cba9,2012,,,1,AM Rahane,R Dravid,1,9,0,0,1,0,4,0,0,1,5,0,0
6480bba30373b229e0090b67,2016,,,2,STR Binny,Sachin Baby,1,1,0,0,1,0,0,0,0,1,1,0,0
6480bb9b7b8617115de9683b,2007/08,,,1,Shahid Afridi,Y Venugopal Rao,1,1,0,0,1,0,0,0,0,1,1,0,0
6480bb97752fcb9cd9f23692,2021,,,1,JA Richardson,M Shahrukh Khan,1,4,0,0,1,0,2,0,0,1,2,0,0
6480bb9ddfb0f2f6f8e813e5,2011,,,1,R Vinay Kumar,RP Singh,1,2,0,0,1,0,1,0,0,1,1,0,0
6480bb9341152e168005ccc9,2017,,,1,AF Milne,S Badree,1,2,0,0,1,1,1,0,0,0,1,0,0
6480bb998454ba791a8fdbf8,2023,,,1,Abishek Porel,DA Warner,1,2,0,0,1,1,1,0,0,0,1,0,0
6480bb99d2bd76016d47896d,2023,,,2,AR Patel,DA Warner,1,3,0,0,1,1,2,0,0,0,1,0,0
6480bb96e18d7a1b3e62552d,2019,,,1,Mohammad Nabi,Rashid Khan,1,2,0,0,1,0,1,0,0,1,1,0,0
6480bb9b50f9e801edc13d5a,2007/08,,,1,B Akhil,P Kumar,1,3,0,0,1,0,1,0,0,1,2,0,0
6480bb9c0dec1a788da66d33,2009/10,,,1,S Narwal,SK Warne,1,1,0,0,1,1,1,0,0,0,0,0,0
6480bb9ee0795047740de5a7,2011,,,1,A Singh,J Botha,1,2,0,0,1,1,1,0,0,0,1,0,0
6480bb9f87652064dab6c573,2013,,,2,G Gambhir,JH Kallis,1,7,0,0,1,0,1,0,0,1,6,0,0
6480bb9b2ca4a7b325526f1f,2009,,,1,AA Bilakhia,AC Gilchrist,1,6,0,0,1,1,5,0,0,0,1,0,0
6480bba13b673297bce003e2,2014,,,2,YV Takawale,Yuvraj Singh,1,3,0,0,1,0,1,0,0,1,2,0,0
6480bb964a4d5a1709db428e,2020/21,,,1,Q de Kock,SA Yadav,1,4,0,0,1,0,0,0,0,0,4,0,0
6480bb9371e90dbd44ee19a3,2017,,,2,AR Patel,KC Cariappa,1,2,0,0,1,0,0,0,0,1,2,0,0
6480bba19701e99975ce7c59,2015,,,1,CH Morris,DS Kulkarni,1,2,0,0,1,0,0,0,0,1,2,0,0
6480bba33dab752d79e587d2,2016,,,1,KS Williamson,MC Henriques,1,2,0,0,1,1,1,0,0,0,1,0,0
6480bb93575636076d81e4c5,2017,,,2,I Sharma,M Vohra,1,2,0,0,1,1,1,0,0,0,1,0,0
6480bb97aed297ca9686c94a,2021,,,1,KL Rahul,MA Agarwal,1,4,0,0,1,1,2,0,0,0,2,0,0
6480bb94dcc956fa4ca06b92,2018,,,1,M Vohra,V Kohli,1,1,0,0,1,0,1,0,0,0,0,0,0
6480bb96acacf3be646d300a,2020/21,,,2,AM Rahane,RR Pant,1,4,0,0,1,0,2,0,0,1,2,0,0
6480bb96b7b695186bbb6a3e,2019,,,1,KA Pollard,MJ McClenaghan,1,6,0,0,1,1,4,0,0,0,2,0,0
6480bb9399a527d39bc17dad,2017,,,1,AJ Tye,Basil Thampi,1,2,0,0,0,1,1,0,0,0,1,0,0
6480bb9824c4678d005d7aeb,2022,,,2,CV Varun,UT Yadav,1,2,0,0,1,1,1,0,0,0,1,0,0
6480bb9d362f72789dcdc5a7,2009/10,,,1,MEK Hussey,S Badrinath,1,6,0,0,1,1,6,0,0,0,0,0,0
6480bb9ee7a29c9b96ed61e5,2011,,,1,KD Karthik,R McLaren,1,2,0,0,1,0,1,0,0,1,1,0,0
6480bb9a1a3ab2ab8297871d,2007/08,,,2,D Salunkhe,SK Warne,1,2,0,0,1,1,1,0,0,0,1,0,0
6480bb9525c593ee45bb038c,2019,,,1,M Markande,MJ McClenaghan,1,2,0,0,0,0,0,0,0,0,2,0,0
6480bba33195e5ebac1da82a,2016,,,1,AT Rayudu,RG Sharma,1,5,0,0,1,0,3,0,0,1,2,0,0
6480bb9d362f72789dcdc5a7,2009/10,,,2,G Gambhir,TM Dilshan,1,3,0,0,1,1,2,0,0,0,1,0,0
6480bb9f02801d2090cdba0d,2012,,,2,KD Karthik,NLTC Perera,1,7,0,0,1,1,3,0,0,0,4,0,0
6480bb9b6ded6d116cfe02ee,2009,,,1,AN Ghosh,Yashpal Singh,1,2,0,0,1,0,1,0,0,1,1,0,0
6480bb99695e001cdaca81e0,2022,,,1,DP Conway,RD Gaikwad,1,2,0,0,1,0,1,0,0,1,1,0,0
6480bba0d2cdb40c68c4739c,2013,,,1,M Vijay,RA Jadeja,1,4,0,0,1,1,2,0,0,0,2,0,0
6480bb94ce8e0a620532955b,2018,,,1,SK Raina,SR Watson,1,2,0,0,1,1,2,0,0,0,0,0,0
6480bb9a24adc8d916dfe2db,2023,,,2,AK Markram,RA Tripathi,1,3,0,0,1,0,1,0,0,1,2,0,0
6480bba2704d23da78c3eb15,2016,,,2,Gurkeerat Singh,Swapnil Singh,1,1,0,0,1,1,1,0,0,0,0,0,0
6480bb9d61e9b86b0f0aae49,2009/10,,,2,A Kumble,KP Appanna,1,1,0,0,1,0,0,0,0,1,1,0,0
6480bb9b9dd7fe8c5cbdbab0,2009,,,2,AB de Villiers,DL Vettori,1,1,0,0,0,1,1,0,0,0,0,0,0
6480bb98f01e4672b988c112,2022,,,2,K Gowtham,Q de Kock,1,1,0,0,1,0,1,0,0,0,0,0,0
6480bb9dd4e6757f7ded95e9,2009/10,,,1,DPMD Jayawardene,IK Pathan,1,1,0,0,0,0,0,0,0,1,1,0,0
6480bb94bf9a1728b1b12f4d,2018,,,1,Basil Thampi,WP Saha,1,1,0,0,0,0,0,0,0,0,1,0,0
6480bb931e6d2b03141b586d,2017,,,1,Mohammed Shami,PJ Cummins,1,1,0,0,0,0,1,0,0,0,0,0,0
6480bb96593f4f87a2c294bc,2020/21,,,2,MR Marsh,Sandeep Sharma,1,2,0,0,1,0,1,0,0,1,1,0,0
6480bb951677500061c85592,2019,,,2,DJ Hooda,YK Pathan,1,5,0,0,1,1,1,0,0,0,4,0,0
6480bb991a76403912eef285,2023,,,1,S Dhawan,SM Curran,1,2,0,0,0,0,0,0,0,1,2,0,0
6480bb9d918bd358d046889d,2011,,,2,CH Gayle,TM Dilshan,1,2,0,0,1,0,1,0,0,0,1,0,0
6480bba31cc11024436836b5,2016,,,1,JC Buttler,KA Pollard,1,3,0,0,1,1,1,0,0,0,2,0,0
6480bb9c5d0fccb6a3a6d37d,2009,,,2,GC Smith,NV Ojha,1,3,0,0,1,1,1,0,0,0,2,0,0
6480bb97220be892fbfc2a36,2021,,,1,KH Pandya,M Jansen,1,1,0,0,1,0,0,0,0,0,1,0,0
6480bb9f00ef088221497043,2013,,,1,JH Kallis,YK Pathan,1,2,0,0,1,0,0,0,0,1,2,0,0
6480bb9b2a5f2fd5053534dc,2007/08,,,2,JR Hopes,SE Marsh,1,3,0,0,1,0,1,0,0,1,2,0,0
6480bb94640655c49683aee1,2018,,,1,E Lewis,SA Yadav,1,4,0,0,1,0,1,0,0,1,3,0,0
6480bb984f6c41cd28aa0353,2022,,,2,R Shepherd,Umran Malik,1,2,0,0,1,0,1,0,0,1,1,0,0
6480bb96f1eadf803ffc292c,2020/21,,,1,K Rabada,R Ashwin,1,2,0,0,0,1,1,0,0,0,1,0,0
6480bb9c963968000dfd00d1,2009/10,,,1,M Vijay,PA Patel,1,3,0,0,1,0,3,0,0,0,0,0,0
6480bb94adb227976b33d30b,2018,,,2,RV Uthappa,SP Narine,1,2,0,0,1,1,2,0,0,0,0,0,0
6480bb99fa79383bdc7df827,2022,,,1,R Dhawan,RD Chahar,1,2,0,0,1,0,1,0,0,1,1,0,0
6480bb981f136a7564719d7f,2022,,,1,K Rabada,M Shahrukh Khan,1,2,0,0,1,1,1,0,0,0,1,0,0
6480bba07b5396a7b65684d3,2013,,,1,AT Rayudu,KD Karthik,1,1,0,0,1,0,0,0,0,1,1,0,0
6480bb9eb559e2934b31c47c,2012,,,1,RA Jadeja,SB Jakati,1,5,0,0,1,0,1,0,0,1,4,0,0
6480bb965f597c872396f67c,2020/21,,,1,N Rana,Shubman Gill,1,2,0,0,1,0,1,0,0,1,1,0,0
6480bb98af25209ef756aa2c,2021,,,1,DT Christian,Shahbaz Ahmed,1,4,0,0,1,0,1,0,0,1,3,0,0
6480bba1017a98eead1ec861,2015,,,1,AM Rahane,SPD Smith,1,3,0,0,1,1,2,0,0,0,1,0,0
6480bb942fc9529eb2869c17,2018,,,1,UT Yadav,Washington Sundar,1,1,0,0,1,0,1,0,0,0,0,0,0
6480bb9eb559e2934b31c47c,2012,,,2,RG Sharma,SR Tendulkar,1,4,0,0,1,0,3,0,0,1,1,0,0
6480bb952f20835ddd6e533f,2019,,,2,JD Unadkat,K Gowtham,1,2,0,0,1,1,2,0,0,0,0,0,0
6480bba03a099a1a2e9c3dc5,2013,,,2,DPMD Jayawardene,IK Pathan,1,7,0,0,1,0,0,0,0,1,7,0,0
6480bb9b8860198955e581d8,2007/08,,,2,SE Marsh,Yuvraj Singh,1,4,0,0,1,0,1,0,0,1,3,0,0
6480bb9ba6cd609c32579bde,2009,,,1,CH Gayle,SC Ganguly,1,4,0,0,1,1,3,0,0,0,1,0,0
6480bb9c620c92d09ba1b6b9,2009,,,2,RA Jadeja,SK Trivedi,1,5,0,0,1,0,0,0,0,1,5,0,0
6480bb942fc9529eb2869c17,2018,,,1,P Negi,Washington Sundar,1,1,0,0,1,0,0,0,0,1,1,0,0
6480bb99864a94e086c8395e,2022,,,1,AK Markram,KS Williamson,1,4,0,0,1,0,2,0,0,1,2,0,0
6480bb9746dfc5c467942a84,2021,,,2,RD Chahar,SS Tiwary,1,2,0,0,1,0,1,0,0,1,1,0,0
6480bba358370ecde0231113,2016,,,2,B Kumar,NV Ojha,1,2,0,0,1,1,1,0,0,0,1,0,0
6480bb9b82dc3ec84c520466,2009,,,1,KP Pietersen,MV Boucher,1,2,0,0,1,0,1,0,0,1,1,0,0
6480bb9ca5c1d511ad78e92d,2009,,,2,G Gambhir,V Sehwag,1,3,0,0,1,1,1,0,0,0,2,0,0
6480bb9c13fa57328b17e4e2,2009/10,,,1,KD Karthik,V Sehwag,1,2,0,0,1,0,1,0,0,0,1,0,0
6480bb9541caaeddc9ddaac3,2019,,,1,AT Rayudu,SR Watson,1,12,0,0,1,1,8,0,0,0,4,0,0
6480bb96c880c7df4e055f14,2020/21,,,2,KK Nair,KL Rahul,1,5,0,0,1,0,3,0,0,1,2,0,0
6480bb964c4bea88164f168d,2020/21,,,2,R Parag,R Tewatia,1,3,0,0,1,0,2,0,0,1,1,0,0
6480bb9541caaeddc9ddaac3,2019,,,2,JC Archer,JD Unadkat,1,1,0,0,0,1,1,0,0,0,0,0,0
6480bb961ee814aee7b674ac,2020/21,,,2,GJ Maxwell,MA Agarwal,1,4,0,0,1,1,4,0,0,0,0,0,0
6480bba0a222eb875a07f5a3,2014,,,1,KD Karthik,M Vijay,1,3,0,0,1,0,1,0,0,1,2,0,0
6480bb9bed3e2a1a008f93a6,2007/08,,,2,SC Ganguly,WP Saha,1,7,0,0,1,0,1,0,0,1,6,0,0
6480bb9c8c6c106c6ffbeae4,2009/10,,,1,R Dravid,RV Uthappa,1,1,0,0,1,1,1,0,0,0,0,0,0
6480bb996c324f07ab7f763c,2023,,,2,AD Russell,RK Singh,1,2,0,0,1,1,2,0,0,0,0,0,0
6480bb9e88141830a7a309b5,2011,,,1,RG Sharma,SR Tendulkar,1,3,0,0,1,0,0,0,0,1,3,0,0
6480bb9e28b7a946a6921fa6,2011,,,2,AT Rayudu,JEC Franklin,1,2,0,0,1,0,1,0,0,1,1,0,0
6480bb96edb3270eba0af1d4,2020/21,,,2,AT Rayudu,SM Curran,1,2,0,0,1,1,1,0,0,0,1,0,0
6480bb9814efd9a91e8c911f,2021,,,2,LS Livingstone,SV Samson,1,4,0,0,1,0,0,0,0,1,4,0,0
6480bba0d2cdb40c68c4739c,2013,,,1,CH Morris,MS Dhoni,1,3,0,0,1,0,1,0,0,1,2,0,0
6480bb9f79be50f1621abcc6,2012,,,2,J Botha,STR Binny,1,2,0,0,1,1,1,0,0,0,1,0,0
6480bb9561509a2f4f139254,2019,,,2,RA Tripathi,SPD Smith,1,2,0,0,1,1,2,0,0,0,0,0,0
6480bb95f282ca61c07afe9b,2018,,,1,C de Grandhomme,M Ashwin,1,2,0,0,1,0,0,0,0,1,2,0,0
6480bb953b102c650968cba2,2019,,,1,PA Patel,SO Hetmyer,1,4,0,0,1,0,2,0,0,0,2,0,0
6480bb9e565ef5f11c5c8f55,2011,,,2,AB de Villiers,JJ van der Wath,1,4,0,0,1,0,3,0,0,1,1,0,0
6480bb9ddcbb8fbbad6614c8,2009/10,,,1,M Manhas,MF Maharoof,1,1,0,0,1,0,0,0,0,0,1,0,0
6480bb9cd0eb4289b2222e37,2009/10,,,2,M Morkel,MM Patel,1,3,0,0,1,0,1,0,0,0,2,0,0
6480bb933fdc96ee7273400e,2017,,,2,JC Buttler,N Rana,1,2,0,0,1,0,1,0,0,1,1,0,0
6480bba11c977a5d11c1aa38,2015,,,1,A Ashish Reddy,EJG Morgan,1,2,0,0,1,1,1,0,0,0,1,0,0
6480bb94a964c10b5f10ae52,2017,,,2,GJ Maxwell,WP Saha,1,3,0,0,1,0,3,0,0,0,0,0,0
6480bb98cbaaf700d226941a,2022,,,1,R Ashwin,R Parag,1,1,0,0,1,1,1,0,0,0,0,0,0
6480bb98373b1ea5035ab3da,2021,,,2,CV Varun,LH Ferguson,1,1,0,0,0,0,0,0,0,1,1,0,0
6480bb95f2e3c32afe233820,2018,,,1,B Kumar,Rashid Khan,1,2,0,0,1,0,0,0,0,1,2,0,0
6480bb933fdc96ee7273400e,2017,,,2,HH Pandya,MJ McClenaghan,1,1,0,0,0,0,1,0,0,0,0,0,0
6480bba2965d1d15aa6f723e,2016,,,2,KD Karthik,SK Raina,1,4,0,0,1,1,1,0,0,0,3,0,0
6480bb970d7cbd85b6ada680,2021,,,1,KL Rahul,M Shahrukh Khan,1,4,0,0,1,1,1,0,0,0,3,0,0
6480bb966539f85263cb6429,2019,,,2,J Suchith,SS Iyer,1,2,0,0,1,1,1,0,0,0,1,0,0
6480bba000b91f6c5cf57fdb,2013,,,1,CL White,GH Vihari,1,4,0,0,1,0,1,0,0,1,3,0,0
6480bb993e44f97eccb361fe,2023,,,1,KL Rahul,N Pooran,1,1,0,0,1,0,0,0,0,0,1,0,0
6480bba2704d23da78c3eb15,2016,,,2,M Vijay,MP Stoinis,1,4,0,0,1,1,1,0,0,0,3,0,0
6480bb9d59f2ded94f736145,2011,,,1,R Vinay Kumar,S Sreesanth,1,4,0,0,1,1,3,0,0,0,1,0,0
6480bb9f7258f976eb8fe943,2012,,,2,M Vijay,MEK Hussey,1,6,0,0,1,0,5,0,0,1,1,0,0
6480bb9c21492b9a562c6f46,2009/10,,,1,AC Voges,P Dogra,1,2,0,0,1,1,1,0,0,0,1,0,0
6480bb99c6aa5989a16174d1,2023,,,2,JC Buttler,YBK Jaiswal,1,4,0,0,1,0,2,0,0,1,2,0,0
6480bba296f606ef91305124,2016,,,1,B Kumar,KV Sharma,1,1,0,0,0,0,1,0,0,0,0,0,0
6480bb9a24adc8d916dfe2db,2023,,,1,MD Shanaka,Mohammed Shami,1,2,0,0,1,1,1,0,0,0,1,0,0
6480bb9d0f6794fbf429449b,2011,,,1,Iqbal Abdulla,L Balaji,1,1,0,0,0,0,0,0,0,1,1,0,0
6480bba1a6882d256a926a8b,2014,,,1,BCJ Cutting,SV Samson,1,3,0,0,1,1,1,0,0,0,2,0,0
6480bb9c58b62383739c022e,2009,,,1,Harbhajan Singh,SL Malinga,1,2,0,0,1,1,1,0,0,0,1,0,0
6480bb9e05571c1a4c163ef1,2012,,,1,MS Dhoni,SK Raina,1,2,0,0,1,1,1,0,0,0,1,0,0
6480bb9c2778066dafd78a71,2009/10,,,1,JA Morkel,M Muralitharan,1,2,0,0,1,0,0,0,0,1,2,0,0
6480bba24f6e6e2c212c7469,2016,,,2,MA Agarwal,SS Iyer,1,4,0,0,1,1,1,0,0,0,3,0,0
6480bb95cf9d446747bd74fe,2019,,,1,KMA Paul,S Dhawan,1,5,0,0,1,0,4,0,0,1,1,0,0
6480bb9d967f5a4cfbd8c74d,2011,,,1,M Morkel,UT Yadav,1,1,0,0,0,0,0,0,0,1,1,0,0
6480bb9d362f72789dcdc5a7,2009/10,,,2,DA Warner,V Sehwag,1,3,0,0,1,0,2,0,0,1,1,0,0
6480bb932f8447acd7840076,2017,,,2,DS Kulkarni,P Kumar,1,2,0,0,1,0,1,0,0,1,1,0,0
6480bb978c66ea3d9c85132d,2020/21,,,2,S Nadeem,SP Goswami,1,1,0,0,1,0,0,0,0,0,1,0,0
6480bba19cc161a3fb8a8795,2014,,,1,GJ Bailey,GJ Maxwell,1,2,0,0,1,1,1,0,0,0,1,0,0
6480bb9623a26d3fbfe59f25,2020/21,,,2,AJ Finch,JR Philippe,1,5,0,0,1,0,2,0,0,0,3,0,0
6480bb9d76ba2d9dd45c74a8,2011,,,2,M Muralitharan,RP Singh,1,1,0,0,1,0,0,0,0,1,1,0,0
6480bb95960e393c939ab44c,2018,,,2,BCJ Cutting,HH Pandya,1,6,0,0,1,1,3,0,0,0,3,0,0
6480bb97aad3147696268239,2021,,,2,JDS Neesham,KA Pollard,1,2,0,0,1,0,1,0,0,1,1,0,0
6480bb98373b1ea5035ab3da,2021,,,2,EJG Morgan,Shakib Al Hasan,1,1,0,0,1,0,0,0,0,0,1,0,0
6480bba286cca051953c976a,2015,,,2,Karanveer Singh,Sandeep Sharma,1,5,0,0,0,0,1,0,0,1,4,0,0
6480bb98aae066234fd8f11e,2022,,,1,DA Miller,Rashid Khan,1,1,0,0,0,0,0,0,0,0,1,0,0
6480bb993e61058e682e2ff4,2023,,,1,R Tewatia,Rashid Khan,1,1,0,0,1,0,0,0,0,1,1,0,0
6480bb9746dfc5c467942a84,2021,,,1,AT Rayudu,RD Gaikwad,1,3,0,0,1,0,3,0,0,0,0,0,0
6480bb9ade063258af41163b,2007/08,,,2,AC Gilchrist,VVS Laxman,1,7,0,0,1,1,1,0,0,0,6,0,0
6480bb99773871f8e2ddc4b1,2022,,,1,R Shepherd,Umran Malik,1,1,0,0,0,0,0,0,0,0,1,0,0
6480bb99b0fa4d217ed7f255,2023,,,1,MK Pandey,SN Khan,1,2,0,0,1,1,1,0,0,0,1,0,0
6480bb98de3641699db2c5a1,2021,,,2,S Dhawan,SO Hetmyer,1,5,0,0,1,0,4,0,0,1,1,0,0
6480bb9f90a251567178de39,2012,,,2,CL White,PA Reddy,1,1,0,0,0,1,1,0,0,0,0,0,0
6480bb9a9dc58f49d783faa9,2023,,,1,GJ Maxwell,MK Lomror,1,2,0,0,1,0,0,0,0,1,2,0,0
6480bba1c67d2c9c1279a4c8,2014,,,1,CH Gayle,V Kohli,1,5,0,0,1,0,0,0,0,0,5,0,0
6480bb9a4de9fe3e7319ce39,2007/08,,,1,R Dravid,S Chanderpaul,1,2,0,0,1,0,1,0,0,1,1,0,0
6480bba179195d83fa7fbfbb,2014,,,2,MK Pandey,Shakib Al Hasan,1,1,0,0,1,0,0,0,0,0,1,0,0
6480bb9da9ca2f2d3738d79e,2011,,,2,M Manhas,TD Paine,1,2,0,0,1,0,1,0,0,0,1,0,0
6480bb9b0e32875998e9bfdc,2009,,,1,M Manhas,PJ Sangwan,1,1,0,0,0,0,0,0,0,1,1,0,0
6480bba000b91f6c5cf57fdb,2013,,,1,GH Vihari,S Dhawan,1,5,0,0,1,0,3,0,0,0,2,0,0
6480bba136257b71aa9952cf,2014,,,1,DR Smith,F du Plessis,1,2,0,0,1,1,1,0,0,0,1,0,0
6480bb9d109617dfa089c2c6,2011,,,1,AL Menaria,SR Watson,1,2,0,0,1,0,1,0,0,1,1,0,0
6480bb9d918bd358d046889d,2011,,,2,SS Tiwary,V Kohli,1,2,0,0,1,0,0,0,0,1,2,0,0
6480bba3b818a7cff6fe4f89,2016,,,2,JO Holder,SP Narine,1,3,0,0,1,0,1,0,0,1,2,0,0
6480bb9ab49fc97bbb30576f,2023,,,1,KD Karthik,V Kohli,1,2,0,0,1,0,1,0,0,1,1,0,0
6480bb9a61edc0c77bc4bc86,2007/08,,,2,MS Dhoni,SK Raina,1,4,0,0,1,0,2,0,0,1,2,0,0
6480bb93ff8d1f4cd07859ce,2017,,,2,RR Pant,SV Samson,1,3,0,0,1,0,1,0,0,1,2,0,0
6480bb9f7bae5ad85c4473ba,2012,,,1,DR Smith,RG Sharma,1,3,0,0,1,1,2,0,0,0,1,0,0
6480bba2563745309ee2bdfb,2016,,,1,KD Karthik,RA Jadeja,1,2,0,0,1,0,1,0,0,1,1,0,0
6480bb9e300070746cc2eb67,2011,,,2,CH Gayle,MA Agarwal,1,4,0,0,1,0,3,0,0,1,1,0,0
6480bb9746dfc5c467942a84,2021,,,1,F du Plessis,RD Gaikwad,1,5,0,0,1,0,3,0,0,0,2,0,0
6480bb978c66ea3d9c85132d,2020/21,,,2,KS Williamson,MK Pandey,1,2,0,0,1,1,1,0,0,0,1,0,0
6480bb9814efd9a91e8c911f,2021,,,2,R Tewatia,S Dube,1,3,0,0,1,1,2,0,0,0,1,0,0
6480bba0d4b2f9be71a5f230,2014,,,1,G Gambhir,JH Kallis,1,1,0,0,1,0,0,0,0,0,1,0,0
6480bba09d6b23c8722fd208,2013,,,2,AT Rayudu,Harbhajan Singh,1,6,0,0,1,1,2,0,0,0,4,0,0
6480bba273adb498d96b27a9,2016,,,1,Q de Kock,SS Iyer,1,3,0,0,1,1,2,0,0,0,1,0,0
6480bb9a1032ce724214f6dd,2007/08,,,2,GD McGrath,VY Mahesh,1,4,0,0,1,0,2,0,0,1,2,0,0
6480bb99b0fa4d217ed7f255,2023,,,1,DA Warner,PD Salt,1,3,0,0,1,1,2,0,0,0,1,0,0
6480bb9b0e32875998e9bfdc,2009,,,2,GC Smith,SK Warne,1,3,0,0,1,1,1,0,0,0,2,0,0
6480bba0e52e9733fc6d9937,2013,,,2,DA Miller,MS Gony,1,4,0,0,1,1,1,0,0,0,3,0,0
6480bba048fb3d33ea0711e7,2013,,,1,AC Gilchrist,Mandeep Singh,1,5,0,0,1,1,3,0,0,0,2,0,0
6480bb95f45dffe4751efc46,2019,,,2,Mandeep Singh,SM Curran,1,2,0,0,0,1,1,0,0,0,1,0,0
6480bb9e05381e16815803e9,2011,,,2,AA Jhunjhunwala,CJ Ferguson,1,3,0,0,1,0,3,0,0,0,0,0,0
6480bb9399a527d39bc17dad,2017,,,1,BB McCullum,DR Smith,1,8,0,0,1,0,4,0,0,1,4,0,0
6480bb961ee814aee7b674ac,2020/21,,,1,MP Stoinis,SS Iyer,1,1,0,0,1,0,0,0,0,0,1,0,0
6480bb9c442caaabe9eb2275,2009,,,2,AM Rahane,DS Kulkarni,1,3,0,0,1,0,1,0,0,0,2,0,0
6480bba21bbf76a62abea528,2016,,,1,R Ashwin,R Bhatia,1,2,0,0,1,0,1,0,0,1,1,0,0
6480bb9fc28e897b3c53f359,2012,,,2,DS Kulkarni,RP Singh,1,2,0,0,0,0,1,0,0,1,1,0,0
6480bb97fb920d483d0da2af,2020/21,,,1,Abdul Samad,MK Pandey,1,3,0,0,1,0,1,0,0,1,2,0,0
6480bb9c7a11e1cbeea46b0e,2009/10,,,1,Harbhajan Singh,R Sathish,1,2,0,0,1,0,1,0,0,1,1,0,0
6480bb945460b25d997060fb,2018,,,2,S Nadeem,TA Boult,1,3,0,0,1,1,1,0,0,0,2,0,0
6480bb9d54ae15d3d0ed9e5e,2011,,,2,MV Boucher,R Bhatia,1,2,0,0,1,0,1,0,0,1,1,0,0
6480bb9ca181f55cb21526f5,2009/10,,,1,DJ Bravo,SR Tendulkar,1,2,0,0,1,1,1,0,0,0,1,0,0
6480bb9a8cf29e28434bb1d5,2023,,,1,AR Patel,PK Garg,1,5,0,0,1,1,4,0,0,0,1,0,0
6480bb9c07d77f83fb139c41,2009,,,2,KC Sangakkara,SM Katich,1,2,0,0,1,1,1,0,0,0,1,0,0
6480bb941ab79050c3c90ee5,2018,,,1,KD Karthik,RV Uthappa,1,1,0,0,1,0,0,0,0,0,1,0,0
6480bb96ebf33df82879ad4c,2020/21,,,1,DA Warner,JM Bairstow,1,4,0,0,1,1,1,0,0,0,3,0,0
6480bb9c3b082d71291a593c,2009,,,2,S Tyagi,SB Jakati,1,1,0,0,1,0,0,0,0,1,1,0,0
6480bb9341152e168005ccc9,2017,,,2,BA Stokes,MK Tiwary,1,2,0,0,1,1,2,0,0,0,0,0,0
6480bb95f214d4f82ab97ee5,2018,,,1,BA Stokes,STR Binny,1,4,0,0,1,0,0,0,0,1,4,0,0
6480bba03ef1ed797291b091,2013,,,1,KD Karthik,RG Sharma,1,2,0,0,1,0,1,0,0,1,1,0,0
6480bb9dd4e6757f7ded95e9,2009/10,,,1,DPMD Jayawardene,SE Marsh,1,5,0,0,1,0,4,0,0,0,1,0,0
6480bb951677500061c85592,2019,,,2,B Kumar,S Kaul,1,3,0,0,1,1,3,0,0,0,0,0,0
6480bba000b91f6c5cf57fdb,2013,,,2,PV Tambe,SK Trivedi,1,2,0,0,0,1,1,0,0,0,1,0,0
6480bb9384cbae8edee3707f,2017,,,2,CJ Anderson,KK Nair,1,3,0,0,1,0,3,0,0,0,0,0,0
6480bb97e5be965d3c00760e,2021,,,1,AB de Villiers,GJ Maxwell,1,3,0,0,1,0,1,0,0,1,2,0,0
6480bba255079696d5cfa453,2015,,,2,GJ Maxwell,WP Saha,1,5,0,0,1,1,5,0,0,0,0,0,0
6480bba0b2a9d600114a43d7,2013,,,1,AD Mathews,Yuvraj Singh,1,3,0,0,1,0,2,0,0,1,1,0,0
6480bb9efe3f9991539e7f6c,2012,,,2,MN Samuels,RV Uthappa,1,3,0,0,1,0,1,0,0,1,2,0,0
6480bb97b97c36ac8be3582f,2021,,,2,Abdul Samad,V Shankar,1,4,0,0,1,0,2,0,0,1,2,0,0
6480bba273adb498d96b27a9,2016,,,2,RV Uthappa,UT Yadav,1,2,0,0,1,0,1,0,0,1,1,0,0
6480bb99f649ea7a6d79892f,2023,,,1,RD Chahar,S Dhawan,1,9,0,0,1,0,8,0,0,1,1,0,0
6480bb9800ba03eb1f9437d2,2022,,,1,Shashank Singh,Washington Sundar,1,1,0,0,1,0,0,0,0,0,1,0,0
6480bb99315aee6cd9d56504,2023,,,1,F du Plessis,KD Karthik,1,1,0,0,0,0,0,0,0,1,1,0,0
6480bba358370ecde0231113,2016,,,2,B Kumar,BB Sran,1,2,0,0,1,0,1,0,0,1,1,0,0
6480bb9fa1611443840261b7,2012,,,2,HV Patel,M Muralitharan,1,2,0,0,1,1,1,0,0,0,1,0,0
6480bb9ba9d43057d652a5fe,2009,,,2,SR Tendulkar,ST Jayasuriya,1,1,0,0,1,0,0,0,0,0,1,0,0
6480bb9bb7a4f1e16df25c8e,2009,,,1,JDP Oram,ML Hayden,1,3,0,0,1,1,2,0,0,0,1,0,0
6480bba1a6882d256a926a8b,2014,,,1,STR Binny,SV Samson,1,4,0,0,1,0,2,0,0,1,2,0,0
6480bb9940bd3bf36dd4897f,2023,,,2,A Badoni,DJ Hooda,1,1,0,0,1,0,0,0,0,1,1,0,0
6480bb9bee2e48d9c41b1e23,2009,,,2,HH Gibbs,VVS Laxman,1,7,0,0,1,0,2,0,0,0,5,0,0
6480bb96c40b697b63d08717,2019,,,1,B Kumar,Basil Thampi,1,1,0,0,0,0,0,0,0,1,1,0,0
6480bb9f895e5780080c8059,2012,,,1,Gurkeerat Singh,PP Chawla,1,2,0,0,1,0,1,0,0,1,1,0,0
6480bb9c8f3ef1685cdf4017,2009,,,2,SC Ganguly,WP Saha,1,3,0,0,1,1,2,0,0,0,1,0,0
6480bb948211fe47e65f2e77,2018,,,2,HH Pandya,MJ McClenaghan,1,3,0,0,1,1,1,0,0,0,2,0,0
6480bb97ce8cbd211049f957,2021,,,1,J Yadav,KA Pollard,1,1,0,0,0,0,0,0,0,1,1,0,0
6480bb9ed74d222a3da56dfa,2012,,,1,CH Gayle,V Kohli,1,11,0,0,1,1,7,0,0,0,4,0,0
6480bba33195e5ebac1da82a,2016,,,1,Harbhajan Singh,TG Southee,1,3,0,0,1,0,0,0,0,1,3,0,0
6480bb9f60d58ee39ba047b9,2013,,,1,KM Jadhav,M Morkel,1,2,0,0,1,1,1,0,0,0,1,0,0
6480bba373508e4f3f4be6c0,2016,,,2,MS Dhoni,R Ashwin,1,8,0,0,0,1,4,0,0,0,4,0,0
6480bb9800ba03eb1f9437d2,2022,,,2,A Manohar,R Tewatia,1,1,0,0,1,0,1,0,0,0,0,0,0
6480bb9bf2869505c9393b7d,2009,,,2,BB McCullum,CH Gayle,1,7,0,0,1,1,3,0,0,0,4,0,0
6480bb94283e3f5a1a95839f,2018,,,1,DJ Bravo,SK Raina,1,2,0,0,1,0,1,0,0,1,1,0,0
6480bb97af44a48533f08540,2020/21,,,1,KL Rahul,Mandeep Singh,1,6,0,0,1,1,5,0,0,0,1,0,0
6480bb99315aee6cd9d56504,2023,,,2,Avesh Khan,Ravi Bishnoi,1,1,0,0,0,0,1,0,0,0,0,0,0
6480bb9f03dd3a09740f0bd0,2013,,,2,G Gambhir,JH Kallis,1,1,0,0,1,0,0,0,0,0,1,0,0
6480bba2557febf92f9f79ab,2015,,,2,G Gambhir,RV Uthappa,1,2,0,0,1,0,1,0,0,1,1,0,0
6480bb9a8053274c083224d9,2023,,,1,N Wadhera,RG Sharma,1,3,0,0,1,1,1,0,0,0,2,0,0
6480bb96593f4f87a2c294bc,2020/21,,,1,JR Philippe,S Dube,1,3,0,0,1,1,2,0,0,0,1,0,0
6480bb9b9d7aa6d8e47576d7,2007/08,,,2,Kamran Akmal,SR Watson,1,3,0,0,1,0,1,0,0,1,2,0,0
6480bb9f36ad55c3c7fd6548,2012,,,1,Harbhajan Singh,RG Sharma,1,2,0,0,1,1,2,0,0,0,0,0,0
6480bba273adb498d96b27a9,2016,,,2,JO Holder,RV Uthappa,1,2,0,0,1,0,1,0,0,1,1,0,0
6480bb9c58b62383739c022e,2009,,,2,NV Ojha,RA Jadeja,1,4,0,0,1,0,2,0,0,1,2,0,0
6480bb9b2ca4a7b325526f1f,2009,,,2,LA Carseldine,SA Asnodkar,1,1,0,0,1,0,0,0,0,0,1,0,0
6480bb94605dacb25c83dc35,2018,,,2,G Gambhir,SS Iyer,1,4,0,0,1,1,4,0,0,0,0,0,0
6480bb9f87652064dab6c573,2013,,,2,MK Tiwary,YK Pathan,1,7,0,0,1,0,1,0,0,0,6,0,0
6480bb9c07d77f83fb139c41,2009,,,2,DPMD Jayawardene,Yuvraj Singh,1,2,0,0,1,1,1,0,0,0,1,0,0
6480bb9a51ee1ef33a5b2dbb,2007/08,,,2,DB Das,Mohammad Hafeez,1,2,0,0,1,0,0,0,0,1,2,0,0
6480bb9d182be5b0fbe5a4e2,2011,,,2,Harbhajan Singh,R Sathish,1,2,0,0,1,1,1,0,0,0,1,0,0
6480bba210201df0f7975000,2016,,,2,HV Patel,KW Richardson,1,1,0,0,0,0,0,0,0,1,1,0,0
6480bb9f3ca20834ecc7607a,2012,,,1,G Gambhir,MS Bisla,1,3,0,0,1,0,2,0,0,1,1,0,0
6480bba1d3b4ddc36050e3f3,2014,,,1,Karanveer Singh,MG Johnson,1,5,0,0,0,1,1,0,0,0,4,0,0
6480bba177ab201442a0e3c8,2015,,,1,AN Ahmed,YS Chahal,1,2,0,0,1,0,1,0,0,1,1,0,0
6480bb97aabcd4374e076d04,2021,,,2,AT Rayudu,F du Plessis,1,2,0,0,1,1,1,0,0,0,1,0,0
6480bb969d80bbba2884b855,2020/21,,,1,Gurkeerat Singh,I Udana,1,2,0,0,1,1,1,0,0,0,1,0,0
6480bb954da239b357833c8a,2018,,,1,RR Pant,V Shankar,1,4,0,0,1,0,1,0,0,1,3,0,0
6480bb99358a21ba3487db81,2023,,,1,Abdul Samad,Umran Malik,1,1,0,0,1,1,1,0,0,0,0,0,0
6480bb9ce93a7b4315d8fa30,2009,,,1,A Symonds,DR Smith,1,2,0,0,1,0,1,0,0,1,1,0,0
6480bb9813fa79617f791851,2022,,,2,DJ Willey,V Kohli,1,4,0,0,1,0,1,0,0,1,3,0,0
6480bba33195e5ebac1da82a,2016,,,2,GJ Maxwell,M Vijay,1,1,0,0,1,0,1,0,0,0,0,0,0
6480bba0dcd1149b9b0b501f,2013,,,1,K Upadhyay,Parvez Rasool,1,2,0,0,1,1,1,0,0,0,1,0,0
6480bb9618b5973b98c0ba18,2019,,,2,C de Grandhomme,Washington Sundar,1,1,0,0,1,0,0,0,0,0,1,0,0
6480bb9d22388e966342dba8,2009/10,,,2,SL Malinga,Z Khan,1,3,0,0,1,0,0,0,0,1,3,0,0
6480bb984f0f3dc0df6d4531,2022,,,2,DA Miller,Rashid Khan,1,3,0,0,0,0,2,0,0,1,1,0,0
6480bb96b56e8d513b451da1,2020/21,,,1,N Rana,Shubman Gill,0,1,0,0,1,0,1,0,0,0,0,0,0
6480bba0b46cf5430edef3f5,2014,,,1,Harbhajan Singh,KA Pollard,0,2,0,0,1,0,2,0,0,0,0,0,0
6480bb953aab41e7ed166b9d,2019,,,2,HH Pandya,Yuvraj Singh,0,3,0,0,1,0,2,0,0,0,1,0,0
6480bb9c58b62383739c022e,2009,,,1,ST Jayasuriya,YV Takawale,0,2,0,0,1,0,0,0,0,0,2,0,0
6480bb9d6ea22feab98beb5b,2011,,,2,LRPL Taylor,STR Binny,0,1,0,0,1,0,1,0,0,0,0,0,0
6480bba1587a54176a9badf4,2014,,,2,DJG Sammy,KV Sharma,0,1,0,0,1,0,1,0,0,0,0,0,0
6480bb9ccba48a6bb44ccc21,2009,,,1,ML Hayden,PA Patel,0,1,0,0,1,0,0,0,0,0,1,0,0
6480bb9affabe4960a987464,2007/08,,,1,B Akhil,CL White,0,3,0,0,1,0,2,0,0,0,1,0,0
6480bb9fa3a890f94f179477,2013,,,1,PP Chawla,RJ Harris,0,3,0,0,1,0,3,0,0,0,0,0,0
6480bba358370ecde0231113,2016,,,1,AM Rahane,UT Khawaja,0,3,0,0,1,0,3,0,0,0,0,0,0
6480bb960d5042aa46b7776b,2020/21,,,1,Ishan Kishan,KH Pandya,0,3,0,0,1,0,0,0,0,0,3,0,0
6480bb9bc80883a975281815,2009,,,2,AD Mascarenhas,YK Pathan,0,1,0,0,1,0,1,0,0,0,0,0,0
6480bb9d54ae15d3d0ed9e5e,2011,,,2,EJG Morgan,G Gambhir,0,1,0,0,1,0,0,0,0,0,1,0,0
6480bb9d61e9b86b0f0aae49,2009/10,,,2,JH Kallis,MK Pandey,0,1,0,0,1,0,0,0,0,0,1,0,0
6480bba107ba9f7f041862c1,2014,,,2,R Vinay Kumar,YK Pathan,0,1,0,0,1,0,0,0,0,0,1,0,0
6480bb9ba9d43057d652a5fe,2009,,,1,KC Sangakkara,RS Bopara,0,4,0,0,1,0,1,0,0,0,3,0,0
6480bb9c71030f4c6f018f55,2009,,,1,HH Gibbs,TL Suman,0,1,0,0,1,0,0,0,0,0,1,0,0
6480bba3b830360cf7031278,2016,,,1,KA Pollard,KH Pandya,0,2,0,0,1,0,0,0,0,0,2,0,0
6480bba21bbf76a62abea528,2016,,,1,AM Rahane,KP Pietersen,0,1,0,0,1,0,0,0,0,0,1,0,0
6480bb94dcc956fa4ca06b92,2018,,,2,AD Russell,CA Lynn,0,1,0,0,1,0,1,0,0,0,0,0,0
6480bb9e591b94e62772e66a,2012,,,2,AC Blizzard,SR Tendulkar,0,3,0,0,1,0,3,0,0,0,0,0,0
6480bb9fa1611443840261b7,2012,,,1,A Ashish Reddy,DW Steyn,0,1,0,0,1,0,1,0,0,0,0,0,0
6480bb9ef18c54e7aafdd223,2012,,,1,Shakib Al Hasan,YK Pathan,0,3,0,0,1,0,0,0,0,0,3,0,0
6480bb99d2bd76016d47896d,2023,,,2,Kuldeep Yadav,Mukesh Kumar,0,1,0,0,0,0,0,0,0,0,1,0,0
6480bb94cfe5aeb50e36aef3,2017,,,1,PJ Sangwan,RA Jadeja,0,1,0,0,1,0,1,0,0,0,0,0,0
6480bb968211e65fcbffa192,2019,,,1,AB de Villiers,MP Stoinis,0,1,0,0,1,0,1,0,0,0,0,0,0
6480bb9b69f8ace7659e486d,2009,,,2,M Rawat,MM Patel,0,1,0,0,1,0,0,0,0,0,1,0,0
6480bba0a4e7c61a5656729e,2014,,,2,AB de Villiers,PA Patel,0,5,0,0,1,0,0,0,0,0,5,0,0
6480bb996c324f07ab7f763c,2023,,,2,RK Singh,SN Thakur,0,1,0,0,1,0,0,0,0,0,1,0,0
6480bb937dc0a09df8f7aeee,2017,,,2,AR Patel,WP Saha,0,1,0,0,1,0,0,0,0,0,1,0,0
6480bb94640655c49683aee1,2018,,,1,KA Pollard,MJ McClenaghan,0,1,0,0,1,0,0,0,0,0,1,0,0
6480bb9940bd3bf36dd4897f,2023,,,2,PN Mankad,Ravi Bishnoi,0,1,0,0,0,0,0,0,0,0,1,0,0
6480bb9bee2e48d9c41b1e23,2009,,,2,Shoaib Ahmed,TL Suman,0,1,0,0,1,0,0,0,0,0,1,0,0
6480bb995193664eda3e9e10,2022,,,1,PJ Cummins,RK Singh,0,2,0,0,1,0,2,0,0,0,0,0,0
6480bb99409885bcc7b67109,2023,,,2,AT Rayudu,S Dube,0,2,0,0,1,0,2,0,0,0,0,0,0
6480bba0ffae8617ee64bd19,2013,,,2,UBT Chand,V Sehwag,0,2,0,0,1,0,0,0,0,0,2,0,0
6480bb966f48b8ee03e6dff5,2020/21,,,1,F du Plessis,RD Gaikwad,0,5,0,0,1,0,0,0,0,0,5,0,0
6480bb96a467817b9b68ca94,2020/21,,,1,DJ Bravo,RA Jadeja,0,1,0,0,1,0,1,0,0,0,0,0,0
6480bb96902b7c96b94f406a,2019,,,1,RK Singh,SP Narine,0,1,0,0,1,0,1,0,0,0,0,0,0
6480bb9e713e850d3dd0cba9,2012,,,2,BB McCullum,G Gambhir,0,1,0,0,1,0,0,0,0,0,1,0,0
6480bba1b8e3071cc513602a,2014,,,2,IK Pathan,KV Sharma,0,1,0,0,1,0,0,0,0,0,1,0,0
6480bba328f7475f4b87d3ff,2016,,,1,BB McCullum,DR Smith,0,1,0,0,1,0,0,0,0,0,1,0,0
6480bb962831291a868490e7,2020/21,,,2,AM Rahane,S Dhawan,0,1,0,0,1,0,1,0,0,0,0,0,0
6480bb9d918bd358d046889d,2011,,,2,A Mithun,DL Vettori,0,2,0,0,1,0,2,0,0,0,0,0,0
6480bb9ee779ef1e445d0506,2012,,,1,AT Rayudu,RE Levi,0,2,0,0,1,0,0,0,0,0,2,0,0
6480bb97f56e9d700b27a098,2021,,,1,D Padikkal,RM Patidar,0,1,0,0,1,0,1,0,0,0,0,0,0
6480bb99350726d00af209bf,2022,,,2,Kartik Tyagi,Shashank Singh,0,1,0,0,1,0,1,0,0,0,0,0,0
6480bb94988cb8c136ec7e46,2018,,,1,AJ Finch,Yuvraj Singh,0,1,0,0,1,0,1,0,0,0,0,0,0
6480bb966c197bad273f91f1,2020/21,,,1,Ishan Kishan,SA Yadav,0,1,0,0,1,0,1,0,0,0,0,0,0
6480bb9a1032ce724214f6dd,2007/08,,,2,R Bhatia,VY Mahesh,0,1,0,0,1,0,1,0,0,0,0,0,0
6480bb9d6919e7181371271f,2011,,,2,AM Nayar,KD Karthik,0,5,0,0,1,0,2,0,0,0,3,0,0
6480bb9baa08d0494c0b8dc3,2007/08,,,2,P Kumar,R Dravid,0,1,0,0,1,0,1,0,0,0,0,0,0
6480bb9ee7a29c9b96ed61e5,2011,,,1,PP Chawla,RJ Harris,0,1,0,0,1,0,0,0,0,0,1,0,0
6480bb99c6aa5989a16174d1,2023,,,1,F du Plessis,V Kohli,0,1,0,0,1,0,0,0,0,0,1,0,0
6480bb985efffbcafdef9f19,2021,,,2,AK Markram,FA Allen,0,1,0,0,0,0,0,0,0,0,1,0,0
6480bb962831291a868490e7,2020/21,,,2,MP Stoinis,SS Iyer,0,1,0,0,1,0,0,0,0,0,1,0,0
6480bb9bc80883a975281815,2009,,,2,RA Jadeja,SK Warne,0,1,0,0,1,0,1,0,0,0,0,0,0
6480bba1d9f266a28a109f29,2015,,,2,AD Mathews,MA Agarwal,0,1,0,0,1,0,0,0,0,0,1,0,0
6480bb9ddfb0f2f6f8e813e5,2011,,,2,NV Ojha,V Sehwag,0,3,0,0,1,0,3,0,0,0,0,0,0
6480bb95c701f5c8388f7f88,2018,,,1,AR Patel,R Ashwin,0,1,0,0,1,0,0,0,0,0,1,0,0
6480bb9fd4a1af6234c9e57c,2012,,,2,AM Nayar,P Dogra,0,1,0,0,1,0,0,0,0,0,1,0,0
6480bb9498a98d52f9285b52,2017,,,1,A Nehra,S Kaul,0,2,0,0,0,0,0,0,0,0,2,0,0
6480bb9d59f2ded94f736145,2011,,,2,DT Christian,KC Sangakkara,0,1,0,0,1,0,0,0,0,0,1,0,0
6480bb94b9d954a885cc531b,2017,,,2,DT Christian,SPD Smith,0,1,0,0,1,0,0,0,0,0,1,0,0
6480bb9871b0ff7264721cbc,2022,,,1,DA Warner,Mandeep Singh,0,5,0,0,1,0,0,0,0,0,5,0,0
6480bb954714437843ab3647,2019,,,2,Abhishek Sharma,Rashid Khan,0,1,0,0,1,0,0,0,0,0,1,0,0
6480bb9bcc2f6123673672d0,2007/08,,,1,MK Tiwary,TM Dilshan,0,1,0,0,1,0,0,0,0,0,1,0,0
6480bb94457bfc7687322f80,2017,,,1,AB de Villiers,TM Head,0,1,0,0,1,0,0,0,0,0,1,0,0
6480bb97fb920d483d0da2af,2020/21,,,1,Abdul Samad,JM Bairstow,0,3,0,0,1,0,0,0,0,0,3,0,0
6480bb9c761c43b2dfb9767d,2009,,,1,LA Pomersbach,Yuvraj Singh,0,3,0,0,1,0,0,0,0,0,3,0,0
6480bb98a95cb1650c81c926,2022,,,1,JC Buttler,SV Samson,0,1,0,0,1,0,1,0,0,0,0,0,0
6480bba1ebb63d1bd8c60b9d,2014,,,2,JD Unadkat,S Nadeem,0,1,0,0,1,0,1,0,0,0,0,0,0
6480bb9e9162dceff15dc334,2011,,,1,DPMD Jayawardene,PA Patel,0,1,0,0,1,0,0,0,0,0,1,0,0
6480bb94457bfc7687322f80,2017,,,1,AB de Villiers,CH Gayle,0,2,0,0,1,0,1,0,0,0,1,0,0
6480bb9a1a3e8cef5633f4e6,2023,,,1,AK Markram,HC Brook,0,1,0,0,1,0,0,0,0,0,1,0,0
6480bb9c58b62383739c022e,2009,,,1,C Nanda,Harbhajan Singh,0,1,0,0,1,0,1,0,0,0,0,0,0
6480bb96ec01f8fb3504bc36,2020/21,,,1,RV Uthappa,SV Samson,0,6,0,0,1,0,5,0,0,0,1,0,0
6480bb9f60d58ee39ba047b9,2013,,,1,DA Warner,V Sehwag,0,4,0,0,1,0,4,0,0,0,0,0,0
6480bb9dd89d4266d59a4592,2011,,,2,AC Gilchrist,PC Valthaty,0,1,0,0,1,0,1,0,0,0,0,0,0
6480bba1f5d65d6146678a7f,2015,,,2,G Gambhir,MK Pandey,0,3,0,0,1,0,0,0,0,0,3,0,0
6480bb9da9ca2f2d3738d79e,2011,,,2,AC Thomas,R Sharma,0,4,0,0,1,0,2,0,0,0,2,0,0
6480bb9e2c96ab2b87d9466a,2011,,,2,NV Ojha,V Sehwag,0,6,0,0,1,0,5,0,0,0,1,0,0
6480bb998454ba791a8fdbf8,2023,,,1,Abishek Porel,Kuldeep Yadav,0,1,0,0,1,0,0,0,0,0,1,0,0
6480bb98d2cd0fa3ed0ffc21,2022,,,1,Arshdeep Singh,OF Smith,0,1,0,0,1,0,1,0,0,0,0,0,0
6480bb963d224b9be17f2c75,2019,,,1,Rashid Khan,Shakib Al Hasan,0,2,0,0,1,0,1,0,0,0,1,0,0
6480bb9e32ed1b9e077b8c11,2011,,,1,AM Rahane,R Dravid,0,2,0,0,1,0,0,0,0,0,2,0,0
6480bb9edb0554f003f5428a,2012,,,2,AB de Villiers,CH Gayle,0,1,0,0,1,0,1,0,0,0,0,0,0
6480bb9a40966b9b90fcdf2e,2023,,,1,M Shahrukh Khan,SM Curran,0,3,0,0,1,0,1,0,0,0,2,0,0
6480bba0c9e6d590ed35eb56,2014,,,2,CJ Anderson,Harbhajan Singh,0,1,0,0,1,0,1,0,0,0,0,0,0
6480bb9d80536875f41bc605,2011,,,1,R Sharma,RV Uthappa,0,1,0,0,0,0,1,0,0,0,0,0,0
6480bb9692a7f0d52bd43127,2019,,,2,GC Viljoen,Mandeep Singh,0,1,0,0,1,0,1,0,0,0,0,0,0
6480bb9c37b72d7a51019794,2009/10,,,1,PP Ojha,RG Sharma,0,1,0,0,1,0,0,0,0,0,1,0,0
6480bb942fc9529eb2869c17,2018,,,1,C de Grandhomme,P Negi,0,1,0,0,1,0,0,0,0,0,1,0,0
6480bb9e19dd5297ba8ca5f7,2011,,,1,RV Uthappa,Yuvraj Singh,0,6,0,0,1,0,4,0,0,0,2,0,0
6480bb9f955d5c84cde78f58,2012,,,2,RV Uthappa,SC Ganguly,0,1,0,0,1,0,0,0,0,0,1,0,0
6480bba1743abcb135a6a4c7,2015,,,1,M Vijay,V Sehwag,0,1,0,0,1,0,0,0,0,0,1,0,0
6480bb99a620a7afdb3217fe,2023,,,2,DA Warner,PP Shaw,0,3,0,0,1,0,0,0,0,0,3,0,0
6480bb9cd0eb4289b2222e37,2009/10,,,2,P Dogra,SK Warne,0,1,0,0,1,0,1,0,0,0,0,0,0
6480bb9be88c31fc563da86f,2009,,,1,JH Kallis,V Kohli,0,1,0,0,1,0,1,0,0,0,0,0,0
6480bb9fe7d0f611ba6ad229,2012,,,1,MJ Clarke,MK Pandey,0,2,0,0,1,0,0,0,0,0,2,0,0
6480bba179195d83fa7fbfbb,2014,,,2,RN ten Doeschate,Shakib Al Hasan,0,1,0,0,1,0,1,0,0,0,0,0,0
6480bba2d324f0342e6af689,2016,,,1,AD Nath,DW Steyn,0,1,0,0,1,0,1,0,0,0,0,0,0
6480bb9de80788b3c3ebe4e1,2009/10,,,1,FY Fazal,NV Ojha,0,3,0,0,1,0,2,0,0,0,1,0,0
6480bb9929c7e430acd1ef18,2022,,,2,A Nortje,KK Ahmed,0,1,0,0,1,0,0,0,0,0,1,0,0
6480bb9b6ded6d116cfe02ee,2009,,,1,AB Dinda,I Sharma,0,1,0,0,1,0,1,0,0,0,0,0,0
6480bb98af25209ef756aa2c,2021,,,2,AF Milne,TA Boult,0,4,0,0,1,0,1,0,0,0,3,0,0
6480bb9f0f1f6c03d8e2f039,2013,,,1,AB Dinda,MK Pandey,0,1,0,0,1,0,1,0,0,0,0,0,0
6480bb99350726d00af209bf,2022,,,2,B Kumar,Umran Malik,0,1,0,0,1,0,0,0,0,0,1,0,0
6480bb96a43476c5d9a56c4e,2020/21,,,2,PP Shaw,S Dhawan,0,2,0,0,1,0,2,0,0,0,0,0,0
6480bb9e9f1ef9ac02266570,2011,,,1,A Mishra,B Chipli,0,1,0,0,1,0,1,0,0,0,0,0,0
6480bb9936b7698da2c2030c,2023,,,1,JC Buttler,SV Samson,0,2,0,0,1,0,0,0,0,0,2,0,0
6480bb9a8ac627a1ebf8dacf,2007/08,,,2,JDP Oram,MEK Hussey,0,1,0,0,1,0,0,0,0,0,1,0,0
6480bba3041017fe2c0593f2,2016,,,2,AB de Villiers,KL Rahul,0,1,0,0,1,0,0,0,0,0,1,0,0
6480bb974086cbea889134af,2021,,,1,MS Dhoni,RA Jadeja,0,2,0,0,1,0,2,0,0,0,0,0,0
6480bb9e5ad1f3182858e7c9,2012,,,1,Harbhajan Singh,NLTC Perera,0,1,0,0,1,0,1,0,0,0,0,0,0
6480bba08ffdd4393211d261,2014,,,1,AJ Finch,DA Warner,0,2,0,0,1,0,0,0,0,0,2,0,0
6480bb988545a7776b8c9306,2022,,,2,Akash Deep,KD Karthik,0,2,0,0,1,0,2,0,0,0,0,0,0
6480bba2f3ed8323f852acfa,2016,,,1,AP Tare,S Dhawan,0,1,0,0,1,0,1,0,0,0,0,0,0
6480bb9c12f907c7b81b11a9,2009,,,2,RA Jadeja,T Henderson,0,3,0,0,1,0,2,0,0,0,1,0,0
6480bb975ea60ce128803d60,2021,,,2,KD Karthik,RA Tripathi,0,2,0,0,1,0,0,0,0,0,2,0,0
6480bba07e219ed95b7b06df,2013,,,1,DA Warner,UBT Chand,0,2,0,0,1,0,0,0,0,0,2,0,0
6480bb97b97c36ac8be3582f,2021,,,2,B Kumar,S Nadeem,0,1,0,0,1,0,0,0,0,0,1,0,0
6480bb9bbb0ec0266749f518,2007/08,,,2,AS Yadav,SB Styris,0,1,0,0,1,0,0,0,0,0,1,0,0
6480bb977f55a1c473670850,2021,,,1,S Dube,SV Samson,0,4,0,0,1,0,3,0,0,0,1,0,0
6480bba03a099a1a2e9c3dc5,2013,,,2,DA Warner,DPMD Jayawardene,0,1,0,0,1,0,1,0,0,0,0,0,0
6480bb9a07d46704efe103ef,2007/08,,,1,AS Yadav,SB Bangar,0,1,0,0,1,0,1,0,0,0,0,0,0
6480bba278153a5979e31ec9,2016,,,2,RA Jadeja,SK Raina,0,1,0,0,1,0,1,0,0,0,0,0,0
6480bb9927b39ebcfd7820b0,2022,,,2,SP Narine,UT Yadav,0,1,0,0,1,0,0,0,0,0,1,0,0
6480bb94566b0cf89fca84f9,2018,,,2,KS Williamson,RK Bhui,0,5,0,0,1,0,0,0,0,0,5,0,0
6480bb96c3293977af83acbf,2019,,,2,PP Shaw,SS Iyer,0,1,0,0,1,0,1,0,0,0,0,0,0
6480bb93ff8d1f4cd07859ce,2017,,,1,MC Henriques,Yuvraj Singh,0,1,0,0,1,0,0,0,0,0,1,0,0
6480bb954e496ec9b12aa120,2019,,,2,F du Plessis,SR Watson,0,4,0,0,1,0,0,0,0,0,4,0,0
6480bb94aad1a08ca4276b4e,2018,,,1,AJ Finch,KL Rahul,0,1,0,0,1,0,1,0,0,0,0,0,0
6480bb9a8cf29e28434bb1d5,2023,,,1,DA Warner,PD Salt,0,1,0,0,1,0,0,0,0,0,1,0,0
6480bb9f5867d07199aa832a,2013,,,1,M Vijay,S Anirudha,0,2,0,0,1,0,0,0,0,0,2,0,0
6480bb9ab34d149420eae546,2023,,,1,MP Stoinis,Q de Kock,0,2,0,0,1,0,2,0,0,0,0,0,0
6480bb9f36ad55c3c7fd6548,2012,,,1,DR Smith,RG Sharma,0,1,0,0,1,0,1,0,0,0,0,0,0
6480bb9c7ac2dca34620d56e,2009/10,,,2,JH Kallis,KP Pietersen,0,2,0,0,1,0,2,0,0,0,0,0,0
6480bba19052ba503c5f7c27,2015,,,1,KL Rahul,NV Ojha,0,1,0,0,1,0,1,0,0,0,0,0,0
6480bb9b8860198955e581d8,2007/08,,,2,S Sreesanth,U Kaul,0,1,0,0,0,0,0,0,0,0,1,0,0
6480bb974086cbea889134af,2021,,,1,MM Ali,RD Gaikwad,0,3,0,0,1,0,2,0,0,0,1,0,0
6480bb9dc8b09381d0f01a9d,2011,,,2,RV Uthappa,Yuvraj Singh,0,4,0,0,1,0,3,0,0,0,1,0,0
6480bb991a4f7e5f59dd1afc,2023,,,2,N Jagadeesan,SP Narine,0,1,0,0,1,0,0,0,0,0,1,0,0
6480bb9ed6aefcc9cd13d851,2012,,,1,CL White,JP Duminy,0,1,0,0,1,0,1,0,0,0,0,0,0
6480bb962831291a868490e7,2020/21,,,2,A Nortje,R Ashwin,0,1,0,0,0,0,0,0,0,0,1,0,0
6480bb9d54ae15d3d0ed9e5e,2011,,,2,MV Boucher,YK Pathan,0,1,0,0,1,0,0,0,0,0,1,0,0
6480bb9c89e2e8ecb04f94cb,2009/10,,,2,A Mishra,Y Nagar,0,1,0,0,1,0,1,0,0,0,0,0,0
6480bb9fa236b26050f19633,2012,,,2,DPMD Jayawardene,V Sehwag,0,3,0,0,1,0,3,0,0,0,0,0,0
6480bb975156c246a0ee40b1,2021,,,2,MK Pandey,WP Saha,0,4,0,0,1,0,3,0,0,0,1,0,0
6480bb9b9dd7fe8c5cbdbab0,2009,,,2,G Gambhir,V Sehwag,0,1,0,0,1,0,1,0,0,0,0,0,0
6480bb9d038ed22e46cbeccb,2011,,,2,AT Rayudu,KA Pollard,0,2,0,0,1,0,2,0,0,0,0,0,0
6480bb994aafcf67cd092a7d,2023,,,1,RR Rossouw,SN Khan,0,1,0,0,1,0,1,0,0,0,0,0,0
6480bb9f23c17ccb47aa9e58,2013,,,2,P Awana,RJ Harris,0,1,0,0,1,0,1,0,0,0,0,0,0
6480bb9429a15517bb46f3be,2018,,,1,KA Pollard,RG Sharma,0,1,0,0,1,0,1,0,0,0,0,0,0
6480bb967d799ced7fe5d8e9,2020/21,,,2,KK Ahmed,T Natarajan,0,2,0,0,1,0,2,0,0,0,0,0,0
6480bb9737b1d7284b5297c1,2021,,,1,M Jansen,RD Chahar,0,2,0,0,1,0,2,0,0,0,0,0,0
6480bb9deba74e341b44c765,2009/10,,,2,R Sharma,RJ Harris,0,9,0,0,1,0,6,0,0,0,3,0,0
6480bb9ea49fe0f895bf242a,2012,,,2,AM Rahane,SP Goswami,0,1,0,0,1,0,0,0,0,0,1,0,0
6480bb9e591b94e62772e66a,2012,,,1,KP Pietersen,Y Nagar,0,1,0,0,1,0,0,0,0,0,1,0,0
6480bb97fb920d483d0da2af,2020/21,,,2,N Pooran,Ravi Bishnoi,0,6,0,0,1,0,5,0,0,0,1,0,0
6480bba2e3610f863b52b887,2016,,,2,AM Rahane,F du Plessis,0,5,0,0,1,0,5,0,0,0,0,0,0
6480bb9aa64355ce98da1141,2007/08,,,1,P Kumar,R Dravid,0,2,0,0,1,0,2,0,0,0,0,0,0
6480bba24f6e6e2c212c7469,2016,,,2,NM Coulter-Nile,SV Samson,0,3,0,0,1,0,2,0,0,0,1,0,0
6480bb9f302200e3bc89464e,2012,,,2,A Chandila,OA Shah,0,1,0,0,1,0,1,0,0,0,0,0,0
6480bb9ca668b7b36823fb21,2009,,,1,KD Karthik,R Bhatia,0,1,0,0,1,0,0,0,0,0,1,0,0
6480bba2b7be71a15b2bb3de,2015,,,1,AT Rayudu,HH Pandya,0,3,0,0,1,0,1,0,0,0,2,0,0
6480bb9a6e44b0c8da00ca72,2007/08,,,2,Harbhajan Singh,SM Pollock,0,1,0,0,1,0,1,0,0,0,0,0,0
6480bb93575636076d81e4c5,2017,,,1,DA Warner,Yuvraj Singh,0,1,0,0,1,0,0,0,0,0,1,0,0
6480bb95fa6394e733c532a9,2018,,,1,B Kumar,Rashid Khan,0,1,0,0,1,0,0,0,0,0,1,0,0
6480bba0f858e6c12b25d8c3,2014,,,2,MG Johnson,R Dhawan,0,1,0,0,1,0,1,0,0,0,0,0,0
6480bb9b2de4e62ee60b7e5c,2009,,,1,Pankaj Singh,R Vinay Kumar,0,1,0,0,1,0,1,0,0,0,0,0,0
6480bb98e87e6f83b61088ea,2022,,,2,DJ Bravo,MS Dhoni,0,1,0,0,1,0,1,0,0,0,0,0,0
6480bb94009d0662ee94f07b,2018,,,2,DJ Hooda,Rashid Khan,0,1,0,0,1,0,0,0,0,0,1,0,0
6480bba07fa24b891b818984,2013,,,2,AP Tare,GJ Maxwell,0,3,0,0,1,0,0,0,0,0,3,0,0
6480bb9894cc2d00f057a1f1,2021,,,2,RA Tripathi,SP Narine,0,1,0,0,1,0,0,0,0,0,1,0,0
6480bb9bee2e48d9c41b1e23,2009,,,2,RG Sharma,VVS Laxman,0,6,0,0,1,0,4,0,0,0,2,0,0
6480bb98b8bb5b0d2c2f0848,2022,,,1,Ishan Kishan,RG Sharma,0,2,0,0,1,0,0,0,0,0,2,0,0
6480bb96593f4f87a2c294bc,2020/21,,,1,AJ Finch,V Kohli,0,1,0,0,1,0,1,0,0,0,0,0,0
6480bb9bc80883a975281815,2009,,,2,M Rawat,MM Patel,0,2,0,0,1,0,0,0,0,0,2,0,0
6480bb9be2940d96c1f903ca,2007/08,,,2,B Akhil,R Vinay Kumar,0,1,0,0,1,0,0,0,0,0,1,0,0
6480bb9d59f2ded94f736145,2011,,,1,DPMD Jayawardene,RV Gomez,0,1,0,0,1,0,0,0,0,0,1,0,0
6480bb9651b51fdcda05e4c8,2020/21,,,2,JC Buttler,SV Samson,0,3,0,0,1,0,0,0,0,0,3,0,0
6480bb99d43295fa2d82c9dc,2023,,,1,GJ Maxwell,Shahbaz Ahmed,0,1,0,0,1,0,1,0,0,0,0,0,0
6480bb98825d8ceb716e3f3c,2022,,,2,KS Williamson,RA Tripathi,0,1,0,0,1,0,0,0,0,0,1,0,0
6480bb9ca668b7b36823fb21,2009,,,1,R Bhatia,V Sehwag,0,1,0,0,1,0,0,0,0,0,1,0,0
6480bba0d2cdb40c68c4739c,2013,,,1,M Vijay,SK Raina,0,1,0,0,1,0,0,0,0,0,1,0,0
6480bba3b830360cf7031278,2016,,,1,AT Rayudu,RG Sharma,0,1,0,0,1,0,0,0,0,0,1,0,0
6480bb99ed38bcb4025b8d86,2023,,,2,HV Patel,MG Bracewell,0,2,0,0,1,0,2,0,0,0,0,0,0
6480bba2563745309ee2bdfb,2016,,,1,DS Kulkarni,JP Faulkner,0,2,0,0,1,0,0,0,0,0,2,0,0
6480bb9f0f959bc6104820c3,2013,,,2,BJ Hodge,KK Cooper,0,1,0,0,1,0,1,0,0,0,0,0,0
6480bb98d8f59b81335f4a3d,2021,,,2,F du Plessis,MM Ali,0,5,0,0,1,0,1,0,0,0,4,0,0
6480bb94a964c10b5f10ae52,2017,,,2,MJ Guptill,WP Saha,0,1,0,0,1,0,1,0,0,0,0,0,0
6480bb9a0a8baa96f94e8db9,2023,,,2,A Badoni,KR Mayers,0,2,0,0,1,0,0,0,0,0,2,0,0
6480bb9e83b8575f74b8e962,2012,,,2,CA Pujara,RR Bhatkal,0,1,0,0,1,0,1,0,0,0,0,0,0
6480bb95a65bb0f3394a62b5,2018,,,1,KS Williamson,MK Pandey,0,1,0,0,1,0,1,0,0,0,0,0,0
6480bb9b1087ddfd207caa83,2009,,,2,DPMD Jayawardene,IK Pathan,0,2,0,0,1,0,2,0,0,0,0,0,0
6480bb9da9ca2f2d3738d79e,2011,,,2,RV Uthappa,Yuvraj Singh,0,2,0,0,1,0,0,0,0,0,2,0,0
6480bb9d61e9b86b0f0aae49,2009/10,,,2,DW Steyn,R Vinay Kumar,0,1,0,0,1,0,1,0,0,0,0,0,0
6480bb9c5ec0713155cad138,2009/10,,,2,BJ Hodge,OA Shah,0,3,0,0,1,0,1,0,0,0,2,0,0
6480bb965f597c872396f67c,2020/21,,,1,KD Karthik,Shubman Gill,0,2,0,0,1,0,2,0,0,0,0,0,0
6480bb9c2f07203e8e510386,2009/10,,,1,PP Chawla,RS Bopara,0,3,0,0,1,0,1,0,0,0,2,0,0
6480bb9a24adc8d916dfe2db,2023,,,1,Shubman Gill,WP Saha,0,3,0,0,1,0,0,0,0,0,3,0,0
6480bb99d2bd76016d47896d,2023,,,2,DA Warner,MR Marsh,0,1,0,0,1,0,0,0,0,0,1,0,0
6480bb9da3dc1406b000cc98,2011,,,2,MS Wade,NV Ojha,0,1,0,0,1,0,0,0,0,0,1,0,0
6480bb99ed38bcb4025b8d86,2023,,,1,AD Russell,RK Singh,0,1,0,0,1,0,1,0,0,0,0,0,0
6480bb9558c0acb502a3b1a9,2019,,,2,CA Ingram,CH Morris,0,1,0,0,1,0,0,0,0,0,1,0,0
6480bb975156c246a0ee40b1,2021,,,1,EJG Morgan,KD Karthik,0,1,0,0,1,0,1,0,0,0,0,0,0
6480bb9e30b7f3c09cfbdabb,2011,,,2,R Dravid,SR Watson,0,1,0,0,1,0,1,0,0,0,0,0,0
6480bba2c3207713bd927ce5,2015,,,1,KL Rahul,NV Ojha,0,1,0,0,1,0,1,0,0,0,0,0,0
6480bb9d61e9b86b0f0aae49,2009/10,,,1,HH Gibbs,TL Suman,0,1,0,0,1,0,0,0,0,0,1,0,0
6480bb9c12e6c723b248799b,2009,,,1,MV Boucher,V Kohli,0,1,0,0,1,0,0,0,0,0,1,0,0
6480bb9359a2cade3b5213d3,2017,,,1,Mandeep Singh,P Negi,0,1,0,0,1,0,1,0,0,0,0,0,0
6480bba3e9fa951efcfc8bfb,2016,,,1,DA Miller,WP Saha,0,1,0,0,1,0,0,0,0,0,1,0,0
6480bb9b2e179d359c1d446d,2009,,,1,Shoaib Ahmed,Y Venugopal Rao,0,3,0,0,1,0,3,0,0,0,0,0,0
6480bba2f05e90a9005771d2,2015,,,2,MS Dhoni,P Negi,0,1,0,0,1,0,1,0,0,0,0,0,0
6480bb9be88c31fc563da86f,2009,,,2,PP Chawla,RR Powar,0,1,0,0,1,0,1,0,0,0,0,0,0
6480bb96e61ac20a6e10582e,2019,,,2,KH Pandya,SA Yadav,0,1,0,0,1,0,1,0,0,0,0,0,0
6480bb95b84f125c6212267a,2019,,,2,MM Ali,S Dube,0,1,0,0,1,0,0,0,0,0,1,0,0
6480bba358370ecde0231113,2016,,,1,A Zampa,R Bhatia,0,1,0,0,1,0,1,0,0,0,0,0,0
6480bb98f98edd45b1ccb406,2022,,,2,AS Roy,SP Narine,0,2,0,0,1,0,2,0,0,0,0,0,0
6480bb9ce93a7b4315d8fa30,2009,,,1,Shoaib Ahmed,WPUJC Vaas,0,1,0,0,1,0,1,0,0,0,0,0,0
6480bb9808d6857eeb335d94,2022,,,2,DA Warner,PP Shaw,0,1,0,0,1,0,0,0,0,0,1,0,0
6480bba1d21281c7385d5ce4,2014,,,1,PA Patel,V Kohli,0,1,0,0,1,0,0,0,0,0,1,0,0
6480bb9836af59f8283f4081,2022,,,2,KA Pollard,Tilak Varma,0,2,0,0,1,0,0,0,0,0,2,0,0
6480bb9834c7569d5fa64353,2022,,,2,KR Sen,M Prasidh Krishna,0,3,0,0,0,0,3,0,0,0,0,0,0
6480bb9866dd8ba9b48863c2,2022,,,1,HV Patel,KD Karthik,0,1,0,0,0,0,1,0,0,0,0,0,0
6480bb9f87652064dab6c573,2013,,,1,DA Miller,Gurkeerat Singh,0,1,0,0,1,0,0,0,0,0,1,0,0
6480bb9d716a89dbf5e486d0,2011,,,2,DA Warner,NV Ojha,0,2,0,0,1,0,0,0,0,0,2,0,0
6480bb97fb920d483d0da2af,2020/21,,,2,Mohammed Shami,Ravi Bishnoi,0,1,0,0,1,0,1,0,0,0,0,0,0
6480bb9e56c724ba25b94666,2011,,,2,DS Kulkarni,SL Malinga,0,2,0,0,1,0,2,0,0,0,0,0,0
6480bb9c963968000dfd00d1,2009/10,,,2,PP Chawla,Yuvraj Singh,0,1,0,0,1,0,0,0,0,0,1,0,0
6480bb94f46306dbde97aa5c,2017,,,2,C de Grandhomme,IR Jaggi,0,1,0,0,1,0,1,0,0,0,0,0,0
6480bb96a467817b9b68ca94,2020/21,,,2,S Nadeem,Sandeep Sharma,0,3,0,0,1,0,3,0,0,0,0,0,0
6480bb9ade063258af41163b,2007/08,,,2,PP Ojha,RP Singh,0,1,0,0,1,0,0,0,0,0,1,0,0
6480bb9b82dc3ec84c520466,2009,,,2,BB McCullum,CH Gayle,0,1,0,0,1,0,1,0,0,0,0,0,0
6480bb9f146f5849bb759148,2013,,,2,AB Dinda,AD Mathews,0,2,0,0,1,0,2,0,0,0,0,0,0
6480bb9f0f959bc6104820c3,2013,,,2,AL Menaria,S Sreesanth,0,1,0,0,1,0,1,0,0,0,0,0,0
6480bb95816d3ad3bc382ab6,2018,,,1,RA Tripathi,SV Samson,0,1,0,0,1,0,0,0,0,0,1,0,0
6480bba2db1e2def1b597ed3,2015,,,2,DA Miller,WP Saha,0,3,0,0,1,0,0,0,0,0,3,0,0
6480bb98960cf9374ee9420d,2022,,,1,JO Holder,KL Rahul,0,2,0,0,0,0,2,0,0,0,0,0,0
6480bb9f0f1f6c03d8e2f039,2013,,,1,MK Pandey,R Sharma,0,1,0,0,1,0,0,0,0,0,1,0,0
6480bba179195d83fa7fbfbb,2014,,,2,Shakib Al Hasan,YK Pathan,0,1,0,0,1,0,0,0,0,0,1,0,0
6480bba3041017fe2c0593f2,2016,,,1,DJ Bravo,P Kumar,0,1,0,0,1,0,1,0,0,0,0,0,0
6480bb94cfe5aeb50e36aef3,2017,,,1,MM Patel,RA Jadeja,0,1,0,0,1,0,1,0,0,0,0,0,0
6480bb958f77e7d3929d28e3,2018,,,2,SK Raina,SW Billings,0,1,0,0,1,0,0,0,0,0,1,0,0
6480bba234aac105851964b1,2015,,,1,MEK Hussey,SK Raina,0,2,0,0,1,0,0,0,0,0,2,0,0
6480bba0ffae8617ee64bd19,2013,,,2,A Nehra,UT Yadav,0,1,0,0,1,0,1,0,0,0,0,0,0
6480bba278153a5979e31ec9,2016,,,2,Ishan Kishan,JP Faulkner,0,1,0,0,1,0,1,0,0,0,0,0,0
6480bb9baccf501985a56d64,2007/08,,,1,NK Patel,SR Watson,0,1,0,0,1,0,1,0,0,0,0,0,0
6480bb97fcc6fccd233157f9,2021,,,2,SV Samson,YBK Jaiswal,0,1,0,0,1,0,0,0,0,0,1,0,0
6480bb97e5be965d3c00760e,2021,,,1,PWH de Silva,Sachin Baby,0,1,0,0,1,0,1,0,0,0,0,0,0
6480bb9553f3fc8903579544,2018,,,2,N Rana,RK Singh,0,1,0,0,1,0,1,0,0,0,0,0,0
6480bb94009d0662ee94f07b,2018,,,2,DJ Hooda,Sandeep Sharma,0,2,0,0,1,0,0,0,0,0,2,0,0
6480bb973d64aa91e60b4088,2021,,,2,CH Morris,R Tewatia,0,2,0,0,1,0,2,0,0,0,0,0,0
6480bb96b7b695186bbb6a3e,2019,,,1,RG Sharma,SA Yadav,0,3,0,0,1,0,2,0,0,0,1,0,0
6480bb97aed297ca9686c94a,2021,,,2,AT Rayudu,F du Plessis,0,1,0,0,1,0,1,0,0,0,0,0,0
6480bb987c720def5fbaf218,2022,,,2,M Ashwin,TS Mills,0,2,0,0,1,0,0,0,0,0,2,0,0
6480bb99358a21ba3487db81,2023,,,2,MP Stoinis,R Shepherd,0,1,0,0,1,0,0,0,0,0,1,0,0
6480bb99ecbdaaf953b8eee5,2023,,,2,KH Pandya,KL Rahul,0,2,0,0,1,0,0,0,0,0,2,0,0
6480bb9c266a85f1960d87e9,2009,,,1,KD Karthik,R Bhatia,0,1,0,0,1,0,0,0,0,0,1,0,0
6480bb9ac9149c73fdf073b3,2023,,,2,A Nortje,Kuldeep Yadav,0,1,0,0,1,0,0,0,0,0,1,0,0
6480bb9e335bec070f88430f,2011,,,1,AB de Villiers,CH Gayle,0,3,0,0,1,0,3,0,0,0,0,0,0
6480bb9af1b34d6aa89e434e,2023,,,2,P Simran Singh,S Dhawan,0,7,0,0,1,0,6,0,0,0,1,0,0
6480bb93575636076d81e4c5,2017,,,2,M Vohra,WP Saha,0,2,0,0,1,0,0,0,0,0,2,0,0
6480bb9ac9149c73fdf073b3,2023,,,2,A Nortje,C Sakariya,0,2,0,0,0,0,0,0,0,0,2,0,0
6480bb9d59f2ded94f736145,2011,,,1,RP Singh,S Sreesanth,0,1,0,0,1,0,1,0,0,0,0,0,0
6480bb9df60a79ae5f20b748,2011,,,1,M Morkel,RE van der Merwe,0,2,0,0,1,0,2,0,0,0,0,0,0
6480bb9b3a5e1af467fb027b,2009,,,2,ML Hayden,SK Raina,0,1,0,0,1,0,0,0,0,0,1,0,0
6480bb9754755bb7a7427d52,2021,,,1,M Prasidh Krishna,Shivam Mavi,0,4,0,0,1,0,0,0,0,0,4,0,0
6480bb99c6aa5989a16174d1,2023,,,1,DJ Willey,Vijaykumar Vyshak,0,1,0,0,1,0,0,0,0,0,1,0,0
6480bb9c757dbd7f92b1130a,2009/10,,,1,PP Ojha,RP Singh,0,4,0,0,1,0,0,0,0,0,4,0,0
6480bb9824c4678d005d7aeb,2022,,,2,SP Jackson,Shivam Mavi,0,1,0,0,1,0,0,0,0,0,1,0,0
6480bb96c95abb10156a6055,2020/21,,,1,RD Chahar,TA Boult,0,2,0,0,1,0,1,0,0,0,1,0,0
6480bb9a43249ece8e841e56,2023,,,2,N Wadhera,TH David,0,1,0,0,1,0,0,0,0,0,1,0,0
6480bb9a8053274c083224d9,2023,,,1,Ishan Kishan,RG Sharma,0,3,0,0,1,0,2,0,0,0,1,0,0
6480bb98f01e4672b988c112,2022,,,2,KL Rahul,Q de Kock,0,1,0,0,1,0,1,0,0,0,0,0,0
6480bba0b07a395235841955,2013,,,2,DR Smith,KD Karthik,0,2,0,0,1,0,0,0,0,0,2,0,0
6480bb976caaa0cc91f652c7,2021,,,1,KH Pandya,SS Tiwary,0,1,0,0,1,0,1,0,0,0,0,0,0
6480bb94c2dcb1007bf6788b,2017,,,1,A Choudhary,S Badree,0,1,0,0,1,0,0,0,0,0,1,0,0
6480bb96e18d7a1b3e62552d,2019,,,2,KL Rahul,R Ashwin,0,1,0,0,1,0,0,0,0,0,1,0,0
6480bb97b945155c90dccd3d,2021,,,2,MS Dhoni,RA Jadeja,0,2,0,0,1,0,2,0,0,0,0,0,0
6480bba1abec4894f2f69a35,2014,,,1,DR Smith,SK Raina,0,2,0,0,1,0,2,0,0,0,0,0,0
6480bb95fa6394e733c532a9,2018,,,1,B Kumar,S Kaul,0,1,0,0,1,0,1,0,0,0,0,0,0
6480bb946efcc4cd9aa80399,2018,,,1,SN Khan,V Kohli,0,1,0,0,1,0,0,0,0,0,1,0,0
6480bb951677500061c85592,2019,,,2,Mohammad Nabi,Rashid Khan,0,1,0,0,1,0,0,0,0,0,1,0,0
6480bb9f59fd8000010baf09,2013,,,1,R Vinay Kumar,V Kohli,0,1,0,0,1,0,0,0,0,0,1,0,0
6480bb9866dd8ba9b48863c2,2022,,,1,F du Plessis,V Kohli,0,1,0,0,1,0,0,0,0,0,1,0,0
6480bb9ee0795047740de5a7,2011,,,1,SK Trivedi,SK Warne,0,2,0,0,1,0,0,0,0,0,2,0,0
6480bb99c26e725b7b6f1637,2023,,,2,Dhruv Jurel,R Parag,0,1,0,0,1,0,1,0,0,0,0,0,0
6480bb9e713e850d3dd0cba9,2012,,,2,BB McCullum,MK Tiwary,0,1,0,0,1,0,1,0,0,0,0,0,0
6480bb98cce4ab46512c2c03,2022,,,1,D Pretorius,MS Dhoni,0,1,0,0,1,0,1,0,0,0,0,0,0
6480bb9aef150645306cc170,2023,,,2,DA Warner,PD Salt,0,2,0,0,1,0,2,0,0,0,0,0,0
6480bb98dd9a2108c79e1014,2022,,,1,M Shahrukh Khan,NT Ellis,0,2,0,0,1,0,0,0,0,0,2,0,0
6480bb96e834e1c16b33f325,2020/21,,,2,JC Archer,R Parag,0,2,0,0,1,0,0,0,0,0,2,0,0
6480bba1827557ebdfc70821,2015,,,1,M Vijay,V Sehwag,0,4,0,0,1,0,4,0,0,0,0,0,0
6480bb9a5d25d853e1cbfe3e,2007/08,,,2,B Lee,S Sohal,0,2,0,0,1,0,2,0,0,0,0,0,0
6480bb9d4e112d675b2925df,2009/10,,,2,DA Warner,V Sehwag,0,5,0,0,1,0,5,0,0,0,0,0,0
6480bb946efcc4cd9aa80399,2018,,,1,CR Woakes,Washington Sundar,0,1,0,0,1,0,1,0,0,0,0,0,0
6480bb9f0f959bc6104820c3,2013,,,1,IK Pathan,NV Ojha,0,1,0,0,0,0,0,0,0,0,1,0,0
6480bb9fd26b695cee9d8761,2013,,,2,AM Rahane,MDKJ Perera,0,1,0,0,1,0,0,0,0,0,1,0,0
6480bb9dfb2e8e8c2002df86,2011,,,1,IR Jaggi,KC Sangakkara,0,4,0,0,1,0,1,0,0,0,3,0,0
6480bb945f95e767a8a9cc10,2017,,,2,BB McCullum,DR Smith,0,1,0,0,1,0,0,0,0,0,1,0,0
6480bb9873e53eace3a69dc7,2022,,,1,LH Ferguson,R Tewatia,0,1,0,0,1,0,1,0,0,0,0,0,0
6480bb9fcbbfd8053f253537,2012,,,2,BB McCullum,MK Tiwary,0,1,0,0,1,0,1,0,0,0,0,0,0
6480bb94ca3c1b1eac5e8dd3,2018,,,2,AT Rayudu,KM Jadhav,0,3,0,0,1,0,3,0,0,0,0,0,0
6480bb9fe3bc767415c60bfa,2012,,,1,NV Ojha,V Sehwag,0,1,0,0,1,0,0,0,0,0,1,0,0
6480bb9b62eb35d78fcd7df0,2007/08,,,2,PJ Sangwan,VY Mahesh,0,1,0,0,1,0,1,0,0,0,0,0,0
6480bb96a43476c5d9a56c4e,2020/21,,,1,F du Plessis,SM Curran,0,3,0,0,1,0,0,0,0,0,3,0,0
6480bb9f36da1a646c80be45,2013,,,2,DA Warner,UBT Chand,0,1,0,0,1,0,0,0,0,0,1,0,0
6480bb9f23c17ccb47aa9e58,2013,,,1,AM Rahane,STR Binny,0,4,0,0,1,0,0,0,0,0,4,0,0
6480bb99bbae76f3f761d060,2023,,,2,N Jagadeesan,VR Iyer,0,4,0,0,1,0,2,0,0,0,2,0,0
6480bb980cc3d01eab3a4748,2022,,,2,LS Livingstone,RA Bawa,0,1,0,0,1,0,0,0,0,0,1,0,0
6480bb98960cf9374ee9420d,2022,,,2,DR Sams,HR Shokeen,0,1,0,0,1,0,1,0,0,0,0,0,0
6480bb94f27c8167d1685878,2017,,,2,DR Smith,SK Raina,0,1,0,0,1,0,0,0,0,0,1,0,0
6480bb9c442caaabe9eb2275,2009,,,2,AM Nayar,Harbhajan Singh,0,1,0,0,1,0,1,0,0,0,0,0,0
6480bb9d038ed22e46cbeccb,2011,,,2,KA Pollard,RG Sharma,0,3,0,0,1,0,1,0,0,0,2,0,0
6480bba07fa24b891b818984,2013,,,1,Gurkeerat Singh,M Vohra,0,1,0,0,1,0,1,0,0,0,0,0,0
6480bb9c12f907c7b81b11a9,2009,,,2,NK Patel,NV Ojha,0,4,0,0,1,0,1,0,0,0,3,0,0
6480bb9b2a5f2fd5053534dc,2007/08,,,1,RV Uthappa,SM Pollock,0,1,0,0,1,0,0,0,0,0,1,0,0
6480bb9eb2690fb1ed356b42,2011,,,2,MJ Lumb,S Sohal,0,2,0,0,1,0,2,0,0,0,0,0,0
6480bba0c9e6d590ed35eb56,2014,,,2,Harbhajan Singh,Z Khan,0,4,0,0,1,0,2,0,0,0,2,0,0
6480bb9be88c31fc563da86f,2009,,,2,RR Powar,TM Srivastava,0,1,0,0,0,0,0,0,0,0,1,0,0
6480bb9e6d7f7f691dde322d,2012,,,1,RE Levi,SR Tendulkar,0,1,0,0,1,0,1,0,0,0,0,0,0
6480bb97220be892fbfc2a36,2021,,,2,KD Karthik,PJ Cummins,0,1,0,0,1,0,0,0,0,0,1,0,0
6480bba255079696d5cfa453,2015,,,2,AR Patel,Anureet Singh,0,2,0,0,1,0,0,0,0,0,2,0,0
6480bb99537b54b870dc74d1,2023,,,1,P Simran Singh,S Dhawan,0,2,0,0,1,0,2,0,0,0,0,0,0
6480bb9932735ca83d38f6e7,2022,,,2,B Kumar,Shashank Singh,0,2,0,0,1,0,1,0,0,0,1,0,0
6480bb99b35dc0981e512451,2022,,,1,M Prasidh Krishna,R Parag,0,2,0,0,1,0,0,0,0,0,2,0,0
6480bb97aa725a640d0f8e2f,2021,,,1,C Sakariya,CH Morris,0,1,0,0,1,0,0,0,0,0,1,0,0
6480bb98291bb8b3f3e8145d,2022,,,2,AD Russell,UT Yadav,0,1,0,0,1,0,0,0,0,0,1,0,0
6480bb94640655c49683aee1,2018,,,2,H Klaasen,JC Archer,0,4,0,0,1,0,1,0,0,0,3,0,0
6480bb9e300070746cc2eb67,2011,,,1,MS Dhoni,SK Raina,0,1,0,0,1,0,1,0,0,0,0,0,0
6480bba0e883438915efc1e6,2013,,,1,RV Uthappa,TL Suman,0,1,0,0,1,0,0,0,0,0,1,0,0
6480bb9e591b94e62772e66a,2012,,,2,KA Pollard,RJ Peterson,0,1,0,0,1,0,1,0,0,0,0,0,0
6480bb98f98edd45b1ccb406,2022,,,2,AJ Finch,B Indrajith,0,6,0,0,1,0,0,0,0,0,6,0,0
6480bb9f36ad55c3c7fd6548,2012,,,1,MM Patel,RP Singh,0,1,0,0,1,0,0,0,0,0,1,0,0
6480bba27b4786f36f706f8e,2016,,,1,HH Pandya,JC Buttler,0,2,0,0,1,0,1,0,0,0,1,0,0
6480bba07fa24b891b818984,2013,,,1,M Vohra,P Kumar,0,1,0,0,1,0,0,0,0,0,1,0,0
6480bba2f3ed8323f852acfa,2016,,,1,DJ Hooda,MC Henriques,0,1,0,0,1,0,0,0,0,0,1,0,0
6480bb9a9dc58f49d783faa9,2023,,,2,KM Asif,Sandeep Sharma,0,2,0,0,1,0,2,0,0,0,0,0,0
6480bb983ad1bab18d1d8774,2022,,,1,SP Jackson,SW Billings,0,1,0,0,1,0,1,0,0,0,0,0,0
6480bb9dbefe5e2cceb23e01,2011,,,2,R Ashwin,S Badrinath,0,2,0,0,1,0,2,0,0,0,0,0,0
6480bb988b447f26d7a96c0c,2022,,,2,JJ Bumrah,KA Pollard,0,2,0,0,1,0,0,0,0,0,2,0,0
6480bb9a61edc0c77bc4bc86,2007/08,,,2,CK Kapugedera,S Badrinath,0,1,0,0,1,0,1,0,0,0,0,0,0
6480bba210201df0f7975000,2016,,,2,HV Patel,STR Binny,0,1,0,0,1,0,0,0,0,0,1,0,0
6480bb9c442caaabe9eb2275,2009,,,2,JP Duminy,PR Shah,0,4,0,0,1,0,4,0,0,0,0,0,0
6480bb97752fcb9cd9f23692,2021,,,2,BA Stokes,M Vohra,0,3,0,0,1,0,3,0,0,0,0,0,0
6480bb96ee2a21f0d9b9f37f,2020/21,,,2,EJG Morgan,KD Karthik,0,1,0,0,1,0,0,0,0,0,1,0,0
6480bba107ba9f7f041862c1,2014,,,2,RV Uthappa,Shakib Al Hasan,0,1,0,0,1,0,0,0,0,0,1,0,0
6480bb9c21492b9a562c6f46,2009/10,,,2,AD Mathews,OA Shah,0,1,0,0,1,0,0,0,0,0,1,0,0
6480bba2e30bef1d7b3bb753,2015,,,2,AB de Villiers,V Kohli,0,1,0,0,1,0,1,0,0,0,0,0,0
6480bb995f3db9699a1f794d,2022,,,1,MJ Santner,MM Ali,0,1,0,0,1,0,0,0,0,0,1,0,0
6480bba163bd0c619365a16b,2015,,,2,JJ Bumrah,SL Malinga,0,2,0,0,0,0,0,0,0,0,2,0,0
6480bb983ad1bab18d1d8774,2022,,,2,DJ Willey,V Kohli,0,1,0,0,1,0,0,0,0,0,1,0,0
6480bb945460b25d997060fb,2018,,,1,Shivam Mavi,TK Curran,0,1,0,0,1,0,0,0,0,0,1,0,0
6480bb9c5ec0713155cad138,2009/10,,,2,BJ Hodge,SC Ganguly,0,3,0,0,1,0,0,0,0,0,3,0,0
6480bb97fb920d483d0da2af,2020/21,,,2,Arshdeep Singh,Ravi Bishnoi,0,3,0,0,1,0,3,0,0,0,0,0,0
6480bb97ce981c1918dce924,2021,,,1,JDS Neesham,SA Yadav,0,1,0,0,1,0,1,0,0,0,0,0,0
6480bb99349f00f851e8d2fd,2023,,,2,N Wadhera,TH David,0,1,0,0,1,0,1,0,0,0,0,0,0
6480bb9f59fd8000010baf09,2013,,,1,AB McDonald,V Kohli,0,2,0,0,1,0,2,0,0,0,0,0,0
6480bb9bc80883a975281815,2009,,,1,JD Ryder,RV Uthappa,0,2,0,0,1,0,2,0,0,0,0,0,0
6480bb9a807eb5f39489408a,2023,,,2,Aman Hakim Khan,Kuldeep Yadav,0,1,0,0,0,0,0,0,0,0,1,0,0
6480bb97ce981c1918dce924,2021,,,1,JJ Bumrah,SA Yadav,0,3,0,0,1,0,0,0,0,0,3,0,0
6480bb9d22388e966342dba8,2009/10,,,2,KA Pollard,Z Khan,0,1,0,0,1,0,1,0,0,0,0,0,0
6480bb9f60d58ee39ba047b9,2013,,,1,MC Juneja,V Sehwag,0,1,0,0,1,0,0,0,0,0,1,0,0
6480bb9e8dfd9ba30b93cbd8,2012,,,1,Ankit Sharma,TP Sudhindra,0,1,0,0,1,0,1,0,0,0,0,0,0
6480bb99f47261f111a6cc1a,2023,,,2,JP Behrendorff,RP Meredith,0,2,0,0,0,0,0,0,0,0,2,0,0
6480bb9c968c81bdfcc6df5b,2009,,,1,DA Warner,G Gambhir,0,5,0,0,1,0,0,0,0,0,5,0,0
6480bb9ff2e0b1df0c3972c9,2012,,,1,DPMD Jayawardene,LRPL Taylor,0,2,0,0,1,0,0,0,0,0,2,0,0
6480bb98af25209ef756aa2c,2021,,,2,AF Milne,KA Pollard,0,1,0,0,1,0,0,0,0,0,1,0,0
6480bb98436587de59527f2e,2022,,,2,Mandeep Singh,PP Shaw,0,2,0,0,1,0,2,0,0,0,0,0,0
6480bb9bc74c35e494cec477,2007/08,,,2,DB Ravi Teja,SB Bangar,0,4,0,0,1,0,2,0,0,0,2,0,0
6480bb9836d24b9817a35f7d,2022,,,1,KL Rahul,Q de Kock,0,1,0,0,1,0,1,0,0,0,0,0,0
6480bb984a44a355b856fd1a,2022,,,1,Anuj Rawat,V Kohli,0,1,0,0,1,0,0,0,0,0,1,0,0
6480bb98d2cd0fa3ed0ffc21,2022,,,2,N Rana,SW Billings,0,2,0,0,1,0,2,0,0,0,0,0,0
6480bba2e3610f863b52b887,2016,,,1,DA Warner,S Dhawan,0,4,0,0,1,0,4,0,0,0,0,0,0
6480bb9341152e168005ccc9,2017,,,2,BA Stokes,SPD Smith,0,1,0,0,1,0,0,0,0,0,1,0,0
6480bb93f866249511c76dbc,2017,,,2,LH Ferguson,SN Thakur,0,1,0,0,1,0,0,0,0,0,1,0,0
6480bb987c52e15a2cac0697,2022,,,1,Arshdeep Singh,K Rabada,0,1,0,0,1,0,1,0,0,0,0,0,0
6480bb9dc4ec5a52f8bcc465,2009/10,,,2,JP Duminy,Z Khan,0,1,0,0,1,0,0,0,0,0,1,0,0
6480bb9b7557e68b433167d5,2007/08,,,1,A Mukund,MS Gony,0,1,0,0,1,0,1,0,0,0,0,0,0
6480bb9e6d7f7f691dde322d,2012,,,2,JP Duminy,V Pratap Singh,0,1,0,0,1,0,0,0,0,0,1,0,0
6480bb9808d6857eeb335d94,2022,,,2,R Powell,RR Pant,0,1,0,0,1,0,0,0,0,0,1,0,0
6480bba048fb3d33ea0711e7,2013,,,1,AC Gilchrist,LA Pomersbach,0,1,0,0,1,0,1,0,0,0,0,0,0
6480bb94b991069934e5c7d2,2018,,,1,JC Buttler,S Gopal,0,1,0,0,1,0,0,0,0,0,1,0,0
6480bb9c89e2e8ecb04f94cb,2009/10,,,2,S Ladda,UT Yadav,0,1,0,0,1,0,1,0,0,0,0,0,0
6480bb9866dd8ba9b48863c2,2022,,,2,PVD Chameera,Ravi Bishnoi,0,1,0,0,0,0,0,0,0,0,1,0,0
6480bba10e78f50f124b406a,2015,,,1,D Wiese,HV Patel,0,1,0,0,1,0,0,0,0,0,1,0,0
6480bb96e29253678ca02869,2020/21,,,1,GJ Maxwell,KL Rahul,0,1,0,0,1,0,0,0,0,0,1,0,0
6480bb95f2e3c32afe233820,2018,,,1,B Kumar,Sandeep Sharma,0,1,0,0,1,0,0,0,0,0,1,0,0
6480bb9be7cbbb90a12dc916,2009,,,1,ML Hayden,PA Patel,0,2,0,0,1,0,0,0,0,0,2,0,0
6480bba250b404cdcbff22c8,2015,,,1,F du Plessis,MS Dhoni,0,1,0,0,1,0,0,0,0,0,1,0,0
6480bb9a5d25d853e1cbfe3e,2007/08,,,2,IK Pathan,S Sohal,0,3,0,0,1,0,2,0,0,0,1,0,0
6480bb96593f4f87a2c294bc,2020/21,,,2,PK Garg,V Shankar,0,1,0,0,1,0,0,0,0,0,1,0,0
6480bb9d967f5a4cfbd8c74d,2011,,,1,AB Agarkar,Y Nagar,0,1,0,0,1,0,0,0,0,0,1,0,0
6480bb9ef18c54e7aafdd223,2012,,,2,P Kumar,PP Chawla,0,1,0,0,1,0,1,0,0,0,0,0,0
6480bb9dec749d630afd07d1,2011,,,1,A Mishra,DB Ravi Teja,0,1,0,0,1,0,1,0,0,0,0,0,0
6480bb963c729ccbcb9446f8,2020/21,,,2,DA Warner,JM Bairstow,0,4,0,0,1,0,2,0,0,0,2,0,0
6480bb9c1e676472f4841aa9,2009/10,,,2,L Balaji,R Ashwin,0,2,0,0,0,0,2,0,0,0,0,0,0
6480bb9a0a8baa96f94e8db9,2023,,,1,Mohammed Siraj,PWH de Silva,0,1,0,0,1,0,1,0,0,0,0,0,0
6480bb9d3ab782f83ce3e381,2011,,,1,KC Sangakkara,S Dhawan,0,2,0,0,1,0,2,0,0,0,0,0,0
6480bb9ba9d43057d652a5fe,2009,,,1,KC Sangakkara,PP Chawla,0,2,0,0,1,0,0,0,0,0,2,0,0
6480bba08cc4182f0127f2e2,2013,,,2,MM Sharma,RA Jadeja,0,3,0,0,1,0,3,0,0,0,0,0,0
6480bb979e91d1ff9b54c737,2020/21,,,1,MP Stoinis,S Dhawan,0,1,0,0,1,0,1,0,0,0,0,0,0
6480bba0dcd1149b9b0b501f,2013,,,1,B Kumar,WD Parnell,0,1,0,0,1,0,0,0,0,0,1,0,0
6480bba1827557ebdfc70821,2015,,,2,G Gambhir,YK Pathan,0,5,0,0,1,0,4,0,0,0,1,0,0
6480bb98f98edd45b1ccb406,2022,,,2,Shivam Mavi,TG Southee,0,1,0,0,1,0,0,0,0,0,1,0,0
6480bb9e692eaa193a417426,2012,,,1,AB de Villiers,HV Patel,0,1,0,0,1,0,0,0,0,0,1,0,0
6480bb974123cbc9756ceefa,2021,,,1,D Padikkal,DT Christian,0,1,0,0,1,0,0,0,0,0,1,0,0
6480bb9a6ecee5429e0468be,2023,,,1,KH Pandya,KS Sharma,0,1,0,0,1,0,1,0,0,0,0,0,0
6480bb94b991069934e5c7d2,2018,,,1,JC Buttler,JD Unadkat,0,1,0,0,0,0,1,0,0,0,0,0,0
6480bb9c9e328ac30bcaf6b0,2009/10,,,2,Harbhajan Singh,R McLaren,0,4,0,0,1,0,2,0,0,0,2,0,0
6480bb9814efd9a91e8c911f,2021,,,2,Mustafizur Rahman,R Tewatia,0,4,0,0,1,0,3,0,0,0,1,0,0
6480bb9d5d93b08a19c16313,2009/10,,,2,MK Tiwary,SC Ganguly,0,2,0,0,1,0,0,0,0,0,2,0,0
6480bb9c968c81bdfcc6df5b,2009,,,1,A Mishra,PJ Sangwan,0,1,0,0,1,0,0,0,0,0,1,0,0
6480bba20559f15c3489f637,2015,,,1,J Suchith,R Vinay Kumar,0,1,0,0,1,0,0,0,0,0,1,0,0
6480bba2b5d601f8354f5b5a,2016,,,2,GJ Maxwell,M Vohra,0,3,0,0,1,0,3,0,0,0,0,0,0
6480bba0d3cbb27b257a9c1f,2013,,,1,AC Gilchrist,Mandeep Singh,0,3,0,0,1,0,0,0,0,0,3,0,0
6480bb9b4fc6889967a3cd54,2007/08,,,2,AM Nayar,DJ Thornely,0,2,0,0,1,0,0,0,0,0,2,0,0
6480bb9b3a5e1af467fb027b,2009,,,1,P Kumar,RV Uthappa,0,3,0,0,1,0,3,0,0,0,0,0,0
6480bba1ebb63d1bd8c60b9d,2014,,,2,KM Jadhav,KP Pietersen,0,4,0,0,1,0,4,0,0,0,0,0,0
6480bb97a42828c5a5ebef1c,2020/21,,,2,PP Shaw,S Dhawan,0,2,0,0,1,0,2,0,0,0,0,0,0
6480bba25855b7a7195a9bc5,2016,,,2,HH Pandya,Harbhajan Singh,0,1,0,0,1,0,0,0,0,0,1,0,0
6480bba3412663673a969a24,2016,,,2,AM Rahane,GJ Bailey,0,1,0,0,1,0,1,0,0,0,0,0,0
6480bb9a8cf29e28434bb1d5,2023,,,2,Shubman Gill,WP Saha,0,6,0,0,1,0,0,0,0,0,6,0,0
6480bb9558c0acb502a3b1a9,2019,,,2,GH Vihari,K Rabada,0,3,0,0,1,0,3,0,0,0,0,0,0
6480bb9e1d754facf4fad618,2012,,,1,S Badrinath,SK Raina,0,2,0,0,1,0,2,0,0,0,0,0,0
6480bb96f8379d02d3435ceb,2020/21,,,2,KM Jadhav,SM Curran,0,4,0,0,1,0,3,0,0,0,1,0,0
6480bb9d872bbb611f6266cb,2011,,,2,M Vijay,SK Raina,0,1,0,0,1,0,0,0,0,0,1,0,0
6480bb9a58bc8710c38f4c1c,2023,,,1,PN Mankad,Q de Kock,0,1,0,0,1,0,1,0,0,0,0,0,0
6480bba069d61566bb63ac2b,2014,,,2,JH Kallis,YK Pathan,0,2,0,0,1,0,0,0,0,0,2,0,0
6480bb97b97c36ac8be3582f,2021,,,2,Abdul Samad,MK Pandey,0,1,0,0,1,0,0,0,0,0,1,0,0
6480bb951677500061c85592,2019,,,2,DA Warner,V Shankar,0,3,0,0,1,0,1,0,0,0,2,0,0
6480bb99b35dc0981e512451,2022,,,1,JC Buttler,SO Hetmyer,0,2,0,0,1,0,1,0,0,0,1,0,0
6480bb94ee669473878c11c2,2017,,,1,SA Yadav,UT Yadav,0,1,0,0,1,0,1,0,0,0,0,0,0
6480bba2ad3f26917361061f,2016,,,1,CH Gayle,V Kohli,0,3,0,0,1,0,3,0,0,0,0,0,0
6480bb99fa79383bdc7df827,2022,,,2,GJ Maxwell,KD Karthik,0,2,0,0,1,0,2,0,0,0,0,0,0
6480bba2d324f0342e6af689,2016,,,1,AJ Finch,BB McCullum,0,4,0,0,1,0,4,0,0,0,0,0,0
6480bb9affabe4960a987464,2007/08,,,1,CL White,W Jaffer,0,3,0,0,1,0,1,0,0,0,2,0,0
6480bba17bce347084729c56,2015,,,1,AJ Finch,RG Sharma,0,2,0,0,1,0,0,0,0,0,2,0,0
6480bb9c8f3ef1685cdf4017,2009,,,2,BJ Hodge,SC Ganguly,0,3,0,0,1,0,3,0,0,0,0,0,0
6480bb9ab83a3072124dda22,2023,,,1,GD Phillips,H Klaasen,0,1,0,0,1,0,1,0,0,0,0,0,0
6480bb94d8aa9021808a4760,2017,,,1,DA Warner,Yuvraj Singh,0,2,0,0,1,0,2,0,0,0,0,0,0
6480bb9c21492b9a562c6f46,2009/10,,,1,MJ Lumb,NV Ojha,0,1,0,0,1,0,1,0,0,0,0,0,0
6480bb9a325c576efe386437,2023,,,1,GJ Maxwell,V Kohli,0,1,0,0,1,0,1,0,0,0,0,0,0
6480bb96e18d7a1b3e62552d,2019,,,2,M Ashwin,Mujeeb Ur Rahman,0,3,0,0,1,0,0,0,0,0,3,0,0
6480bb9404b444be6724e41e,2017,,,2,AM Rahane,RA Tripathi,0,1,0,0,1,0,1,0,0,0,0,0,0
6480bb99773871f8e2ddc4b1,2022,,,1,J Suchith,R Shepherd,0,1,0,0,1,0,1,0,0,0,0,0,0
6480bb9f4bdcea2f81049fe9,2012,,,1,P Negi,VR Aaron,0,2,0,0,1,0,0,0,0,0,2,0,0
6480bb9558345af5a1bb044d,2019,,,1,P Negi,UT Yadav,0,2,0,0,1,0,2,0,0,0,0,0,0
6480bb94009d0662ee94f07b,2018,,,1,M Markande,PJ Sangwan,0,1,0,0,1,0,0,0,0,0,1,0,0
6480bb9506d56930505d45ae,2019,,,1,Mandeep Singh,SM Curran,0,4,0,0,1,0,0,0,0,0,4,0,0
6480bb9825eb960aded1ff64,2022,,,2,AS Joseph,DA Miller,0,1,0,0,1,0,1,0,0,0,0,0,0
6480bba33195e5ebac1da82a,2016,,,1,Harbhajan Singh,KA Pollard,0,1,0,0,1,0,0,0,0,0,1,0,0
6480bb9808d6857eeb335d94,2022,,,1,TG Southee,UT Yadav,0,1,0,0,1,0,1,0,0,0,0,0,0
6480bba32e54551792a9e915,2016,,,1,AJ Finch,BB McCullum,0,2,0,0,1,0,2,0,0,0,0,0,0
6480bb9ac9149c73fdf073b3,2023,,,2,DA Warner,RR Rossouw,0,1,0,0,1,0,0,0,0,0,1,0,0
6480bb95816d3ad3bc382ab6,2018,,,2,TG Southee,UT Yadav,0,1,0,0,1,0,0,0,0,0,1,0,0
6480bb998454ba791a8fdbf8,2023,,,2,RG Sharma,SA Yadav,0,1,0,0,1,0,0,0,0,0,1,0,0
6480bb9d872bbb611f6266cb,2011,,,1,AM Nayar,PC Valthaty,0,1,0,0,1,0,1,0,0,0,0,0,0
6480bb9de80788b3c3ebe4e1,2009/10,,,2,AT Rayudu,SR Tendulkar,0,3,0,0,1,0,3,0,0,0,0,0,0
6480bb9ddfb0f2f6f8e813e5,2011,,,1,R Vinay Kumar,RR Powar,0,1,0,0,1,0,0,0,0,0,1,0,0
6480bb93d9581d69657887c3,2017,,,1,Iqbal Abdulla,TS Mills,0,3,0,0,1,0,0,0,0,0,3,0,0
6480bb9a9dc58f49d783faa9,2023,,,1,GJ Maxwell,KD Karthik,0,2,0,0,1,0,0,0,0,0,2,0,0
6480bb9a81d7fd0ac0307b4d,2023,,,2,MP Stoinis,N Pooran,0,1,0,0,1,0,0,0,0,0,1,0,0
6480bb93d9581d69657887c3,2017,,,1,KM Jadhav,P Negi,0,2,0,0,1,0,2,0,0,0,0,0,0
6480bb96ebf33df82879ad4c,2020/21,,,1,KS Williamson,PK Garg,0,1,0,0,1,0,1,0,0,0,0,0,0
6480bb9d69cb9046a72d8fbe,2009/10,,,2,Harmeet Singh,RP Singh,0,1,0,0,1,0,1,0,0,0,0,0,0
6480bb9dd10e35e6145534dc,2011,,,2,AJ Finch,V Sehwag,0,2,0,0,1,0,2,0,0,0,0,0,0
6480bb9fcbbfd8053f253537,2012,,,1,M Morkel,S Nadeem,0,1,0,0,1,0,0,0,0,0,1,0,0
6480bba0cdc200ad3ab8fbf5,2014,,,2,CM Gautam,Harbhajan Singh,0,2,0,0,1,0,0,0,0,0,2,0,0
6480bb9c7b7d7712bdc663de,2009/10,,,2,A Symonds,AC Gilchrist,0,2,0,0,1,0,1,0,0,0,1,0,0
6480bb96b56e8d513b451da1,2020/21,,,1,Shubman Gill,T Banton,0,4,0,0,1,0,2,0,0,0,2,0,0
6480bb9541caaeddc9ddaac3,2019,,,2,JC Buttler,RA Tripathi,0,1,0,0,1,0,1,0,0,0,0,0,0
6480bb99b3179a9346d8883c,2022,,,2,DA Warner,KS Bharat,0,2,0,0,1,0,0,0,0,0,2,0,0
6480bb9df60a79ae5f20b748,2011,,,1,UBT Chand,V Sehwag,0,2,0,0,1,0,2,0,0,0,0,0,0
6480bb9e8dfd9ba30b93cbd8,2012,,,1,Ankit Sharma,DB Ravi Teja,0,2,0,0,1,0,0,0,0,0,2,0,0
6480bb9a24adc8d916dfe2db,2023,,,1,MD Shanaka,Rashid Khan,0,1,0,0,1,0,0,0,0,0,1,0,0
6480bb9873e53eace3a69dc7,2022,,,1,AS Joseph,Yash Dayal,0,1,0,0,1,0,0,0,0,0,1,0,0
6480bba2bae80e615447f251,2015,,,2,Iqbal Abdulla,YS Chahal,0,3,0,0,1,0,3,0,0,0,0,0,0
6480bb99350726d00af209bf,2022,,,2,Abhishek Sharma,KS Williamson,0,1,0,0,1,0,1,0,0,0,0,0,0
6480bb985efffbcafdef9f19,2021,,,2,AK Markram,DJ Hooda,0,2,0,0,1,0,0,0,0,0,2,0,0
6480bb9b283b30d0503656f7,2007/08,,,2,DP Vijaykumar,RP Singh,0,1,0,0,1,0,0,0,0,0,1,0,0
6480bb9ee0795047740de5a7,2011,,,1,A Singh,SK Trivedi,0,1,0,0,1,0,1,0,0,0,0,0,0
6480bb9c266a85f1960d87e9,2009,,,2,LA Pomersbach,Yuvraj Singh,0,7,0,0,1,0,2,0,0,0,5,0,0
6480bb94dfad571ef76493a9,2017,,,1,KK Nair,SV Samson,0,1,0,0,1,0,0,0,0,0,1,0,0
6480bb9558c0acb502a3b1a9,2019,,,2,PP Shaw,S Dhawan,0,1,0,0,1,0,1,0,0,0,0,0,0
6480bb95f45dffe4751efc46,2019,,,2,KL Rahul,MA Agarwal,0,2,0,0,1,0,0,0,0,0,2,0,0
6480bba07b5396a7b65684d3,2013,,,2,R Bhatia,R McLaren,0,1,0,0,1,0,0,0,0,0,1,0,0
6480bba0a3e806f41a4dab41,2013,,,1,G Gambhir,MS Bisla,0,2,0,0,1,0,0,0,0,0,2,0,0
6480bb9deba74e341b44c765,2009/10,,,2,Anirudh Singh,MD Mishra,0,3,0,0,1,0,2,0,0,0,1,0,0
6480bb9ea75f51e7a33e90ed,2012,,,2,Bipul Sharma,PP Chawla,0,2,0,0,1,0,0,0,0,0,2,0,0
6480bb9b3a5e1af467fb027b,2009,,,1,R Bishnoi,R Dravid,0,2,0,0,1,0,1,0,0,0,1,0,0
6480bb9cd0eb4289b2222e37,2009/10,,,2,MM Patel,SK Trivedi,0,1,0,0,1,0,0,0,0,0,1,0,0
6480bba0f858e6c12b25d8c3,2014,,,1,CA Lynn,JH Kallis,0,6,0,0,1,0,5,0,0,0,1,0,0
6480bba3d3dc891a3092643e,2016,,,2,AR Patel,R Dhawan,0,1,0,0,1,0,1,0,0,0,0,0,0
6480bb9ee779ef1e445d0506,2012,,,2,MK Pandey,SC Ganguly,0,5,0,0,1,0,5,0,0,0,0,0,0
6480bb9d3c4dfa9f054aa47f,2011,,,2,SK Warne,SW Tait,0,1,0,0,1,0,0,0,0,0,1,0,0
6480bba06e8cb70fb4bdc83e,2013,,,2,A Ashish Reddy,GH Vihari,0,1,0,0,1,0,1,0,0,0,0,0,0
6480bb95085c25712f29bd36,2019,,,2,F du Plessis,SK Raina,0,1,0,0,1,0,0,0,0,0,1,0,0
6480bb9b2de4e62ee60b7e5c,2009,,,1,JH Kallis,KP Pietersen,0,2,0,0,1,0,0,0,0,0,2,0,0
6480bb9f70156528a31bb270,2013,,,2,AT Rayudu,KA Pollard,0,1,0,0,1,0,1,0,0,0,0,0,0
6480bba15b304732a6212cdf,2015,,,1,BB McCullum,RA Jadeja,0,1,0,0,1,0,0,0,0,0,1,0,0
6480bb971ffe5345804e7f32,2020/21,,,1,PP Shaw,S Dhawan,0,1,0,0,1,0,1,0,0,0,0,0,0
6480bb9bed3e2a1a008f93a6,2007/08,,,2,A Chopra,SC Ganguly,0,1,0,0,1,0,0,0,0,0,1,0,0
6480bba2a94dd2c01769b3ae,2016,,,1,AJ Finch,DR Smith,0,2,0,0,1,0,1,0,0,0,1,0,0
6480bba2f36e449a59f4a812,2015,,,1,AD Mathews,MA Agarwal,0,1,0,0,1,0,1,0,0,0,0,0,0
6480bb94ee669473878c11c2,2017,,,1,C de Grandhomme,SA Yadav,0,2,0,0,1,0,2,0,0,0,0,0,0
6480bb97372fc5d5ef4c436a,2021,,,2,JC Buttler,SV Samson,0,2,0,0,1,0,2,0,0,0,0,0,0
6480bb9c17dcdfd5b06984f0,2009/10,,,2,CK Langeveldt,WP Saha,0,1,0,0,1,0,1,0,0,0,0,0,0
6480bb9a6a7169d0e413bcfa,2023,,,2,KH Pandya,Swapnil Singh,0,1,0,0,1,0,1,0,0,0,0,0,0
6480bb9b2ca4a7b325526f1f,2009,,,2,GC Smith,SA Asnodkar,0,2,0,0,1,0,2,0,0,0,0,0,0
6480bb9edb0554f003f5428a,2012,,,2,DL Vettori,R Vinay Kumar,0,1,0,0,0,0,0,0,0,0,1,0,0
6480bb970d7cbd85b6ada680,2021,,,2,DR Sams,KA Jamieson,0,1,0,0,1,0,1,0,0,0,0,0,0
6480bb9d59f2ded94f736145,2011,,,1,BB McCullum,DPMD Jayawardene,0,4,0,0,1,0,4,0,0,0,0,0,0
6480bba1f2392e6761d39d66,2014,,,2,AT Rayudu,Harbhajan Singh,0,1,0,0,1,0,1,0,0,0,0,0,0
6480bb9f02801d2090cdba0d,2012,,,2,Harbhajan Singh,KD Karthik,0,1,0,0,1,0,1,0,0,0,0,0,0
6480bb9808d6857eeb335d94,2022,,,1,Harshit Rana,UT Yadav,0,1,0,0,0,0,1,0,0,0,0,0,0
6480bb9a0474602f26069e45,2007/08,,,2,PA Patel,SP Fleming,0,1,0,0,1,0,1,0,0,0,0,0,0
6480bb9ed6aefcc9cd13d851,2012,,,2,MJ Clarke,MK Pandey,0,1,0,0,1,0,0,0,0,0,1,0,0
6480bb976344f6d667dfd965,2021,,,2,EJG Morgan,N Rana,0,2,0,0,1,0,2,0,0,0,0,0,0
6480bb9ce93a7b4315d8fa30,2009,,,1,RP Singh,WPUJC Vaas,0,1,0,0,1,0,1,0,0,0,0,0,0
6480bb9c9e328ac30bcaf6b0,2009/10,,,1,MEK Hussey,ML Hayden,0,1,0,0,1,0,0,0,0,0,1,0,0
6480bb98cbaaf700d226941a,2022,,,2,DR Sams,KA Pollard,0,1,0,0,1,0,1,0,0,0,0,0,0
6480bb94c008939d7976abfe,2018,,,2,C Munro,GJ Maxwell,0,1,0,0,1,0,0,0,0,0,1,0,0
6480bb9f54d17f50da495682,2012,,,2,DPMD Jayawardene,Y Venugopal Rao,0,2,0,0,1,0,2,0,0,0,0,0,0
6480bba090c88df75eba18e6,2014,,,2,PA Patel,V Kohli,0,1,0,0,1,0,0,0,0,0,1,0,0
6480bb995193664eda3e9e10,2022,,,2,KA Pollard,M Ashwin,0,2,0,0,1,0,0,0,0,0,2,0,0
6480bb96ed06a5693a66b9f0,2020/21,,,2,AB de Villiers,V Kohli,0,1,0,0,1,0,0,0,0,0,1,0,0
6480bb9af1b34d6aa89e434e,2023,,,2,Harpreet Brar,LS Livingstone,0,1,0,0,1,0,1,0,0,0,0,0,0
6480bb942efd740a6ffc47df,2017,,,1,JC Buttler,PA Patel,0,1,0,0,1,0,0,0,0,0,1,0,0
6480bba03b6f98689b851317,2013,,,1,MS Bisla,YK Pathan,0,1,0,0,1,0,0,0,0,0,1,0,0
6480bb9aa37f3b44678752d9,2023,,,2,R Tewatia,Rashid Khan,0,1,0,0,1,0,1,0,0,0,0,0,0
6480bb9996eb97dd08b62f78,2023,,,1,F du Plessis,GJ Maxwell,0,1,0,0,1,0,0,0,0,0,1,0,0
6480bb94640655c49683aee1,2018,,,2,H Klaasen,JC Buttler,0,1,0,0,1,0,0,0,0,0,1,0,0
6480bb9f2305d07e3c65be11,2013,,,2,Gurkeerat Singh,M Vohra,0,1,0,0,1,0,0,0,0,0,1,0,0
6480bb9b77a0ff5cb3d0e3e0,2009,,,1,MS Dhoni,SB Jakati,0,1,0,0,1,0,1,0,0,0,0,0,0
6480bb96ed06a5693a66b9f0,2020/21,,,1,SPD Smith,SV Samson,0,1,0,0,1,0,0,0,0,0,1,0,0
6480bba3b818a7cff6fe4f89,2016,,,1,DA Warner,Yuvraj Singh,0,1,0,0,1,0,1,0,0,0,0,0,0
6480bb9b52b93b56f5a16e52,2007/08,,,2,SA Asnodkar,Sohail Tanvir,0,2,0,0,1,0,2,0,0,0,0,0,0
6480bb9359a2cade3b5213d3,2017,,,2,PA Patel,RG Sharma,0,3,0,0,1,0,2,0,0,0,1,0,0
6480bb99f47261f111a6cc1a,2023,,,2,SA Yadav,TH David,0,2,0,0,1,0,0,0,0,0,2,0,0
6480bb9ade063258af41163b,2007/08,,,2,A Symonds,RG Sharma,0,3,0,0,1,0,0,0,0,0,3,0,0
6480bb9f777b7b1e89543a6e,2013,,,2,AT Rayudu,SL Malinga,0,6,0,0,1,0,1,0,0,0,5,0,0
6480bb988545a7776b8c9306,2022,,,1,RA Jadeja,S Dube,0,1,0,0,1,0,1,0,0,0,0,0,0
6480bba2704d23da78c3eb15,2016,,,2,M Vijay,WP Saha,0,1,0,0,1,0,1,0,0,0,0,0,0
6480bb948f3284f793b2763c,2018,,,1,E Lewis,SA Yadav,0,1,0,0,1,0,0,0,0,0,1,0,0
6480bb9a07d46704efe103ef,2007/08,,,1,AS Yadav,WPUJC Vaas,0,5,0,0,1,0,2,0,0,0,3,0,0
6480bb9439fcd1191cf17a90,2017,,,1,AD Nath,KD Karthik,0,1,0,0,1,0,1,0,0,0,0,0,0
6480bba01893b0faadb9c761,2013,,,1,Harbhajan Singh,KA Pollard,0,1,0,0,1,0,0,0,0,0,1,0,0
6480bba071a7a0cbb02d505a,2013,,,2,DA Miller,Mandeep Singh,0,1,0,0,1,0,1,0,0,0,0,0,0
6480bb987c52e15a2cac0697,2022,,,1,K Rabada,RD Chahar,0,2,0,0,1,0,0,0,0,0,2,0,0
6480bba326249b668a4713d6,2016,,,1,MK Pandey,RV Uthappa,0,2,0,0,1,0,2,0,0,0,0,0,0
6480bb97220be892fbfc2a36,2021,,,1,JJ Bumrah,RD Chahar,0,1,0,0,1,0,1,0,0,0,0,0,0
6480bb97493381c4d7dc7bf4,2021,,,1,C Sakariya,S Gopal,0,1,0,0,1,0,1,0,0,0,0,0,0
6480bb9740aaba2132c0eb0e,2021,,,1,AT Rayudu,F du Plessis,0,1,0,0,1,0,0,0,0,0,1,0,0
6480bb9a577cde04d3672225,2023,,,2,MS Dhoni,S Dube,0,1,0,0,1,0,1,0,0,0,0,0,0
6480bb9e21655ee16a96b2c3,2012,,,1,CH Gayle,V Kohli,0,2,0,0,1,0,2,0,0,0,0,0,0
6480bb991a4f7e5f59dd1afc,2023,,,2,N Jagadeesan,Rahmanullah Gurbaz,0,3,0,0,1,0,0,0,0,0,3,0,0
6480bb9bdde9db92f880e40d,2007/08,,,2,DPMD Jayawardene,PP Chawla,0,1,0,0,1,0,0,0,0,0,1,0,0
6480bb9c37b72d7a51019794,2009/10,,,2,AS Raut,SR Watson,0,3,0,0,1,0,3,0,0,0,0,0,0
6480bba30373b229e0090b67,2016,,,1,DA Miller,M Vijay,0,1,0,0,1,0,1,0,0,0,0,0,0
6480bb9a8cf29e28434bb1d5,2023,,,1,A Nortje,Kuldeep Yadav,0,1,0,0,0,0,0,0,0,0,1,0,0
6480bb99d43295fa2d82c9dc,2023,,,2,DA Warner,MR Marsh,0,6,0,0,1,0,2,0,0,0,4,0,0
6480bb9af968df9497d2b9c4,2007/08,,,2,MK Pandey,RV Uthappa,0,3,0,0,1,0,1,0,0,0,2,0,0
6480bb9c3803ef7726af83ab,2009/10,,,1,MS Dhoni,S Badrinath,0,1,0,0,1,0,1,0,0,0,0,0,0
6480bba273adb498d96b27a9,2016,,,1,CH Morris,SW Billings,0,2,0,0,1,0,2,0,0,0,0,0,0
6480bb98436587de59527f2e,2022,,,2,Lalit Yadav,R Powell,0,2,0,0,1,0,0,0,0,0,2,0,0
6480bb9824c4678d005d7aeb,2022,,,2,AJ Finch,SP Narine,0,1,0,0,1,0,1,0,0,0,0,0,0
6480bb945460b25d997060fb,2018,,,1,PP Chawla,TK Curran,0,3,0,0,1,0,3,0,0,0,0,0,0
6480bb990942cd416cf5f447,2022,,,2,DJ Hooda,PVD Chameera,0,1,0,0,1,0,1,0,0,0,0,0,0
6480bb97aed297ca9686c94a,2021,,,1,DJ Hooda,N Pooran,0,2,0,0,1,0,0,0,0,0,2,0,0
6480bb99358a21ba3487db81,2023,,,1,AK Markram,RA Tripathi,0,1,0,0,1,0,1,0,0,0,0,0,0
6480bba01a3f8444c7a33ba6,2014,,,1,STR Binny,SV Samson,0,1,0,0,1,0,0,0,0,0,1,0,0
6480bb97a42828c5a5ebef1c,2020/21,,,2,AM Rahane,S Dhawan,0,3,0,0,1,0,3,0,0,0,0,0,0
6480bb9c3b082d71291a593c,2009,,,2,L Balaji,SB Jakati,0,1,0,0,1,0,1,0,0,0,0,0,0
6480bba0c9e6d590ed35eb56,2014,,,1,PA Patel,Yuvraj Singh,0,2,0,0,1,0,0,0,0,0,2,0,0
6480bba237377ccc608266d2,2016,,,2,PA Patel,RG Sharma,0,2,0,0,1,0,0,0,0,0,2,0,0
6480bb947a7c9fe868fc901a,2017,,,1,KK Nair,SV Samson,0,2,0,0,1,0,0,0,0,0,2,0,0
6480bb9e65a802582c071438,2012,,,2,AT Rayudu,Harbhajan Singh,0,2,0,0,1,0,0,0,0,0,2,0,0
6480bb9eb2690fb1ed356b42,2011,,,1,DS Kulkarni,Harbhajan Singh,0,1,0,0,0,0,0,0,0,0,1,0,0
6480bb9e41b781523bd5aafe,2012,,,1,G Gambhir,MK Tiwary,0,1,0,0,1,0,0,0,0,0,1,0,0
6480bb96b56e8d513b451da1,2020/21,,,2,D Padikkal,Gurkeerat Singh,0,2,0,0,1,0,0,0,0,0,2,0,0
6480bba3fc9599eca1b87a77,2016,,,1,AB de Villiers,SR Watson,0,1,0,0,1,0,0,0,0,0,1,0,0
6480bb995193664eda3e9e10,2022,,,2,JJ Bumrah,RP Meredith,0,1,0,0,1,0,0,0,0,0,1,0,0
6480bb9b1087ddfd207caa83,2009,,,2,RS Bopara,Yuvraj Singh,0,1,0,0,1,0,1,0,0,0,0,0,0
6480bb9e713e850d3dd0cba9,2012,,,2,MK Tiwary,SP Narine,0,1,0,0,1,0,0,0,0,0,1,0,0
6480bb950c59218964b27cc0,2018,,,2,KL Rahul,R Ashwin,0,2,0,0,1,0,0,0,0,0,2,0,0
6480bb9e300070746cc2eb67,2011,,,1,S Badrinath,SK Raina,0,1,0,0,1,0,0,0,0,0,1,0,0
6480bba08cc4182f0127f2e2,2013,,,2,MEK Hussey,S Badrinath,0,3,0,0,1,0,0,0,0,0,3,0,0
6480bb9c0dec1a788da66d33,2009/10,,,1,AA Jhunjhunwala,S Narwal,0,1,0,0,1,0,1,0,0,0,0,0,0
6480bb95430629e254bbc4fd,2018,,,2,RV Uthappa,Shubman Gill,0,2,0,0,1,0,1,0,0,0,1,0,0
6480bb9938b659481e3ab6dc,2022,,,2,Shubman Gill,WP Saha,0,2,0,0,1,0,0,0,0,0,2,0,0
6480bb9a07d46704efe103ef,2007/08,,,1,DP Vijaykumar,RP Singh,0,2,0,0,1,0,0,0,0,0,2,0,0
6480bba28257fe87dd859e3e,2015,,,1,AR Patel,WP Saha,0,1,0,0,1,0,1,0,0,0,0,0,0
6480bba2b7be71a15b2bb3de,2015,,,1,KA Pollard,LMP Simmons,0,1,0,0,1,0,0,0,0,0,1,0,0
6480bb948211fe47e65f2e77,2018,,,1,KS Williamson,WP Saha,0,2,0,0,1,0,0,0,0,0,2,0,0
6480bb9a365c63af4b3de24c,2023,,,2,AR Patel,MK Pandey,0,1,0,0,1,0,1,0,0,0,0,0,0
6480bba3fc9599eca1b87a77,2016,,,2,AJ Finch,RA Jadeja,0,1,0,0,1,0,0,0,0,0,1,0,0
6480bb995193664eda3e9e10,2022,,,1,RK Singh,SP Narine,0,1,0,0,1,0,0,0,0,0,1,0,0
6480bba048fb3d33ea0711e7,2013,,,2,BB Samantray,PA Patel,0,1,0,0,1,0,1,0,0,0,0,0,0
6480bb94ee669473878c11c2,2017,,,2,P Negi,STR Binny,0,3,0,0,1,0,0,0,0,0,3,0,0
6480bb9737b1d7284b5297c1,2021,,,1,KA Pollard,M Jansen,0,1,0,0,1,0,1,0,0,0,0,0,0
6480bb954714437843ab3647,2019,,,2,KK Ahmed,Sandeep Sharma,0,1,0,0,1,0,1,0,0,0,0,0,0
6480bb9aef150645306cc170,2023,,,1,Abhishek Sharma,HC Brook,0,2,0,0,1,0,0,0,0,0,2,0,0
6480bb93f866249511c76dbc,2017,,,2,AM Rahane,RA Tripathi,0,3,0,0,1,0,3,0,0,0,0,0,0
6480bba1b8e3071cc513602a,2014,,,1,KW Richardson,R Bhatia,0,1,0,0,1,0,0,0,0,0,1,0,0
6480bb9b9d7aa6d8e47576d7,2007/08,,,2,RA Jadeja,YK Pathan,0,1,0,0,1,0,1,0,0,0,0,0,0
6480bb95960e393c939ab44c,2018,,,2,KA Pollard,RG Sharma,0,1,0,0,1,0,1,0,0,0,0,0,0
6480bba090c88df75eba18e6,2014,,,2,AB Dinda,YS Chahal,0,3,0,0,1,0,3,0,0,0,0,0,0
6480bb9c3b082d71291a593c,2009,,,2,JDP Oram,SB Jakati,0,4,0,0,1,0,2,0,0,0,2,0,0
6480bb99c6aa5989a16174d1,2023,,,1,KD Karthik,SS Prabhudessai,0,2,0,0,1,0,0,0,0,0,2,0,0
6480bb9359a2cade3b5213d3,2017,,,2,MJ McClenaghan,RG Sharma,0,1,0,0,1,0,1,0,0,0,0,0,0
6480bb97668d35800fa74139,2021,,,1,CH Gayle,N Pooran,0,1,0,0,1,0,1,0,0,0,0,0,0
6480bb9c2778066dafd78a71,2009/10,,,2,HH Gibbs,VVS Laxman,0,1,0,0,1,0,1,0,0,0,0,0,0
6480bba1827557ebdfc70821,2015,,,2,RN ten Doeschate,YK Pathan,0,1,0,0,1,0,1,0,0,0,0,0,0
6480bb98af25209ef756aa2c,2021,,,2,AF Milne,RD Chahar,0,1,0,0,1,0,0,0,0,0,1,0,0
6480bb9bc8bcea920f081be8,2009,,,1,JH Kallis,RV Uthappa,0,1,0,0,1,0,1,0,0,0,0,0,0
6480bb9b46b4360184dc19f3,2007/08,,,1,DB Ravi Teja,RG Sharma,0,1,0,0,1,0,1,0,0,0,0,0,0
6480bba11eff9b230a172302,2014,,,1,R Vinay Kumar,Shakib Al Hasan,0,1,0,0,1,0,1,0,0,0,0,0,0
6480bb9bfcaabf33b5687e32,2007/08,,,1,RA Jadeja,SR Watson,0,3,0,0,1,0,0,0,0,0,3,0,0
6480bb9b7b8617115de9683b,2007/08,,,1,AS Yadav,Shahid Afridi,0,1,0,0,1,0,1,0,0,0,0,0,0
6480bb9d872bbb611f6266cb,2011,,,2,M Vijay,S Anirudha,0,1,0,0,1,0,0,0,0,0,1,0,0
6480bba20559f15c3489f637,2015,,,2,KV Sharma,P Kumar,0,2,0,0,1,0,0,0,0,0,2,0,0
6480bba0b5eabeb0a150b93f,2013,,,2,IC Pandey,M Manhas,0,2,0,0,1,0,2,0,0,0,0,0,0
6480bb9a07d46704efe103ef,2007/08,,,1,LPC Silva,RG Sharma,0,5,0,0,1,0,2,0,0,0,3,0,0
6480bb9db6a011b38afed5dc,2011,,,2,BB McCullum,VVS Laxman,0,1,0,0,1,0,1,0,0,0,0,0,0
6480bb9d1f9a3cf1fa86e11c,2011,,,2,JJ van der Wath,V Kohli,0,1,0,0,1,0,1,0,0,0,0,0,0
6480bb9f9eae77e599a46300,2012,,,1,DR Smith,KA Pollard,0,1,0,0,1,0,1,0,0,0,0,0,0
6480bba2f39653e2f61baca2,2015,,,2,MA Agarwal,SS Iyer,0,1,0,0,1,0,1,0,0,0,0,0,0
6480bb999424dd02cf40772a,2022,,,2,E Lewis,KH Pandya,0,1,0,0,1,0,0,0,0,0,1,0,0
6480bb9c7a11e1cbeea46b0e,2009/10,,,2,A Uniyal,AD Mascarenhas,0,1,0,0,1,0,1,0,0,0,0,0,0
6480bb94c5d20726ee59d3d6,2017,,,1,CH Gayle,Mandeep Singh,0,1,0,0,1,0,1,0,0,0,0,0,0
6480bb9b72f6a46338302131,2009,,,2,Harbhajan Singh,JP Duminy,0,1,0,0,1,0,1,0,0,0,0,0,0
6480bb94cb5adf24f5ad15c3,2017,,,1,AT Rayudu,PA Patel,0,3,0,0,1,0,3,0,0,0,0,0,0
6480bb9a24adc8d916dfe2db,2023,,,1,MD Shanaka,Noor Ahmad,0,1,0,0,1,0,0,0,0,0,1,0,0
6480bb9384cbae8edee3707f,2017,,,2,KK Nair,RR Pant,0,9,0,0,1,0,6,0,0,0,3,0,0
6480bb9ef8d4c23c6e5be4c7,2011,,,2,RP Singh,RR Powar,0,1,0,0,1,0,0,0,0,0,1,0,0
6480bb9e34659755628e7471,2012,,,1,MK Pandey,R Sharma,0,2,0,0,0,0,0,0,0,0,2,0,0
6480bb9cff4ec2f71cdf18d1,2009/10,,,2,B Lee,SE Marsh,0,1,0,0,1,0,0,0,0,0,1,0,0
6480bb974123cbc9756ceefa,2021,,,1,GHS Garton,KS Bharat,0,1,0,0,1,0,1,0,0,0,0,0,0
6480bb945901306d3cb2b759,2018,,,2,B Laughlin,S Gopal,0,1,0,0,1,0,1,0,0,0,0,0,0
6480bb98aae066234fd8f11e,2022,,,2,KK Ahmed,Kuldeep Yadav,0,1,0,0,1,0,1,0,0,0,0,0,0
6480bb9fe3bc767415c60bfa,2012,,,1,IK Pathan,M Morkel,0,1,0,0,1,0,0,0,0,0,1,0,0
6480bb9c9685addc4a78d7d0,2009/10,,,1,RS Bopara,Yuvraj Singh,0,2,0,0,1,0,2,0,0,0,0,0,0
6480bba20559f15c3489f637,2015,,,2,DW Steyn,KV Sharma,0,1,0,0,1,0,1,0,0,0,0,0,0
6480bba3fc9599eca1b87a77,2016,,,2,PV Tambe,S Kaushik,0,1,0,0,1,0,0,0,0,0,1,0,0
6480bb9af85f41b4de44ca19,2023,,,2,DG Nalkande,Rashid Khan,0,1,0,0,1,0,1,0,0,0,0,0,0
6480bb9e83b8575f74b8e962,2012,,,2,RR Bhatkal,V Kohli,0,1,0,0,1,0,0,0,0,0,1,0,0
6480bb9ed6aefcc9cd13d851,2012,,,1,PA Patel,S Dhawan,0,1,0,0,1,0,1,0,0,0,0,0,0
6480bb9541caaeddc9ddaac3,2019,,,2,AM Rahane,JC Buttler,0,2,0,0,1,0,2,0,0,0,0,0,0
6480bba154ce29a67e4752df,2015,,,2,AT Rayudu,RG Sharma,0,1,0,0,1,0,1,0,0,0,0,0,0
6480bb9824c4678d005d7aeb,2022,,,2,PJ Cummins,SP Jackson,0,1,0,0,1,0,1,0,0,0,0,0,0
6480bb9341152e168005ccc9,2017,,,2,MK Tiwary,SN Thakur,0,1,0,0,1,0,0,0,0,0,1,0,0
6480bb9d59f2ded94f736145,2011,,,2,A Mishra,DB Ravi Teja,0,1,0,0,1,0,1,0,0,0,0,0,0
6480bb94cfe5aeb50e36aef3,2017,,,1,AJ Finch,KD Karthik,0,1,0,0,1,0,0,0,0,0,1,0,0
6480bb9dd89d4266d59a4592,2011,,,1,AB de Villiers,AUK Pathan,0,1,0,0,1,0,0,0,0,0,1,0,0
6480bb9a7577454a5220c94b,2007/08,,,2,RA Jadeja,SA Asnodkar,0,2,0,0,1,0,1,0,0,0,1,0,0
6480bb9cf1471ad233c7b0af,2009,,,2,A Singh,SK Warne,0,1,0,0,1,0,1,0,0,0,0,0,0
6480bb95c701f5c8388f7f88,2018,,,1,AJ Finch,KK Nair,0,2,0,0,1,0,0,0,0,0,2,0,0
6480bba1603d86b7d278a366,2015,,,2,A Nehra,MM Sharma,0,2,0,0,1,0,1,0,0,0,1,0,0
6480bb9435048f20502ba1e1,2018,,,2,JP Duminy,RG Sharma,0,1,0,0,1,0,0,0,0,0,1,0,0
6480bb9efe3f9991539e7f6c,2012,,,1,AC Gilchrist,PC Valthaty,0,1,0,0,1,0,0,0,0,0,1,0,0
6480bb99d43295fa2d82c9dc,2023,,,1,KD Karthik,Shahbaz Ahmed,0,1,0,0,1,0,1,0,0,0,0,0,0
6480bb9d76ba2d9dd45c74a8,2011,,,2,PA Patel,RV Gomez,0,1,0,0,1,0,1,0,0,0,0,0,0
6480bb9d6919e7181371271f,2011,,,1,GC Smith,JD Ryder,0,1,0,0,1,0,1,0,0,0,0,0,0
6480bb95b33a36f0dd77d1a1,2018,,,1,E Lewis,RG Sharma,0,1,0,0,1,0,0,0,0,0,1,0,0
6480bb9f7bae5ad85c4473ba,2012,,,2,R Ashwin,S Badrinath,0,1,0,0,1,0,1,0,0,0,0,0,0
6480bb98b8bb5b0d2c2f0848,2022,,,2,RD Gaikwad,RV Uthappa,0,1,0,0,1,0,1,0,0,0,0,0,0
6480bb952f20835ddd6e533f,2019,,,2,K Gowtham,S Gopal,0,1,0,0,1,0,1,0,0,0,0,0,0
6480bb9b8860198955e581d8,2007/08,,,2,S Sreesanth,VRV Singh,0,1,0,0,1,0,0,0,0,0,1,0,0
6480bba000b91f6c5cf57fdb,2013,,,1,A Mishra,NLTC Perera,0,1,0,0,1,0,0,0,0,0,1,0,0
6480bb9c71030f4c6f018f55,2009,,,1,RG Sharma,Y Venugopal Rao,0,1,0,0,1,0,0,0,0,0,1,0,0
6480bb9ac9149c73fdf073b3,2023,,,1,DP Conway,MS Dhoni,0,2,0,0,1,0,2,0,0,0,0,0,0
6480bb945f95e767a8a9cc10,2017,,,2,Ankit Soni,Basil Thampi,0,1,0,0,1,0,1,0,0,0,0,0,0
6480bb9cd0eb4289b2222e37,2009/10,,,2,P Dogra,S Narwal,0,1,0,0,1,0,0,0,0,0,1,0,0
6480bb9ddfb0f2f6f8e813e5,2011,,,1,R Vinay Kumar,S Sreesanth,0,2,0,0,1,0,0,0,0,0,2,0,0
6480bb93f866249511c76dbc,2017,,,2,MK Tiwary,SN Thakur,0,1,0,0,1,0,1,0,0,0,0,0,0
6480bb9ea49fe0f895bf242a,2012,,,2,AA Chavan,GB Hogg,0,1,0,0,1,0,1,0,0,0,0,0,0
6480bb9929c7e430acd1ef18,2022,,,1,MS Dhoni,RV Uthappa,0,1,0,0,1,0,0,0,0,0,1,0,0
6480bb9dc8b09381d0f01a9d,2011,,,2,M Kartik,NL McCullum,0,1,0,0,1,0,0,0,0,0,1,0,0
6480bb984a44a355b856fd1a,2022,,,1,KD Karthik,Shahbaz Ahmed,0,3,0,0,1,0,3,0,0,0,0,0,0
6480bb958f77e7d3929d28e3,2018,,,1,AJ Tye,KK Nair,0,2,0,0,1,0,2,0,0,0,0,0,0
6480bb9bee2e48d9c41b1e23,2009,,,2,AC Gilchrist,HH Gibbs,0,1,0,0,1,0,1,0,0,0,0,0,0
6480bb97a42828c5a5ebef1c,2020/21,,,2,S Dhawan,SS Iyer,0,3,0,0,1,0,2,0,0,0,1,0,0
6480bb9e19dd5297ba8ca5f7,2011,,,1,M Manhas,Yuvraj Singh,0,1,0,0,1,0,1,0,0,0,0,0,0
6480bb967d799ced7fe5d8e9,2020/21,,,1,KL Rahul,N Pooran,0,1,0,0,1,0,1,0,0,0,0,0,0
6480bb9f2305d07e3c65be11,2013,,,2,AD Mascarenhas,Gurkeerat Singh,0,1,0,0,1,0,0,0,0,0,1,0,0
6480bb966c9efd5bf35d10b9,2019,,,1,CA Lynn,Shubman Gill,0,3,0,0,1,0,3,0,0,0,0,0,0
6480bb9f87652064dab6c573,2013,,,2,G Gambhir,MS Bisla,0,1,0,0,1,0,0,0,0,0,1,0,0
6480bb9b69f390d624466843,2007/08,,,1,DJ Hussey,Salman Butt,0,1,0,0,1,0,1,0,0,0,0,0,0
6480bb988b447f26d7a96c0c,2022,,,2,Ishan Kishan,SA Yadav,0,3,0,0,1,0,2,0,0,0,1,0,0
6480bba234aac105851964b1,2015,,,2,MA Starc,S Aravind,0,1,0,0,0,0,0,0,0,0,1,0,0
6480bb967d799ced7fe5d8e9,2020/21,,,2,PK Garg,T Natarajan,0,1,0,0,1,0,1,0,0,0,0,0,0
6480bb9f210b6e50fb2072ae,2013,,,2,PJ Sangwan,R Bhatia,0,1,0,0,1,0,0,0,0,0,1,0,0
6480bb9f36ad55c3c7fd6548,2012,,,2,G Gambhir,JH Kallis,0,1,0,0,1,0,0,0,0,0,1,0,0
6480bb954817ed0a4ba25bc2,2018,,,1,RG Sharma,SA Yadav,0,1,0,0,1,0,0,0,0,0,1,0,0
6480bb9e83b8575f74b8e962,2012,,,2,R Vinay Kumar,RR Bhatkal,0,1,0,0,1,0,0,0,0,0,1,0,0
6480bba179195d83fa7fbfbb,2014,,,1,JP Faulkner,STR Binny,0,1,0,0,1,0,0,0,0,0,1,0,0
6480bb990b96e91d3fbf421b,2022,,,1,PWH de Silva,Shahbaz Ahmed,0,1,0,0,1,0,1,0,0,0,0,0,0
6480bb99fe078839da40e7ab,2023,,,1,AD Russell,AS Roy,0,1,0,0,1,0,0,0,0,0,1,0,0
6480bb95c8ecc2185a67f4fd,2019,,,2,MK Pandey,YK Pathan,0,1,0,0,1,0,1,0,0,0,0,0,0
6480bb98d8f59b81335f4a3d,2021,,,1,D Padikkal,GJ Maxwell,0,1,0,0,1,0,1,0,0,0,0,0,0
6480bb99bb362e3714226928,2022,,,2,A Badoni,KL Rahul,0,1,0,0,1,0,1,0,0,0,0,0,0
6480bb98d2cd0fa3ed0ffc21,2022,,,1,OF Smith,RD Chahar,0,2,0,0,1,0,0,0,0,0,2,0,0
6480bb97cca23939859c422e,2021,,,2,KS Williamson,Rashid Khan,0,1,0,0,1,0,0,0,0,0,1,0,0
6480bb9c2f07203e8e510386,2009/10,,,2,G Gambhir,TM Dilshan,0,3,0,0,1,0,0,0,0,0,3,0,0
6480bb9a807eb5f39489408a,2023,,,2,DA Warner,PD Salt,0,2,0,0,1,0,2,0,0,0,0,0,0
6480bb970c637fd0c057dca9,2021,,,2,KM Jadhav,Rashid Khan,0,3,0,0,1,0,3,0,0,0,0,0,0
6480bb9c454e9eefca545bde,2009/10,,,1,S Sreesanth,SJ Srivastava,0,2,0,0,1,0,1,0,0,0,1,0,0
6480bb9498a98d52f9285b52,2017,,,1,B Kumar,Rashid Khan,0,1,0,0,1,0,0,0,0,0,1,0,0
6480bba2bae80e615447f251,2015,,,2,KD Karthik,SN Khan,0,1,0,0,1,0,1,0,0,0,0,0,0
6480bb9b62eb35d78fcd7df0,2007/08,,,2,MK Tiwary,S Dhawan,0,1,0,0,1,0,1,0,0,0,0,0,0
6480bb99433f6e11060ba714,2022,,,1,DA Warner,SN Khan,0,1,0,0,1,0,1,0,0,0,0,0,0
6480bb9a0474602f26069e45,2007/08,,,2,M Muralitharan,MS Gony,0,3,0,0,1,0,3,0,0,0,0,0,0
6480bb988b447f26d7a96c0c,2022,,,2,JJ Bumrah,TS Mills,0,1,0,0,0,0,0,0,0,0,1,0,0
6480bb966c197bad273f91f1,2020/21,,,2,JC Buttler,YBK Jaiswal,0,2,0,0,1,0,0,0,0,0,2,0,0
6480bb9bb7a4f1e16df25c8e,2009,,,1,JDP Oram,MS Gony,0,1,0,0,0,0,1,0,0,0,0,0,0
6480bb93575636076d81e4c5,2017,,,2,HM Amla,M Vohra,0,1,0,0,1,0,1,0,0,0,0,0,0
6480bb9b283b30d0503656f7,2007/08,,,2,PP Ojha,RP Singh,0,1,0,0,1,0,1,0,0,0,0,0,0
6480bb9c12e6c723b248799b,2009,,,2,AC Gilchrist,HH Gibbs,0,3,0,0,1,0,3,0,0,0,0,0,0
6480bba2b99fcf06aaeac805,2015,,,2,KK Nair,STR Binny,0,1,0,0,1,0,1,0,0,0,0,0,0
6480bb9ca21b98f1be8254e2,2009/10,,,2,A Kumble,A Mithun,0,1,0,0,1,0,0,0,0,0,1,0,0
6480bba2bae80e615447f251,2015,,,1,BB McCullum,DR Smith,0,6,0,0,1,0,0,0,0,0,6,0,0
6480bb9e56c724ba25b94666,2011,,,2,MM Patel,SL Malinga,0,1,0,0,1,0,1,0,0,0,0,0,0
6480bb9faf20f0bc714af2ea,2013,,,2,S Nadeem,UT Yadav,0,1,0,0,1,0,1,0,0,0,0,0,0
6480bb9940bd3bf36dd4897f,2023,,,2,A Badoni,MP Stoinis,0,1,0,0,1,0,0,0,0,0,1,0,0
6480bb980095555db76d49cb,2022,,,1,SA Yadav,Tilak Varma,0,3,0,0,1,0,0,0,0,0,3,0,0
6480bb9aded509be64de3bfb,2007/08,,,2,RT Ponting,SC Ganguly,0,1,0,0,1,0,1,0,0,0,0,0,0
6480bb95385ebb9bda58a643,2019,,,2,AR Patel,KMA Paul,0,1,0,0,1,0,1,0,0,0,0,0,0
6480bba01893b0faadb9c761,2013,,,1,AT Rayudu,KA Pollard,0,1,0,0,1,0,0,0,0,0,1,0,0
6480bb9d05f8e769574069fa,2009/10,,,2,AB Agarkar,I Sharma,0,2,0,0,1,0,0,0,0,0,2,0,0
6480bb9e56c724ba25b94666,2011,,,2,A Symonds,AC Blizzard,0,2,0,0,1,0,1,0,0,0,1,0,0
6480bb9772f78629131db057,2021,,,2,KL Rahul,SN Khan,0,3,0,0,1,0,0,0,0,0,3,0,0
6480bb9a1032ce724214f6dd,2007/08,,,1,DJ Bravo,SM Pollock,0,2,0,0,1,0,1,0,0,0,1,0,0
6480bb9af968df9497d2b9c4,2007/08,,,1,LR Shukla,Mohammad Hafeez,0,2,0,0,1,0,0,0,0,0,2,0,0
6480bba11c977a5d11c1aa38,2015,,,2,AD Mathews,Yuvraj Singh,0,1,0,0,1,0,0,0,0,0,1,0,0
6480bb9c89f35f11aae1f2d0,2009/10,,,2,MJ Lumb,NV Ojha,0,2,0,0,1,0,2,0,0,0,0,0,0
6480bb9aa64355ce98da1141,2007/08,,,1,CL White,V Kohli,0,1,0,0,1,0,1,0,0,0,0,0,0
6480bb99864a94e086c8395e,2022,,,2,R Sanjay Yadav,Ramandeep Singh,0,2,0,0,1,0,2,0,0,0,0,0,0
6480bba090c88df75eba18e6,2014,,,2,AB de Villiers,V Kohli,0,1,0,0,1,0,1,0,0,0,0,0,0
6480bba1b8e3071cc513602a,2014,,,1,AM Rahane,KK Nair,0,3,0,0,1,0,3,0,0,0,0,0,0
6480bb9a7577454a5220c94b,2007/08,,,2,MM Patel,SK Trivedi,0,3,0,0,1,0,1,0,0,0,2,0,0
6480bb9da9ca2f2d3738d79e,2011,,,2,RV Uthappa,TD Paine,0,3,0,0,1,0,1,0,0,0,2,0,0
6480bb95481ab7c06b86419b,2018,,,1,JJ Roy,SS Iyer,0,1,0,0,1,0,1,0,0,0,0,0,0
6480bb9574ca455ec008e942,2018,,,2,Kuldeep Yadav,M Prasidh Krishna,0,3,0,0,0,0,3,0,0,0,0,0,0
6480bb9558345af5a1bb044d,2019,,,1,AD Nath,P Negi,0,1,0,0,1,0,1,0,0,0,0,0,0
6480bba2aecb4103bab63c15,2016,,,2,G Gambhir,RV Uthappa,0,1,0,0,1,0,0,0,0,0,1,0,0
6480bb9bc80883a975281815,2009,,,1,LRPL Taylor,RV Uthappa,0,1,0,0,1,0,1,0,0,0,0,0,0
6480bb9bef0d1fffea8bfd11,2009,,,1,ML Hayden,S Badrinath,0,1,0,0,1,0,0,0,0,0,1,0,0
6480bb993e44f97eccb361fe,2023,,,1,A Badoni,Yudhvir Singh,0,1,0,0,1,0,0,0,0,0,1,0,0
6480bba3b818a7cff6fe4f89,2016,,,2,M Morkel,SP Narine,0,1,0,0,0,0,0,0,0,0,1,0,0
6480bb970d7cbd85b6ada680,2021,,,2,GJ Maxwell,RM Patidar,0,1,0,0,1,0,1,0,0,0,0,0,0
6480bb973da000031d26fbba,2021,,,2,Q de Kock,SA Yadav,0,1,0,0,1,0,0,0,0,0,1,0,0
6480bb9ec07aa72ec89917f0,2012,,,2,F du Plessis,M Vijay,0,1,0,0,1,0,1,0,0,0,0,0,0
6480bb9442c4889bcbb4a784,2017,,,1,G Gambhir,SP Narine,0,6,0,0,1,0,0,0,0,0,6,0,0
6480bb967c50ceac62ba0719,2020/21,,,2,HH Pandya,Ishan Kishan,0,2,0,0,1,0,2,0,0,0,0,0,0
6480bb9cdf6c63fec90a42df,2009/10,,,1,BJ Hodge,MK Tiwary,0,2,0,0,1,0,2,0,0,0,0,0,0
6480bb9435048f20502ba1e1,2018,,,1,C de Grandhomme,V Kohli,0,1,0,0,1,0,0,0,0,0,1,0,0
6480bb99a620a7afdb3217fe,2023,,,2,DA Warner,MK Pandey,0,1,0,0,1,0,0,0,0,0,1,0,0
6480bb978c66ea3d9c85132d,2020/21,,,2,Rashid Khan,SP Goswami,0,1,0,0,1,0,1,0,0,0,0,0,0
6480bba163bd0c619365a16b,2015,,,2,Harbhajan Singh,MJ McClenaghan,0,1,0,0,1,0,0,0,0,0,1,0,0
6480bba21bbf76a62abea528,2016,,,2,AB de Villiers,SR Watson,0,1,0,0,1,0,1,0,0,0,0,0,0
6480bba2c04b3acd88a50839,2015,,,2,JP Duminy,Yuvraj Singh,0,3,0,0,1,0,0,0,0,0,3,0,0
6480bb9d85a6220ec9bc7dcb,2011,,,1,MD Mishra,MK Pandey,0,2,0,0,1,0,2,0,0,0,0,0,0
6480bb94d8aa9021808a4760,2017,,,2,RV Uthappa,YK Pathan,0,1,0,0,1,0,0,0,0,0,1,0,0
6480bb96b7b695186bbb6a3e,2019,,,1,KA Pollard,RD Chahar,0,2,0,0,1,0,0,0,0,0,2,0,0
6480bb99f649ea7a6d79892f,2023,,,1,P Simran Singh,S Dhawan,0,1,0,0,1,0,1,0,0,0,0,0,0
6480bb96c3293977af83acbf,2019,,,1,R Parag,STR Binny,0,1,0,0,1,0,0,0,0,0,1,0,0
6480bb9a9dc58f49d783faa9,2023,,,2,A Zampa,Sandeep Sharma,0,2,0,0,1,0,1,0,0,0,1,0,0
6480bba177ab201442a0e3c8,2015,,,1,AB de Villiers,Mandeep Singh,0,1,0,0,1,0,0,0,0,0,1,0,0
6480bba0bc196f7168b3d989,2013,,,2,DA Miller,Gurkeerat Singh,0,1,0,0,1,0,0,0,0,0,1,0,0
6480bba2a215721aadf7a90a,2015,,,2,CH Morris,R Bhatia,0,1,0,0,1,0,0,0,0,0,1,0,0
6480bb966f48b8ee03e6dff5,2020/21,,,1,F du Plessis,MS Dhoni,0,6,0,0,1,0,5,0,0,0,1,0,0
6480bb9bb7a4f1e16df25c8e,2009,,,1,ML Hayden,PA Patel,0,2,0,0,1,0,0,0,0,0,2,0,0
6480bb9b5d0191a0a2611916,2009,,,1,K Goel,RS Bopara,0,1,0,0,1,0,0,0,0,0,1,0,0
6480bba1d3b4ddc36050e3f3,2014,,,2,RN ten Doeschate,YK Pathan,0,1,0,0,1,0,0,0,0,0,1,0,0
6480bba0f858e6c12b25d8c3,2014,,,2,L Balaji,R Dhawan,0,2,0,0,1,0,2,0,0,0,0,0,0
6480bb993e44f97eccb361fe,2023,,,2,Atharva Taide,P Simran Singh,0,3,0,0,1,0,3,0,0,0,0,0,0
6480bba2fc84811f520b04cf,2016,,,1,AR Patel,MP Stoinis,0,1,0,0,1,0,0,0,0,0,1,0,0
6480bb9d69cb9046a72d8fbe,2009/10,,,2,B Sumanth,Harmeet Singh,0,2,0,0,1,0,2,0,0,0,0,0,0
6480bb987b6845947f7ca137,2022,,,1,SO Hetmyer,SV Samson,0,1,0,0,1,0,0,0,0,0,1,0,0
6480bb9c12f907c7b81b11a9,2009,,,1,BB McCullum,BJ Hodge,0,1,0,0,1,0,1,0,0,0,0,0,0
6480bb9f4bdcea2f81049fe9,2012,,,1,P Negi,Y Venugopal Rao,0,1,0,0,1,0,1,0,0,0,0,0,0
6480bb9baa08d0494c0b8dc3,2007/08,,,2,J Arunkumar,V Kohli,0,3,0,0,1,0,3,0,0,0,0,0,0
6480bb96fed7a7ee65076e4a,2020/21,,,1,BA Stokes,JC Buttler,0,3,0,0,1,0,1,0,0,0,2,0,0
6480bb9b17739118ee6c3bd0,2007/08,,,2,GC Smith,M Kaif,0,3,0,0,1,0,3,0,0,0,0,0,0
6480bba2b341a081c069198d,2015,,,2,DJ Hooda,STR Binny,0,1,0,0,1,0,0,0,0,0,1,0,0
6480bb9359a2cade3b5213d3,2017,,,2,N Rana,RG Sharma,0,1,0,0,1,0,0,0,0,0,1,0,0
6480bb9e2c96ab2b87d9466a,2011,,,2,IK Pathan,Y Nagar,0,1,0,0,1,0,0,0,0,0,1,0,0
6480bb9bfcaabf33b5687e32,2007/08,,,2,DR Smith,SM Pollock,0,1,0,0,1,0,0,0,0,0,1,0,0
6480bb9b332c16fba9cd28bc,2009,,,2,AM Rahane,ST Jayasuriya,0,1,0,0,1,0,1,0,0,0,0,0,0
6480bb980095555db76d49cb,2022,,,1,KA Pollard,SA Yadav,0,2,0,0,1,0,1,0,0,0,1,0,0
6480bb97c92184fed1a879f3,2021,,,1,Abdul Samad,WP Saha,0,1,0,0,1,0,1,0,0,0,0,0,0
6480bba250b404cdcbff22c8,2015,,,1,DR Smith,MEK Hussey,0,4,0,0,1,0,4,0,0,0,0,0,0
6480bb966c197bad273f91f1,2020/21,,,2,AS Rajpoot,Kartik Tyagi,0,1,0,0,1,0,1,0,0,0,0,0,0
6480bb95b1f28cf5bcf5e167,2018,,,2,F du Plessis,SR Watson,0,5,0,0,1,0,0,0,0,0,5,0,0
6480bb9a81d7fd0ac0307b4d,2023,,,2,DJ Hooda,Naveen-ul-Haq,0,2,0,0,1,0,0,0,0,0,2,0,0
6480bb9d80536875f41bc605,2011,,,1,JD Ryder,MK Pandey,0,1,0,0,1,0,1,0,0,0,0,0,0
6480bb9d3c4dfa9f054aa47f,2011,,,1,JH Kallis,MS Bisla,0,2,0,0,1,0,2,0,0,0,0,0,0
6480bb9be2940d96c1f903ca,2007/08,,,1,S Vidyut,SK Raina,0,3,0,0,1,0,3,0,0,0,0,0,0
6480bba179195d83fa7fbfbb,2014,,,2,AD Russell,MK Pandey,0,2,0,0,1,0,2,0,0,0,0,0,0
6480bb939b2499e9af6ee18c,2017,,,1,JC Buttler,PA Patel,0,2,0,0,1,0,0,0,0,0,2,0,0
6480bb984f6c41cd28aa0353,2022,,,2,Abdul Samad,Washington Sundar,0,1,0,0,1,0,1,0,0,0,0,0,0
6480bb95d675b7da24db1a57,2019,,,1,JL Denly,Shubman Gill,0,1,0,0,1,0,1,0,0,0,0,0,0
6480bb9cd6fe6fad0d6efbd9,2009/10,,,2,TM Dilshan,V Sehwag,0,1,0,0,1,0,1,0,0,0,0,0,0
6480bba358370ecde0231113,2016,,,2,DJ Hooda,MC Henriques,0,1,0,0,1,0,0,0,0,0,1,0,0
6480bb9619eaed447b2a05d4,2020/21,,,1,CH Morris,D Padikkal,0,2,0,0,1,0,0,0,0,0,2,0,0
6480bb9f146f5849bb759148,2013,,,2,AD Mathews,R Sharma,0,1,0,0,1,0,0,0,0,0,1,0,0
6480bba163bd0c619365a16b,2015,,,2,AT Rayudu,HH Pandya,0,1,0,0,1,0,0,0,0,0,1,0,0
6480bb9faf20f0bc714af2ea,2013,,,2,DA Warner,UBT Chand,0,1,0,0,1,0,0,0,0,0,1,0,0
6480bb94aad1a08ca4276b4e,2018,,,2,AB de Villiers,SN Khan,0,1,0,0,1,0,0,0,0,0,1,0,0
6480bb98af25209ef756aa2c,2021,,,1,AB de Villiers,DT Christian,0,1,0,0,1,0,1,0,0,0,0,0,0
6480bb9b4fc6889967a3cd54,2007/08,,,1,LPC Silva,RG Sharma,0,1,0,0,1,0,0,0,0,0,1,0,0
6480bb94aa9b082aa58a3822,2017,,,2,A Mishra,S Nadeem,0,1,0,0,1,0,0,0,0,0,1,0,0
6480bb93ec7e3351941d3b5b,2017,,,2,S Aravind,TS Mills,0,1,0,0,1,0,1,0,0,0,0,0,0
6480bb9f0f1f6c03d8e2f039,2013,,,1,AJ Finch,TL Suman,0,1,0,0,1,0,1,0,0,0,0,0,0
6480bb98bd3ca4df44cf9d8f,2022,,,2,R Powell,RR Pant,0,1,0,0,1,0,1,0,0,0,0,0,0
6480bb965aa0867bce4e79b3,2019,,,2,CH Gayle,N Pooran,0,1,0,0,1,0,1,0,0,0,0,0,0
6480bba140ee53a14fe06e0d,2014,,,1,AT Rayudu,CJ Anderson,0,1,0,0,1,0,1,0,0,0,0,0,0
6480bb95a8153d4daac6e4f7,2019,,,1,Kuldeep Yadav,PP Chawla,0,1,0,0,1,0,0,0,0,0,1,0,0
6480bba2a215721aadf7a90a,2015,,,1,MS Dhoni,P Negi,0,1,0,0,1,0,0,0,0,0,1,0,0
6480bb9fc3369c6f5a549d05,2013,,,1,BMAJ Mendis,V Sehwag,0,1,0,0,1,0,0,0,0,0,1,0,0
6480bb9f5867d07199aa832a,2013,,,2,AM Nayar,SPD Smith,0,1,0,0,0,0,1,0,0,0,0,0,0
6480bb9f59fd8000010baf09,2013,,,2,MC Juneja,V Sehwag,0,3,0,0,1,0,2,0,0,0,1,0,0
6480bba063bacaa2dfabf6fd,2014,,,2,JP Duminy,KP Pietersen,0,1,0,0,1,0,0,0,0,0,1,0,0
6480bb987c52e15a2cac0697,2022,,,1,K Rabada,VG Arora,0,1,0,0,1,0,0,0,0,0,1,0,0
6480bb981f136a7564719d7f,2022,,,1,LS Livingstone,OF Smith,0,1,0,0,1,0,0,0,0,0,1,0,0
6480bb97220be892fbfc2a36,2021,,,2,KD Karthik,Shakib Al Hasan,0,2,0,0,1,0,0,0,0,0,2,0,0
6480bb9b8860198955e581d8,2007/08,,,2,PP Chawla,S Sreesanth,0,1,0,0,1,0,1,0,0,0,0,0,0
6480bb96c880c7df4e055f14,2020/21,,,1,Q de Kock,RG Sharma,0,5,0,0,1,0,5,0,0,0,0,0,0
6480bba11a59d64bb4aa66f4,2014,,,2,SR Watson,SV Samson,0,1,0,0,1,0,1,0,0,0,0,0,0
6480bba0bc196f7168b3d989,2013,,,2,DA Miller,MS Gony,0,1,0,0,0,0,0,0,0,0,1,0,0
6480bb96c10dfe3d8c259db3,2020/21,,,1,AB de Villiers,CH Morris,0,2,0,0,1,0,0,0,0,0,2,0,0
6480bba2bae80e615447f251,2015,,,2,D Wiese,Iqbal Abdulla,0,1,0,0,1,0,1,0,0,0,0,0,0
6480bb9c7b7d7712bdc663de,2009/10,,,2,Jaskaran Singh,TL Suman,0,2,0,0,1,0,0,0,0,0,2,0,0
6480bb9e591b94e62772e66a,2012,,,2,KD Karthik,RG Sharma,0,4,0,0,1,0,3,0,0,0,1,0,0
6480bba2bae80e615447f251,2015,,,1,A Nehra,MM Sharma,0,1,0,0,1,0,1,0,0,0,0,0,0
6480bb9498a98d52f9285b52,2017,,,2,SN Thakur,Washington Sundar,0,1,0,0,1,0,1,0,0,0,0,0,0
6480bb973d64aa91e60b4088,2021,,,2,C Sakariya,Mustafizur Rahman,0,4,0,0,0,0,0,0,0,0,4,0,0
6480bb9561509a2f4f139254,2019,,,2,S Gopal,SPD Smith,0,1,0,0,1,0,0,0,0,0,1,0,0
6480bba1d3b4ddc36050e3f3,2014,,,2,MK Pandey,Shakib Al Hasan,0,3,0,0,1,0,3,0,0,0,0,0,0
6480bba17bce347084729c56,2015,,,1,J Suchith,R Vinay Kumar,0,1,0,0,0,0,1,0,0,0,0,0,0
6480bb98a95cb1650c81c926,2022,,,2,GJ Maxwell,RM Patidar,0,1,0,0,1,0,1,0,0,0,0,0,0
6480bba2bae80e615447f251,2015,,,2,Mandeep Singh,V Kohli,0,2,0,0,1,0,0,0,0,0,2,0,0
6480bb9e3db1392e753dd785,2012,,,1,JD Ryder,MK Pandey,0,2,0,0,1,0,2,0,0,0,0,0,0
6480bb9f0f1f6c03d8e2f039,2013,,,1,AD Mathews,AM Nayar,0,2,0,0,1,0,0,0,0,0,2,0,0
6480bb9f36da1a646c80be45,2013,,,1,RT Ponting,SR Tendulkar,0,6,0,0,1,0,6,0,0,0,0,0,0
6480bb98960cf9374ee9420d,2022,,,2,HR Shokeen,JJ Bumrah,0,2,0,0,0,0,0,0,0,0,2,0,0
6480bb964752e7c0f9e39d3c,2020/21,,,1,EJG Morgan,KD Karthik,0,1,0,0,1,0,0,0,0,0,1,0,0
6480bba09d6b23c8722fd208,2013,,,2,MM Patel,PP Ojha,0,2,0,0,1,0,0,0,0,0,2,0,0
6480bb9814efd9a91e8c911f,2021,,,2,LS Livingstone,YBK Jaiswal,0,3,0,0,1,0,0,0,0,0,3,0,0
6480bb9ca5c1d511ad78e92d,2009,,,2,G Gambhir,M Manhas,0,2,0,0,1,0,0,0,0,0,2,0,0
6480bb9480627b50308b7903,2017,,,1,Basil Thampi,JP Faulkner,0,1,0,0,1,0,0,0,0,0,1,0,0
6480bb9ee7a29c9b96ed61e5,2011,,,1,Mandeep Singh,PP Chawla,0,1,0,0,1,0,1,0,0,0,0,0,0
6480bb9ded279701c84af803,2011,,,2,A Mishra,DT Christian,0,2,0,0,1,0,2,0,0,0,0,0,0
6480bb96c40b697b63d08717,2019,,,2,AR Patel,RR Pant,0,3,0,0,1,0,3,0,0,0,0,0,0
6480bba20130c44ed20c9bcf,2016,,,2,AJ Finch,P Kumar,0,2,0,0,1,0,0,0,0,0,2,0,0
6480bb965f597c872396f67c,2020/21,,,1,LH Ferguson,M Prasidh Krishna,0,1,0,0,0,0,0,0,0,0,1,0,0
6480bb968211e65fcbffa192,2019,,,1,H Klaasen,MP Stoinis,0,1,0,0,1,0,0,0,0,0,1,0,0
6480bb948f3284f793b2763c,2018,,,1,E Lewis,Ishan Kishan,0,1,0,0,1,0,0,0,0,0,1,0,0
6480bb99315aee6cd9d56504,2023,,,2,KH Pandya,KL Rahul,0,2,0,0,1,0,2,0,0,0,0,0,0
6480bb9c7a11e1cbeea46b0e,2009/10,,,2,GC Smith,SA Asnodkar,0,2,0,0,1,0,2,0,0,0,0,0,0
6480bb9813fa79617f791851,2022,,,2,DJ Willey,SE Rutherford,0,1,0,0,1,0,1,0,0,0,0,0,0
6480bb9b9ca80d1c48994e04,2007/08,,,2,CK Kapugedera,S Badrinath,0,2,0,0,1,0,2,0,0,0,0,0,0
6480bba136257b71aa9952cf,2014,,,1,DJ Hussey,RA Jadeja,0,1,0,0,1,0,0,0,0,0,1,0,0
6480bb996c324f07ab7f763c,2023,,,2,RK Singh,SP Narine,0,1,0,0,1,0,0,0,0,0,1,0,0
6480bb942efd740a6ffc47df,2017,,,2,AF Milne,KM Jadhav,0,1,0,0,1,0,0,0,0,0,1,0,0
6480bba2965d1d15aa6f723e,2016,,,2,DJ Bravo,KD Karthik,0,1,0,0,1,0,0,0,0,0,1,0,0
6480bba1d9f266a28a109f29,2015,,,1,AR Patel,R Dhawan,0,1,0,0,1,0,1,0,0,0,0,0,0
6480bb9b77a0ff5cb3d0e3e0,2009,,,2,AB de Villiers,DA Warner,0,1,0,0,1,0,1,0,0,0,0,0,0
6480bb9765a785922ad360fe,2021,,,1,DA Warner,WP Saha,0,3,0,0,1,0,3,0,0,0,0,0,0
6480bb966f48b8ee03e6dff5,2020/21,,,1,F du Plessis,N Jagadeesan,0,1,0,0,1,0,0,0,0,0,1,0,0
6480bb9558c0acb502a3b1a9,2019,,,2,Avesh Khan,S Lamichhane,0,1,0,0,1,0,0,0,0,0,1,0,0
6480bba23b270561e8026bd2,2015,,,1,KL Rahul,NV Ojha,0,1,0,0,1,0,0,0,0,0,1,0,0
6480bba0b2a9d600114a43d7,2013,,,1,AM Nayar,Yuvraj Singh,0,2,0,0,1,0,0,0,0,0,2,0,0
6480bb9808d6857eeb335d94,2022,,,1,SP Narine,SS Iyer,0,1,0,0,1,0,1,0,0,0,0,0,0
6480bb9d76ba2d9dd45c74a8,2011,,,2,NLTC Perera,RV Gomez,0,3,0,0,1,0,2,0,0,0,1,0,0
6480bb9a6e44b0c8da00ca72,2007/08,,,2,L Ronchi,RV Uthappa,0,1,0,0,1,0,0,0,0,0,1,0,0
6480bb9574ca455ec008e942,2018,,,2,Kuldeep Yadav,Shubman Gill,0,1,0,0,1,0,0,0,0,0,1,0,0
6480bb99350726d00af209bf,2022,,,2,B Kumar,Shashank Singh,0,4,0,0,1,0,1,0,0,0,3,0,0
6480bb99e909d98c8193bac5,2023,,,2,MA Agarwal,RA Tripathi,0,2,0,0,1,0,0,0,0,0,2,0,0
6480bb958e752648ab95362b,2019,,,1,AD Russell,Kuldeep Yadav,0,1,0,0,1,0,0,0,0,0,1,0,0
6480bb9e2c96ab2b87d9466a,2011,,,2,AB Agarkar,S Nadeem,0,1,0,0,1,0,0,0,0,0,1,0,0
6480bb95b1f28cf5bcf5e167,2018,,,2,AT Rayudu,F du Plessis,0,1,0,0,1,0,1,0,0,0,0,0,0
6480bb99e909d98c8193bac5,2023,,,2,Abhishek Sharma,MA Agarwal,0,3,0,0,1,0,3,0,0,0,0,0,0
6480bb9f2305d07e3c65be11,2013,,,1,PA Reddy,Q de Kock,0,4,0,0,1,0,0,0,0,0,4,0,0
6480bb9d8f5769d3a514fd88,2009/10,,,1,LRPL Taylor,R Dravid,0,1,0,0,1,0,0,0,0,0,1,0,0
6480bb9e156723e64d6bd26b,2012,,,1,A Mishra,CL White,0,2,0,0,1,0,2,0,0,0,0,0,0
6480bb94cfe5aeb50e36aef3,2017,,,1,KD Karthik,SK Raina,0,2,0,0,1,0,0,0,0,0,2,0,0
6480bb9a3ffea6235f54cc1e,2023,,,1,AS Roy,Harshit Rana,0,1,0,0,1,0,0,0,0,0,1,0,0
6480bb9f87652064dab6c573,2013,,,1,Azhar Mahmood,DA Miller,0,1,0,0,1,0,1,0,0,0,0,0,0
6480bb96ec7d98e34055e8fc,2020/21,,,2,F du Plessis,RD Gaikwad,0,1,0,0,1,0,0,0,0,0,1,0,0
6480bb9e95693a2c4c4531e8,2011,,,1,KD Karthik,PC Valthaty,0,1,0,0,1,0,0,0,0,0,1,0,0
6480bb9dd778cb6c44535092,2009/10,,,2,R Sathish,SS Tiwary,0,2,0,0,1,0,1,0,0,0,1,0,0
6480bb9b50f9e801edc13d5a,2007/08,,,1,A Kumble,P Kumar,0,1,0,0,1,0,0,0,0,0,1,0,0
6480bb9df60a79ae5f20b748,2011,,,1,IK Pathan,Y Venugopal Rao,0,1,0,0,1,0,1,0,0,0,0,0,0
6480bb953b102c650968cba2,2019,,,1,Mohammed Siraj,PA Patel,0,2,0,0,1,0,1,0,0,0,1,0,0
6480bb987c52e15a2cac0697,2022,,,1,K Rabada,OF Smith,0,2,0,0,1,0,0,0,0,0,2,0,0
6480bb985efffbcafdef9f19,2021,,,1,Kartik Tyagi,Mustafizur Rahman,0,1,0,0,1,0,1,0,0,0,0,0,0
6480bb9f7ff1377c4d13a645,2013,,,2,AJ Finch,RV Uthappa,0,1,0,0,1,0,1,0,0,0,0,0,0
6480bb954714437843ab3647,2019,,,2,DJ Hooda,V Shankar,0,1,0,0,1,0,0,0,0,0,1,0,0
6480bb9fc28e897b3c53f359,2012,,,1,MEK Hussey,SK Raina,0,1,0,0,1,0,0,0,0,0,1,0,0
6480bb9575ad32214d0f6ec0,2019,,,1,DA Miller,R Ashwin,0,1,0,0,1,0,1,0,0,0,0,0,0
6480bb9993e6e474a4e37366,2023,,,2,DP Conway,RD Gaikwad,0,4,0,0,1,0,4,0,0,0,0,0,0
6480bb998454ba791a8fdbf8,2023,,,1,A Nortje,Abishek Porel,0,2,0,0,1,0,0,0,0,0,2,0,0
6480bb95960e393c939ab44c,2018,,,2,JJ Bumrah,Mustafizur Rahman,0,1,0,0,1,0,1,0,0,0,0,0,0
6480bb961ee814aee7b674ac,2020/21,,,2,CJ Jordan,Mohammed Shami,0,1,0,0,1,0,1,0,0,0,0,0,0
6480bb9deba74e341b44c765,2009/10,,,2,Harmeet Singh,PP Ojha,0,2,0,0,1,0,0,0,0,0,2,0,0
6480bb95ff5da0069bc5274e,2018,,,2,KL Rahul,MA Agarwal,0,1,0,0,1,0,0,0,0,0,1,0,0
6480bb9c757dbd7f92b1130a,2009/10,,,1,AC Gilchrist,MD Mishra,0,2,0,0,1,0,2,0,0,0,0,0,0
6480bb967d799ced7fe5d8e9,2020/21,,,2,PK Garg,Rashid Khan,0,1,0,0,1,0,0,0,0,0,1,0,0
6480bb9d05f8e769574069fa,2009/10,,,2,AB Agarkar,AB Dinda,0,1,0,0,1,0,0,0,0,0,1,0,0
6480bb9bdde9db92f880e40d,2007/08,,,1,DB Das,SC Ganguly,0,1,0,0,1,0,1,0,0,0,0,0,0
6480bb9b1087ddfd207caa83,2009,,,2,IK Pathan,PP Chawla,0,1,0,0,1,0,1,0,0,0,0,0,0
6480bb99bb362e3714226928,2022,,,2,MP Stoinis,PVD Chameera,0,2,0,0,1,0,0,0,0,0,2,0,0
6480bb9bc8bcea920f081be8,2009,,,1,B Akhil,V Kohli,0,1,0,0,1,0,0,0,0,0,1,0,0
6480bba29f384ce360fa8131,2016,,,2,IK Pathan,MS Dhoni,0,1,0,0,1,0,0,0,0,0,1,0,0
6480bba069d61566bb63ac2b,2014,,,1,PA Patel,V Kohli,0,3,0,0,1,0,1,0,0,0,2,0,0
6480bb95b1f28cf5bcf5e167,2018,,,1,S Dhawan,SP Goswami,0,1,0,0,1,0,1,0,0,0,0,0,0
6480bb9b72f6a46338302131,2009,,,2,PR Shah,SR Tendulkar,0,1,0,0,1,0,0,0,0,0,1,0,0
6480bba1603d86b7d278a366,2015,,,2,BB McCullum,DR Smith,0,1,0,0,1,0,0,0,0,0,1,0,0
6480bba1c0aa361f3c6e454c,2015,,,1,J Suchith,KA Pollard,0,1,0,0,1,0,0,0,0,0,1,0,0
6480bb9d967f5a4cfbd8c74d,2011,,,2,EJG Morgan,MK Tiwary,0,1,0,0,1,0,1,0,0,0,0,0,0
6480bb94834e2b780c4782b5,2017,,,1,CA Lynn,SP Narine,0,4,0,0,1,0,0,0,0,0,4,0,0
6480bb9808d6857eeb335d94,2022,,,1,AD Russell,N Rana,0,3,0,0,1,0,3,0,0,0,0,0,0
6480bb9f0f1f6c03d8e2f039,2013,,,2,CL White,GH Vihari,0,1,0,0,1,0,1,0,0,0,0,0,0
6480bb98adf21699eaa67796,2022,,,1,KD Karthik,PWH de Silva,0,1,0,0,1,0,0,0,0,0,1,0,0
6480bba21bbf76a62abea528,2016,,,1,Ankit Sharma,M Ashwin,0,1,0,0,1,0,0,0,0,0,1,0,0
6480bb94ca3c1b1eac5e8dd3,2018,,,2,DJ Bravo,DL Chahar,0,1,0,0,1,0,0,0,0,0,1,0,0
6480bb962831291a868490e7,2020/21,,,1,EJG Morgan,PJ Cummins,0,1,0,0,1,0,1,0,0,0,0,0,0
6480bba08cc4182f0127f2e2,2013,,,2,MEK Hussey,SK Raina,0,1,0,0,1,0,0,0,0,0,1,0,0
6480bb970127afddc00607cc,2021,,,2,F du Plessis,RA Jadeja,0,1,0,0,1,0,1,0,0,0,0,0,0
6480bb9d93cca4d1a7635fba,2011,,,1,MA Agarwal,TM Dilshan,0,1,0,0,1,0,1,0,0,0,0,0,0
6480bb97aa725a640d0f8e2f,2021,,,1,LS Livingstone,SV Samson,0,2,0,0,1,0,1,0,0,0,1,0,0
6480bb95014388d3e8c62904,2019,,,2,CH Morris,RR Pant,0,3,0,0,1,0,3,0,0,0,0,0,0
6480bba0d2cdb40c68c4739c,2013,,,2,KA Pollard,SL Malinga,0,2,0,0,1,0,0,0,0,0,2,0,0
6480bba0b5eabeb0a150b93f,2013,,,2,AJ Finch,RV Uthappa,0,2,0,0,1,0,0,0,0,0,2,0,0
6480bba1af9481df8b4f9f0f,2015,,,1,MK Pandey,YK Pathan,0,1,0,0,1,0,1,0,0,0,0,0,0
6480bb96acacf3be646d300a,2020/21,,,2,R Ashwin,RR Pant,0,1,0,0,1,0,0,0,0,0,1,0,0
6480bb9f03dd3a09740f0bd0,2013,,,1,BJ Hodge,KK Cooper,0,2,0,0,1,0,0,0,0,0,2,0,0
6480bb9bd918d2e963f0218a,2009,,,1,JD Ryder,RV Uthappa,0,1,0,0,1,0,1,0,0,0,0,0,0
6480bb93d9581d69657887c3,2017,,,2,A Mishra,S Nadeem,0,2,0,0,1,0,0,0,0,0,2,0,0
6480bb9b9dd7fe8c5cbdbab0,2009,,,1,JA Morkel,L Balaji,0,1,0,0,1,0,1,0,0,0,0,0,0
6480bb9c71030f4c6f018f55,2009,,,1,RJ Harris,RP Singh,0,2,0,0,1,0,0,0,0,0,2,0,0
6480bba04b49d2ff5f997e02,2013,,,2,B Chipli,BJ Rohrer,0,1,0,0,1,0,1,0,0,0,0,0,0
6480bba234aac105851964b1,2015,,,1,DJ Bravo,MS Dhoni,0,1,0,0,1,0,1,0,0,0,0,0,0
6480bba273adb498d96b27a9,2016,,,2,GB Hogg,UT Yadav,0,1,0,0,1,0,0,0,0,0,1,0,0
6480bba31cc11024436836b5,2016,,,2,CH Morris,RR Pant,0,1,0,0,1,0,0,0,0,0,1,0,0
6480bb97aad3147696268239,2021,,,1,AT Rayudu,SK Raina,0,1,0,0,1,0,0,0,0,0,1,0,0
6480bb9c968c81bdfcc6df5b,2009,,,1,DA Warner,V Sehwag,0,1,0,0,1,0,1,0,0,0,0,0,0
6480bb99ed38bcb4025b8d86,2023,,,1,Mandeep Singh,Rahmanullah Gurbaz,0,1,0,0,1,0,1,0,0,0,0,0,0
6480bb99695e001cdaca81e0,2022,,,2,T Stubbs,Tilak Varma,0,2,0,0,1,0,2,0,0,0,0,0,0
6480bb9927b39ebcfd7820b0,2022,,,2,A Tomar,VR Iyer,0,4,0,0,1,0,0,0,0,0,4,0,0
6480bb99b0fa4d217ed7f255,2023,,,1,Kuldeep Yadav,RV Patel,0,2,0,0,1,0,2,0,0,0,0,0,0
6480bba0b2a9d600114a43d7,2013,,,2,DR Smith,SR Tendulkar,0,1,0,0,1,0,1,0,0,0,0,0,0
6480bba16796f9a72374865f,2015,,,2,AT Rayudu,RG Sharma,0,2,0,0,1,0,2,0,0,0,0,0,0
6480bba2563745309ee2bdfb,2016,,,1,DJ Bravo,RA Jadeja,0,1,0,0,1,0,1,0,0,0,0,0,0
6480bb9fe8f5df13fc8d1bc3,2012,,,2,M Vijay,SK Raina,0,2,0,0,1,0,2,0,0,0,0,0,0
6480bba237377ccc608266d2,2016,,,2,HH Pandya,KH Pandya,0,1,0,0,1,0,1,0,0,0,0,0,0
6480bb95385ebb9bda58a643,2019,,,2,AR Patel,K Rabada,0,1,0,0,1,0,1,0,0,0,0,0,0
6480bb956b439141409fd739,2018,,,1,JC Archer,RA Tripathi,0,1,0,0,1,0,1,0,0,0,0,0,0
6480bb9574ca455ec008e942,2018,,,2,CA Lynn,Shubman Gill,0,2,0,0,1,0,2,0,0,0,0,0,0
6480bb9d5d93b08a19c16313,2009/10,,,2,BB McCullum,SC Ganguly,0,4,0,0,1,0,4,0,0,0,0,0,0
6480bb948f3284f793b2763c,2018,,,2,CJ Anderson,V Kohli,0,1,0,0,1,0,1,0,0,0,0,0,0
6480bb96c40b697b63d08717,2019,,,1,B Kumar,Rashid Khan,0,1,0,0,1,0,0,0,0,0,1,0,0
6480bb981b01a21305fd65d5,2022,,,1,B Sai Sudharsan,Rashid Khan,0,1,0,0,1,0,0,0,0,0,1,0,0
6480bb94adb227976b33d30b,2018,,,2,AD Russell,Shivam Mavi,0,3,0,0,1,0,0,0,0,0,3,0,0
6480bba00be5cdbaf6648462,2013,,,2,M Vijay,SK Raina,0,1,0,0,1,0,0,0,0,0,1,0,0
6480bb9f9a70ecf3467829df,2013,,,1,MS Dhoni,RA Jadeja,0,2,0,0,1,0,0,0,0,0,2,0,0
6480bb95f45dffe4751efc46,2019,,,1,MS Dhoni,SK Raina,0,1,0,0,1,0,0,0,0,0,1,0,0
6480bb942efd740a6ffc47df,2017,,,2,AF Milne,S Aravind,0,1,0,0,1,0,1,0,0,0,0,0,0
6480bb9c2f07203e8e510386,2009/10,,,1,DPMD Jayawardene,RS Bopara,0,1,0,0,1,0,1,0,0,0,0,0,0
6480bb96fb897a6ff486ffe4,2020/21,,,2,SPD Smith,SV Samson,0,7,0,0,1,0,4,0,0,0,3,0,0
6480bb9af85f41b4de44ca19,2023,,,2,Shubman Gill,V Shankar,0,2,0,0,1,0,1,0,0,0,1,0,0
6480bba2563745309ee2bdfb,2016,,,2,GJ Maxwell,M Vijay,0,1,0,0,1,0,1,0,0,0,0,0,0
6480bb9b166300b6298fc71a,2009,,,1,KC Sangakkara,S Sohal,0,1,0,0,1,0,0,0,0,0,1,0,0
6480bba23b270561e8026bd2,2015,,,1,DA Warner,MC Henriques,0,1,0,0,1,0,1,0,0,0,0,0,0
6480bb97a42828c5a5ebef1c,2020/21,,,2,AR Patel,DR Sams,0,2,0,0,1,0,0,0,0,0,2,0,0
6480bb9c5ec0713155cad138,2009/10,,,2,BJ Hodge,MK Tiwary,0,1,0,0,1,0,0,0,0,0,1,0,0
6480bb94834e2b780c4782b5,2017,,,1,CA Lynn,MK Pandey,0,2,0,0,1,0,2,0,0,0,0,0,0
6480bb97493381c4d7dc7bf4,2021,,,1,CH Morris,S Gopal,0,1,0,0,1,0,1,0,0,0,0,0,0
6480bba2ab35be3ffcfa932a,2016,,,1,SN Khan,SR Watson,0,1,0,0,1,0,0,0,0,0,1,0,0
6480bb9d05f8e769574069fa,2009/10,,,2,BB McCullum,MK Tiwary,0,3,0,0,1,0,1,0,0,0,2,0,0
6480bb9deba74e341b44c765,2009/10,,,2,Harmeet Singh,RJ Harris,0,1,0,0,1,0,0,0,0,0,1,0,0
6480bb9ab99ef699d66ad5a0,2023,,,2,Ishan Kishan,RG Sharma,0,3,0,0,1,0,0,0,0,0,3,0,0
6480bb947a7c9fe868fc901a,2017,,,1,MN Samuels,RR Pant,0,1,0,0,1,0,1,0,0,0,0,0,0
6480bb942fc9529eb2869c17,2018,,,1,CJ Anderson,Mandeep Singh,0,1,0,0,1,0,1,0,0,0,0,0,0
6480bb99350726d00af209bf,2022,,,1,F du Plessis,V Kohli,0,1,0,0,1,0,0,0,0,0,1,0,0
6480bb9498a98d52f9285b52,2017,,,1,B Kumar,S Kaul,0,1,0,0,1,0,1,0,0,0,0,0,0
6480bba177ab201442a0e3c8,2015,,,1,HV Patel,SA Abbott,0,1,0,0,1,0,0,0,0,0,1,0,0
6480bba286cca051953c976a,2015,,,2,M Vijay,WP Saha,0,2,0,0,1,0,2,0,0,0,0,0,0
